(supertux-level
  (version 2)
  (name (_ "No More Mr Ice Guy"))
  (author "SuperTux Team")
  (license "GPL 2+ / CC-by-sa 3.0")
  (sector
    (name "main")
    (music "music/bossattack.music")
    (init-script "
Effect.fade_in(1);
")
    (ambient-light 1 1 1)
    (background
      (speed 0.5)
      (image "images/background/semi_arctic.jpg")
    )
    (camera
      (mode "normal")
    )
    (particles-snow
    )
    (spawnpoint
      (name "main")
      (x 480)
      (y 448)
    )
    (yeti_stalactite
      (x 97)
      (y 32)
    )
    (yeti_stalactite
      (x 128)
      (y 32)
    )
    (yeti_stalactite
      (x 161)
      (y 32)
    )
    (yeti_stalactite
      (x 191)
      (y 32)
    )
    (yeti_stalactite
      (x 223)
      (y 32)
    )
    (yeti_stalactite
      (x 255)
      (y 32)
    )
    (yeti_stalactite
      (x 288)
      (y 32)
    )
    (yeti_stalactite
      (x 321)
      (y 32)
    )
    (yeti_stalactite
      (x 352)
      (y 32)
    )
    (yeti_stalactite
      (x 384)
      (y 32)
    )
    (yeti_stalactite
      (x 417)
      (y 32)
    )
    (yeti_stalactite
      (x 576)
      (y 32)
    )
    (yeti_stalactite
      (x 545)
      (y 32)
    )
    (yeti_stalactite
      (x 512)
      (y 32)
    )
    (yeti_stalactite
      (x 479)
      (y 32)
    )
    (yeti_stalactite
      (x 448)
      (y 32)
    )
    (yeti_stalactite
      (x 607)
      (y 32)
    )
    (yeti_stalactite
      (x 639)
      (y 32)
    )
    (yeti_stalactite
      (x 671)
      (y 32)
    )
    (tilemap
      (z-pos -100)
      (solid #f)
      (width 25)
      (height 20)
      (tiles
      0 0 0 0 0 0 0 0 0 0 0 0 0 0 0 0 0 0 0 0 0 0 0 0 0
      0 0 0 0 0 0 0 0 0 0 0 0 0 0 0 0 0 0 0 0 0 0 0 0 0
      0 0 0 0 0 0 0 0 0 0 0 0 0 0 0 0 0 0 0 0 0 0 0 0 0
      0 0 0 0 0 0 0 0 0 0 0 0 0 0 0 0 0 0 0 0 0 0 0 0 0
      0 0 0 0 0 0 0 0 0 0 0 0 0 0 0 0 0 0 0 0 0 0 0 0 0
      0 0 0 0 0 0 0 0 0 0 0 0 0 0 0 0 0 0 0 0 0 0 0 0 0
      0 0 0 0 0 0 0 0 0 0 0 0 0 0 0 0 0 0 0 0 0 0 0 0 0
      0 0 0 0 0 0 0 0 0 0 0 0 0 0 0 0 0 0 0 0 0 0 0 0 0
      0 0 0 0 0 0 0 0 0 0 0 0 0 0 0 0 0 0 0 0 0 0 0 0 0
      0 0 0 0 0 0 0 0 0 0 0 0 0 0 0 0 0 0 0 0 0 0 0 0 0
      0 0 0 0 0 0 0 0 0 0 0 0 0 0 0 0 0 0 0 0 0 0 0 0 0
      0 0 0 0 0 0 0 0 0 0 0 0 0 0 0 0 0 0 0 0 0 0 0 0 0
      0 0 0 0 0 0 0 0 0 0 0 0 0 0 0 0 0 0 0 0 0 0 0 0 0
      0 0 0 0 0 0 0 0 0 0 0 0 0 0 0 0 0 0 0 0 0 0 0 0 0
      0 0 0 0 0 0 0 0 0 0 0 0 0 0 0 0 0 0 0 0 0 0 0 0 0
      0 0 0 0 0 0 0 0 0 0 0 0 0 0 0 0 0 0 0 0 0 0 0 0 0
      0 0 0 0 0 0 0 0 0 0 0 0 0 0 0 0 0 0 0 0 0 0 0 0 0
      0 0 0 0 0 0 0 0 0 0 0 0 0 0 0 0 0 0 0 0 0 0 0 0 0
      0 0 0 0 0 0 0 0 0 0 0 0 0 0 0 0 0 0 0 0 0 0 0 0 0
      0 0 0 0 0 0 0 0 0 0 0 0 0 0 0 0 0 0 0 0 0 0 0 0 0
      )
    )
    (tilemap
      (z-pos 0)
      (solid #t)
      (width 25)
      (height 20)
      (tiles
      11 11 11 11 11 11 11 11 11 11 11 11 11 11 11 11 11 11 11 11 11 11 11 11 11
      17 17 17 17 17 17 17 17 17 17 17 17 17 17 17 17 17 17 17 17 17 17 17 17 17
      0 0 0 0 0 0 0 0 0 0 0 0 0 0 0 0 0 0 0 0 0 0 0 0 0
      0 0 0 0 0 0 0 0 0 0 0 0 0 0 0 0 0 0 0 0 0 0 0 0 0
      0 0 0 0 0 0 0 0 0 0 0 0 0 0 0 0 0 0 0 0 0 0 0 0 0
      0 0 0 0 0 0 0 0 0 0 0 0 0 0 0 0 0 0 0 0 0 0 0 0 0
      0 0 0 0 0 0 0 0 0 0 0 0 0 0 0 0 0 0 0 0 0 0 0 0 0
      0 0 0 0 0 0 0 0 0 0 0 0 0 0 0 0 0 0 0 0 0 0 0 0 0
      0 0 0 0 0 0 0 0 0 0 0 0 0 0 0 0 0 0 0 0 0 0 0 0 0
      0 0 0 0 0 0 0 0 0 0 0 0 0 0 0 0 0 0 0 0 0 0 0 0 0
      0 0 0 0 0 0 0 0 0 0 0 0 0 0 0 0 0 0 0 0 0 0 0 0 0
      8 8 9 0 0 0 0 0 0 0 0 0 0 0 0 0 0 0 0 0 0 0 7 8 8
      14 14 15 0 0 0 0 0 0 0 0 0 0 0 0 0 0 0 0 0 0 0 13 14 14
      11 11 12 0 0 0 0 0 0 0 0 0 0 0 0 0 0 0 0 0 0 0 10 11 11
      11 11 12 0 0 0 0 0 0 0 0 0 0 0 0 0 0 0 0 0 0 0 10 11 11
      11 11 12 0 0 0 0 0 0 0 0 0 0 0 0 0 0 0 0 0 0 0 10 11 11
      11 11 12 0 0 0 0 0 0 0 0 0 0 0 0 0 0 0 0 0 0 0 10 11 11
      11 11 12 0 0 0 0 0 0 0 0 0 0 0 0 0 0 0 0 0 0 0 10 11 11
      11 11 21 8 8 8 8 8 8 8 8 8 8 8 8 8 8 8 8 8 8 8 22 11 11
      11 11 20 14 14 14 14 14 14 14 14 14 14 14 14 14 14 14 14 14 14 14 23 11 11
      )
    )
    (tilemap
      (z-pos 100)
      (solid #f)
      (width 25)
      (height 20)
      (tiles
      0 0 0 0 0 0 0 0 0 0 0 0 0 0 0 0 0 0 0 0 0 0 0 0 0
      0 0 0 0 0 0 0 0 0 0 0 0 0 0 0 0 0 0 0 0 0 0 0 0 0
      0 0 0 0 0 0 0 0 0 0 0 0 0 0 0 0 0 0 0 0 0 0 0 0 0
      0 0 0 0 0 0 0 0 0 0 0 0 0 0 0 0 0 0 0 0 0 0 0 0 0
      0 0 0 0 0 0 0 0 0 0 0 0 0 0 0 0 0 0 0 0 0 0 0 0 0
      0 0 0 0 0 0 0 0 0 0 0 0 0 0 0 0 0 0 0 0 0 0 0 0 0
      0 0 0 0 0 0 0 0 0 0 0 0 0 0 0 0 0 0 0 0 0 0 0 0 0
      0 0 0 0 0 0 0 0 0 0 0 0 0 0 0 0 0 0 0 0 0 0 0 0 0
      0 0 0 0 0 0 0 0 0 0 0 0 0 0 0 0 0 0 0 0 0 0 0 0 0
      0 0 0 0 0 0 0 0 0 0 0 0 0 0 0 0 0 0 0 0 0 0 0 0 0
      0 0 0 0 0 0 0 0 0 0 0 0 0 0 0 0 0 0 0 0 0 0 0 0 0
      0 0 0 0 0 0 0 0 0 0 0 0 0 0 0 0 0 0 0 0 0 0 0 0 0
      0 0 0 0 0 0 0 0 0 0 0 0 0 0 0 0 0 0 0 0 0 0 0 0 0
      0 0 0 0 0 0 0 0 0 0 0 0 0 0 0 0 0 0 0 0 0 0 0 0 0
      0 0 0 0 0 0 0 0 0 0 0 0 0 0 0 0 0 0 0 0 0 0 0 0 0
      0 0 0 0 0 0 0 0 0 0 0 0 0 0 0 0 0 0 0 0 0 0 0 0 0
      0 0 0 0 0 0 0 0 0 0 0 0 0 0 0 0 0 0 0 0 0 0 0 0 0
      0 0 0 0 0 0 0 0 0 0 0 0 0 0 0 0 0 0 0 0 0 0 0 0 0
      0 0 0 0 0 0 0 0 0 0 0 0 0 0 0 0 0 0 0 0 0 0 0 0 0
      0 0 0 0 0 0 0 0 0 0 0 0 0 0 0 0 0 0 0 0 0 0 0 0 0
      )
    )
    (yeti
      (dead-script "sector.Tux.trigger_sequence(\"fireworks\");")
      (x 2)
      (y 177)
    )
  )
)
