(supertux-level
  (version 3)
  (name (_ "Bouncy, Bouncy Mountainside"))
  (author "Carsten Wirtz, FrostC")
  (license "CC-BY-SA 4.0 International")
  (allow-item-pocket "inherit")
  (icon "")
  (icon-locked "")
  (statistics
    (enable-coins #t)
    (enable-badguys #f)
    (enable-secrets #t)
  )
  (sector
    (name "main")
    (ambient-light
      (color 1 1 1)
    )
    (background
      (color 1 1 1)
      (scroll-speed-x -0.1)
      (speed 0)
      (image "/images/background/misc/skybox.png")
      (z-pos -290)
    )
    (background
      (color 1 1 1)
      (scroll-speed-x -2)
      (speed 0)
      (image "/images/background/misc/clouds.png")
      (z-pos -280)
    )
    (background
      (scroll-offset-x -120)
      (color 1 1 1)
      (alignment "bottom")
      (speed 0)
      (image-top "/images/background/misc/transparent_up.png")
      (image "/images/background/antarctic/snowmountain_panorama.png")
      (z-pos -250)
    )
    (camera
      (name "Camera")
      (mode "normal")
    )
    (coin
      (z-pos 49)
      (x 944)
      (y 1536)
    )
    (coin
      (z-pos 49)
      (x 1040)
      (y 1536)
    )
    (coin
      (z-pos 49)
      (x 1902.04)
      (y 1494.97)
    )
    (coin
      (z-pos 49)
      (x 1824)
      (y 1440)
    )
    (coin
      (z-pos 49)
      (x 1744)
      (y 1392)
    )
    (coin
      (z-pos 49)
      (x 1824)
      (y 1344)
    )
    (coin
      (z-pos 49)
      (x 1904)
      (y 1296)
    )
    (gradient
      (top_color 0.5 0.7 1)
      (bottom_color 1 1 1)
    )
    (infoblock
      (z-pos 51)
      (message (_ "-Walljumping
#Tux is able to cling onto certain walls and perform a walljump. Simply move against the wall and press the JUMP key."))
      (x 1312)
      (y 1600)
    )
    (jumpy
      (z-pos 50)
      (x 640)
      (y 1568)
    )
    (jumpy
      (z-pos 50)
      (x 864)
      (y 1600)
    )
    (mriceblock
      (z-pos 50)
      (x 1584)
      (y 1664)
    )
    (music
      (file "/music/antarctic/midday.music")
    )
    (particles-clouds
    )
    (powerup
      (version 2)
      (type "oneup")
      (z-pos 50)
      (disable-physics #t)
      (x 4560)
      (y 1744)
    )
    (smartball
      (z-pos 50)
      (x 2464)
      (y 1248)
    )
    (smartball
      (z-pos 50)
      (x 2560)
      (y 1248)
    )
    (smartball
      (z-pos 50)
      (x 4912)
      (y 1472)
    )
    (spawnpoint
      (name "main")
      (x 80)
      (y 1472)
    )
    (spawnpoint
      (x 2960)
      (y 1424)
    )
    (spawnpoint
      (x 3696)
      (y 1056)
    )
    (spawnpoint
      (x 4368)
      (y 1936)
    )
    (tilemap
      (solid #t)
      (z-pos 0)
      (width 350)
      (height 80)
      (tiles -121 0 10 11 5368 5369 -3 11 -4 5369 -3 11 12 -335 0 10 -3 11 -3 5368 -4 11 5368 5369 11 12 -335 0 10 5369 -10 11 5368 11 21 -14 8 9 -320 0 10 11 -8 5368 5369 -2 11 5369 20 -2 14 3988 -10 14 3989 15 -320 0 10 5369 -9 11 5369 11 5368 -3 11 5369 -2 11 5368 -5 11 -2 5369 11 12 -320 0 10 5369 11 5368 -2 11 5369 -2 11 -2 5369 -2 11 5368 -2 11 5368 11 -2 5369 -5 11 5368 11 5369 11 12 -320 0 10 5369 11 5369 11 5369 -2 11 5369 5368 5369 -2 11 5368 11 5368 5369 -2 11 5368 11 5369 11 -2 5369 -2 11 5369 5368 12 -320 0 10 5369 -2 11 5368 11 5369 5368 -2 11 5368 11 -3 5368 5369 -11 11 5369 11 12 -320 0 10 5369 1539 11 5369 -5 11 5368 -2 11 5368 5369 11 -3 5368 -3 11 -2 5368 -4 11 5368 12 -320 0 10 5369 5368 -2 11 -4 5369 11 5368 -2 11 5369 -12 11 -2 5368 11 12 -320 0 10 5369 5368 -5 11 5368 11 -3 5368 -2 11 -3 5369 -3 11 5369 5368 11 5369 -4 11 12 -320 0 5374 5368 -4 11 5368 5369 -2 11 -2 5369 -2 11 5368 -2 11 5368 -2 11 5368 -5 11 5368 -2 11 12 -320 0 2938 5368 -2 11 5368 5369 -3 11 -2 5369 -6 11 5368 -3 11 5369 -7 11 12 -320 0 2939 31 -2 11 5368 -3 11 -2 5369 -3 11 5369 11 5368 5369 -2 11 5369 11 5368 -2 11 -2 5368 -2 11 5369 12 -321 0 10 -2 11 5369 11 5369 -3 5368 11 5368 -4 11 5368 11 5368 -10 11 12 -321 0 10 -2 11 5369 5368 -3 11 5368 -4 11 5368 11 -2 5368 11 5368 5369 -2 11 -2 5369 -2 11 -2 5369 12 -321 0 10 5368 -2 11 5369 5368 5369 11 5368 -2 11 5368 -2 11 5369 5368 5369 -2 11 5368 11 5368 -5 11 5369 12 -321 0 10 5368 -5 11 5369 -2 5368 5369 -2 11 5369 -2 5368 11 5369 11 -2 5368 -6 11 5369 12 -321 0 10 5368 -5 11 -2 5368 5369 -3 11 5368 1539 5369 -2 11 5369 5368 5369 11 5368 11 5368 19 -2 11 12 -321 0 5374 11 5369 -2 11 5369 5368 11 5368 11 -3 5368 -3 11 5369 11 -2 5368 -2 11 -2 5368 -4 11 12 -321 0 2938 11 5368 11 1539 -3 11 5368 -5 11 5368 -2 11 5369 5368 5369 5368 5369 5368 -2 5369 -2 11 5369 12 -321 0 2939 31 -2 11 -3 5368 11 -3 5368 11 5369 11 -2 5368 5369 -2 5368 -2 11 -2 5369 -5 11 12 -322 0 10 11 -2 5369 -2 11 5369 5368 5369 -2 11 5368 11 5369 -3 11 5369 5368 5369 5368 11 5369 -4 11 12 -322 0 10 11 5369 -2 11 5369 5368 5369 11 -2 5369 -8 11 -2 5369 11 5368 11 -2 5368 11 12 -322 0 5374 -3 11 5368 11 5368 5369 19 11 5369 -7 11 5369 5368 -7 11 12 -322 0 2938 -7 11 5369 11 5369 -2 11 5369 5368 11 5368 5369 11 5368 11 5368 11 -2 5369 11 5369 12 -322 0 2939 31 -3 11 5368 -3 11 5369 5368 -4 11 -2 5369 -2 11 -2 5369 -3 11 -2 5368 11 12 -323 0 10 -2 11 5368 -3 11 -2 5368 5369 11 -2 5368 -8 11 5368 5369 11 -2 5369 12 -323 0 5374 5369 11 -3 5369 -3 11 5369 11 5369 11 5369 11 5368 5369 -6 11 5368 11 5368 12 -323 0 2938 5368 -3 11 5369 -2 5368 11 5369 -2 11 -2 5369 -2 11 5368 11 -2 5369 11 5368 11 -2 5369 5368 12 -323 0 2939 31 -3 11 5368 5369 11 5369 -2 11 5368 11 5369 5368 5369 11 5368 11 5369 5368 -3 11 5368 5369 12 -324 0 10 11 5369 11 5368 5369 5368 5369 -4 11 -2 5369 -4 11 5369 -3 11 -2 5368 11 21 9 -323 0 10 -6 11 5368 -2 11 5368 -4 11 5368 11 5369 11 5368 -2 5369 11 -2 5368 20 15 -243 0 83 102 83 -77 0 10 -2 11 5368 -2 11 5369 -3 5368 11 5369 11 5369 11 5369 11 5369 11 5369 11 5368 11 5369 -2 11 12 -311 0 7 -5 8 9 -5 0 10 11 5368 -2 11 5368 -4 11 5368 5369 -9 11 5368 -3 11 5368 12 -311 0 13 3990 -4 14 15 -5 0 10 11 5368 5369 11 5369 -3 11 5368 11 5369 5368 -5 11 5368 5369 -3 11 5368 -2 11 12 -241 0 7 -6 8 9 -62 0 10 -4 11 5368 12 -5 0 10 11 5369 -3 11 5368 11 5369 5368 11 5369 11 5368 2929 2930 -5 17 31 -3 11 30 18 -241 0 13 -6 14 15 -62 0 10 5369 -2 11 5368 11 12 -5 0 5374 -3 11 5369 -3 11 5369 11 5369 2929 2930 17 2931 -6 0 16 31 -2 11 12 -242 0 10 -2 11 5368 11 5368 11 12 -62 0 10 11 5368 11 5369 1539 12 -5 0 2938 -3 11 5368 -2 5369 5368 11 5368 2935 2931 -10 0 16 31 30 18 -242 0 10 11 -2 5368 -2 11 5368 21 -2 8 9 -11 0 7 -16 8 9 -30 0 10 -3 11 -2 5369 12 -5 0 2939 2937 5369 11 5368 5369 5368 5369 11 2935 2936 -12 0 16 18 -243 0 10 -6 11 20 -2 14 15 -11 0 13 -5 14 3989 -10 14 15 -30 0 10 1539 -2 5368 5369 11 12 -6 0 2938 -2 5369 -3 11 5368 2935 2936 -258 0 10 -2 11 -2 5369 -2 11 5368 5369 11 12 -11 0 10 -7 11 5368 5369 11 5368 -3 11 5368 11 12 -30 0 10 5368 5369 11 5368 11 12 -6 0 2939 2925 2926 -2 11 2929 2930 2936 -259 0 16 17 2925 2926 5368 5369 5368 -2 5369 11 12 -7 0 7 -3 8 22 -3 5368 -3 11 -2 5368 5369 11 5369 -3 11 5369 11 21 -3 8 9 -4 0 77 83 77 -19 0 10 -2 11 5369 -2 11 12 -8 0 2928 17 3991 2931 -264 0 2928 2937 -5 11 12 -7 0 13 -2 14 3990 23 -2 5368 1539 -5 11 5368 5369 -6 11 20 -3 14 15 -17 0 7 -4 8 9 -3 0 10 -5 11 12 -277 0 2938 11 5368 11 -2 5369 12 -7 0 10 -7 11 5369 -4 5368 5369 11 5368 -3 11 5368 -2 11 5368 -2 11 12 -17 0 13 14 3990 -2 14 15 -3 0 10 -3 11 5369 11 12 -277 0 2939 31 11 5369 11 5369 12 -7 0 10 5368 -3 5369 5368 -3 11 5369 5368 -3 11 5368 -5 11 5368 -2 11 5368 11 21 -11 8 9 -5 0 10 -3 11 5369 12 -3 0 10 5368 11 5368 -2 11 12 -278 0 10 11 -2 5368 11 12 -7 0 10 5368 -2 5369 5368 -2 11 5369 5368 -3 11 -2 5369 -2 11 5369 1539 11 5368 11 -2 5369 -2 11 20 -3 14 -2 3990 -6 14 15 -5 0 10 5368 -2 11 5368 12 -3 0 10 11 -3 5369 11 12 -14 0 7 -4 8 9 -9 0 7 -6 8 9 -203 0 2909 2910 -6 8 9 -29 0 5372 2926 5368 1539 11 12 -7 0 10 -4 11 5368 -2 11 5369 -3 11 -2 5369 -2 11 5369 5368 11 5368 -3 11 5368 11 5368 -3 11 5368 5369 5368 5369 5368 -3 11 12 -5 0 10 -4 11 12 -3 0 10 11 5368 5369 11 5369 12 -14 0 13 -4 14 15 -9 0 13 -2 14 3990 -3 14 15 -193 0 -8 8 2921 2922 2911 2912 -6 14 15 -3 0 7 -2 8 9 -23 0 2928 -3 17 18 -7 0 10 -3 11 5369 -2 11 5369 -2 11 5368 -3 11 5368 5369 -5 11 5369 11 5368 11 5369 -2 5368 5369 11 5369 5368 -2 11 5369 -2 11 12 -5 0 10 5368 -2 11 5368 12 -3 0 10 1539 11 5369 -2 11 12 -14 0 10 5369 -2 11 5369 12 -6 2068 7 -2 8 22 5369 -2 11 -2 5368 5369 12 -193 0 14 3989 -2 14 3989 -3 14 2923 2924 1834 11 5368 11 1539 5368 -2 11 12 -3 0 13 -2 14 15 -3 0 7 -3 8 9 -27 0 10 -2 5369 -2 11 5369 11 5369 -2 11 5369 5368 11 1539 5368 11 5368 -2 11 5369 -2 11 5368 -2 11 -3 5368 11 5369 -5 11 -2 5369 21 -5 8 22 5368 11 5369 11 21 -3 8 22 -4 5368 11 12 -8 0 7 -5 8 22 -2 11 -2 5368 12 -6 2073 13 14 3989 23 5368 -3 11 5369 11 12 -193 0 -6 11 -2 5369 11 -2 5369 11 -2 5369 5368 11 5368 11 21 -3 8 22 -2 11 12 -3 0 13 14 3990 14 15 -27 0 10 5369 5368 -2 11 5368 11 5368 11 5369 -5 11 5369 -3 11 5368 -2 11 5369 11 5368 -2 11 5368 -2 11 5368 5369 5368 -4 11 20 -5 14 23 -2 11 5369 5368 20 3990 -2 14 23 -3 11 5369 11 12 -8 0 13 -5 14 23 5369 -3 11 12 -6 0 10 5368 -2 11 5368 -5 11 12 -193 0 11 5368 11 5368 11 -2 5369 -3 11 5369 11 5369 11 5369 -3 11 20 -3 14 23 5369 11 21 -3 8 22 -2 5368 5369 12 -27 0 10 -2 11 5369 11 5369 11 5369 -2 11 5368 -3 11 5368 11 5369 5368 5369 -3 11 5368 11 5368 -3 11 -2 5369 5368 -2 11 5368 5369 -3 11 5368 -2 11 5369 11 5368 5369 -2 11 5369 5368 -2 11 5369 5368 -3 11 -2 5369 12 -8 0 10 11 5369 11 5368 -4 11 2940 17 18 -6 0 16 17 2937 -3 5368 -2 5369 -2 11 12 -193 0 -6 11 -2 5369 5368 -2 5369 5368 -4 11 5368 -2 11 -3 5368 5369 -2 5368 20 -3 14 23 11 -2 5369 21 8 2913 2914 -9 0 2909 2910 -13 8 22 -2 11 5368 11 5368 11 5368 11 5369 -4 11 5368 11 5369 5368 -13 11 5369 11 5369 11 5369 -2 11 5369 11 1539 -2 11 5369 11 5368 -2 5369 -3 11 5369 -2 11 -2 5368 5369 11 12 -8 0 10 -3 5369 11 5368 11 5369 11 2941 -10 0 2938 5368 -3 11 5368 11 5368 12 -193 0 1539 5369 11 5369 1539 -2 5369 11 -2 5368 -4 11 5369 -5 11 5369 -2 11 5369 -2 11 5369 -3 5368 -3 11 20 14 2915 2916 2917 2918 -5 8 2921 2922 2911 2912 -3 14 3990 14 3988 3989 -6 14 23 5369 -5 11 5369 -2 11 5369 -3 5368 11 5368 -2 11 5368 -5 11 -2 5368 -3 11 -2 5369 1539 -2 5369 -2 11 5369 11 5369 11 5369 -2 11 5369 -3 11 5369 -2 11 5368 -2 11 -2 5368 11 5368 11 12 -8 0 5372 2926 -3 11 5369 11 1539 30 2942 -10 0 2939 31 -2 11 5368 5369 -2 11 12 -193 0 5368 11 5368 11 5368 -3 11 5369 -3 11 5369 -4 11 5368 11 5368 -2 11 5368 -2 11 5368 11 5368 -6 11 5369 11 1835 2919 2920 -5 14 2923 2924 1834 -3 11 5368 11 5369 -2 11 5368 -6 11 5369 11 5369 11 5369 11 5368 11 5369 5368 -2 11 5368 11 5368 11 5368 11 -2 5368 11 5369 11 5368 5369 11 5369 11 5368 11 5369 11 5368 -4 11 5368 -3 11 -3 5368 -2 11 5368 11 5368 11 5369 -2 11 5368 -2 11 5368 12 -9 0 2928 2937 5369 -2 11 5368 11 12 -12 0 10 -5 11 5369 12 -193 0 5368 5369 5368 5369 5368 -2 11 5369 -2 11 5369 -4 11 5368 -11 11 5368 11 5368 -7 11 -2 5368 5369 -2 5368 -2 11 -2 5369 11 5369 11 -2 5369 11 5369 11 5369 11 5369 -2 11 5369 -2 11 5368 11 5368 11 5368 11 5368 -5 11 5368 -3 11 5369 5368 5369 -2 11 5368 11 5368 -5 11 5369 11 5368 -4 11 5369 -3 11 5368 -7 11 -2 5369 5368 -2 11 -2 5368 11 5368 12 -10 0 2938 -3 11 5369 11 12 -12 0 10 11 5368 -3 11 5369 12 -193 0 5369 11 5368 11 -2 5369 -3 11 5369 -2 11 5369 11 5369 -2 11 5369 5368 -2 11 5368 11 5369 5368 -5 11 5368 -3 11 5368 -5 11 -2 5368 11 5369 -2 11 -2 5368 11 5368 -5 11 5368 5369 -2 11 5369 -2 11 5368 -2 11 5369 11 5369 -6 11 5369 -2 5368 5369 -2 11 5368 -2 11 5369 5368 11 5369 -2 11 5368 5369 11 -2 5368 11 5368 -2 11 5369 11 -2 5368 -2 11 5368 -2 11 -2 5368 5369 -4 11 5369 11 5369 -2 5368 12 -10 0 2939 31 11 5369 11 5369 12 -12 0 10 -4 11 5369 11 12 -193 0 5369 11 5369 -3 11 5368 11 -2 5369 5368 11 5368 5369 5368 -2 11 5368 -2 11 5368 -2 11 5368 -2 11 5369 5368 -3 11 5369 -3 11 5368 11 5368 11 5369 -3 11 5369 11 5369 -2 11 -2 5368 19 -3 11 5369 -5 11 5369 11 5369 11 5369 11 5369 11 5369 5368 -2 11 5368 11 5368 -2 11 5369 -2 5368 11 5369 11 -2 5368 -2 11 -2 5369 5368 5369 5368 -3 11 5369 5368 -2 5369 -5 11 5369 5368 11 5368 -2 11 5369 11 5369 -5 11 5368 12 -11 0 16 -2 17 -2 3991 18 -12 0 10 11 5368 11 5369 5368 11 12 -193 0 11 5368 11 5369 -2 11 5369 -2 11 5369 -4 11 5368 -2 11 -9 5368 -2 11 5369 -3 11 5369 -4 11 5369 11 5369 11 -2 5368 -2 11 5369 11 5369 -6 11 5369 -5 11 5368 11 5368 11 5368 11 5368 11 5369 -3 5368 5369 -2 11 5369 11 5368 -9 11 5369 -2 11 -2 5368 11 5369 11 -2 5369 -5 11 5369 -2 11 5369 5368 -2 11 5369 5368 -4 11 5368 11 5368 11 12 -29 0 10 -2 11 5368 5369 19 5369 12 -193 0 -8 11 5368 5369 11 5368 11 5368 -3 5369 5368 -2 11 5368 -2 11 5368 -6 11 5368 -2 11 5369 -2 5368 5369 -2 5368 -2 11 1539 11 -2 5369 -5 11 5369 -2 11 5369 11 5368 -2 5369 5368 -8 11 5368 -4 11 5368 11 -2 5369 11 5369 5368 11 5368 5369 -2 11 5368 11 -2 5369 -7 11 19 5369 11 -3 5369 5368 11 5368 5369 -8 11 5368 -2 11 5369 -2 11 12 -29 0 10 -4 11 -2 5368 12 -193 0 11 5369 -2 11 5368 5369 5368 -3 11 5368 -4 11 5368 11 5369 -2 11 5369 -2 11 5369 -2 11 5368 -2 11 5368 11 5368 11 5368 11 5369 -3 11 5369 5368 5369 5368 5369 5368 11 5369 11 5368 -4 11 5369 11 -3 5368 -2 11 5369 11 5369 11 5369 11 5369 5368 -4 11 5369 -3 11 5369 -2 5368 -3 11 -2 5369 11 5368 -6 11 5369 11 5369 -3 11 5369 -8 11 5368 -2 11 5368 11 5368 11 5369 5368 5369 11 5369 12 -20 0 7 -4 8 9 -3 0 10 5369 11 5369 11 5369 5368 12 -193 0 -3 11 5369 11 5368 -2 11 5369 -4 11 5369 11 5368 -8 11 5368 5369 11 5369 5368 11 5368 11 -2 5368 5369 -2 11 5369 11 5368 -4 11 5369 11 5369 -3 11 5368 5369 5368 11 5368 -2 11 5369 5368 -2 11 5368 11 5368 11 5368 -2 11 -2 5369 -2 11 5369 -2 11 5368 -3 11 -2 5369 -10 11 5369 1539 -2 5369 11 5369 11 5369 11 5369 -4 11 5369 -2 11 5368 -2 11 5369 5368 11 19 5369 -3 11 12 -20 0 13 -4 14 15 -3 0 10 11 -2 5368 5369 11 5369 12 -193 0 -2 11 -2 5368 11 5368 -3 11 5368 -3 11 5368 -2 5369 5368 -3 11 5368 -3 11 5369 -3 11 5369 5368 11 5368 11 -2 5369 -3 11 -2 5369 -2 11 -2 5369 -3 11 -2 5368 11 -2 5368 -3 11 5368 5369 5368 -2 11 5368 11 5369 -2 11 5368 -5 11 5368 -9 11 -2 5369 -2 11 -2 5369 11 5368 11 5368 11 5369 11 5368 -6 11 5368 5369 -10 11 5369 -5 11 12 -11 0 7 -8 8 22 -3 5369 11 21 -3 8 22 -2 11 5369 5368 -2 11 12 -193 0 11 -2 5369 11 5368 -4 11 5369 11 -3 5368 -2 11 5368 -4 11 5369 11 5369 -6 11 -2 5368 5369 -7 11 5368 19 -2 5369 -2 11 5369 -2 11 5368 -2 11 5369 11 5368 -3 5369 5368 11 5369 -2 11 5368 -2 11 -2 5368 11 5368 -5 11 5369 5368 5369 -7 11 5369 -5 11 5369 11 5368 -3 11 5368 -3 11 5369 -3 11 5369 -2 11 5368 -2 11 5368 11 5369 5368 11 5368 -2 11 12 -11 0 13 -8 14 23 -3 11 5368 20 3989 -2 14 23 -5 11 5369 12 -193 0 -6 11 5368 -6 11 5368 -2 11 5368 -2 5369 -3 11 19 5369 11 5368 -5 11 -2 5369 11 -2 5369 -10 11 5369 -3 11 -2 5369 -3 11 19 5368 -2 11 5369 5368 11 5369 -2 11 5369 -3 5368 5369 11 5369 5368 5369 11 5369 5368 11 5368 5369 -2 11 5368 11 5369 5368 -2 11 5369 -3 11 -2 5368 11 5368 5369 5368 11 5368 -3 5369 5368 -2 11 5368 11 5369 -3 11 -2 5369 -4 11 5369 12 -11 0 10 -4 11 -2 5368 11 5369 -2 11 5369 5368 -2 11 5369 -5 11 5368 5369 11 5368 12 -193 0 -7 11 5368 -2 5369 5368 -2 11 -4 5369 5368 -8 11 5369 -3 11 5368 -3 11 -2 5368 5369 -2 5368 -4 11 5369 11 5369 -3 11 5368 -2 5369 5368 -2 11 -2 5368 -3 11 5368 -2 11 5368 -5 11 5368 11 -2 5369 -4 11 -2 5369 11 5368 5369 -4 11 5369 -2 11 1539 -2 5368 -3 11 5369 -3 11 5369 11 5368 5369 -5 11 -2 5369 -3 11 5369 -4 11 5368 12 -11 0 10 11 5368 -7 11 5369 11 5368 -2 5369 -2 5368 -2 11 5369 -2 5368 -2 11 5368 12 -193 0 -2 5368 11 -2 5369 11 5369 11 5369 11 5369 -3 11 5368 -2 11 5368 11 5368 11 5369 5368 -4 11 5369 -3 11 5369 -2 11 5369 -2 5368 -2 11 -2 5368 -2 11 5368 5369 5368 -2 11 5369 -4 11 5368 5369 -3 11 5369 5368 -2 11 5368 -7 11 5368 -2 11 5369 -2 11 5368 -2 11 5369 5368 11 5369 11 5369 -2 11 5368 5369 5368 11 5368 11 5369 11 5369 11 -3 5369 5368 11 5369 11 5368 5369 -2 11 5369 11 5368 11 5369 5368 19 -3 5368 11 12 -11 0 10 -8 11 5368 -3 5369 -2 11 5369 11 5368 11 5368 11 5368 -2 11 5369 12 -193 0 5368 11 -2 5368 11 -2 5368 11 5369 -3 11 5368 11 5368 -2 11 5368 -2 11 5368 5369 11 5369 5368 -3 11 5369 5368 11 5368 -3 11 -2 5369 -4 11 -2 5368 -2 11 5369 -2 11 5369 -5 11 5369 -3 11 5369 5368 -2 11 5369 -4 5368 5369 11 5369 -2 11 5368 -3 11 5368 11 5368 -2 11 -2 5369 -12 11 19 -3 11 5368 5369 5368 -3 11 5368 11 5369 5368 -5 11 5368 11 5369 -2 11 12 -11 0 10 5368 11 -2 5369 -2 11 5368 -3 5369 -3 11 5368 5369 -3 11 19 5368 -2 11 5369 11 12 -193 0 5369 -2 11 5368 5369 5368 11 5368 -2 5369 -3 11 5368 -2 5369 -7 11 5368 11 5368 -2 11 5368 11 -2 5369 11 -2 5369 -8 11 5368 5369 11 -2 5368 11 5368 5369 5368 11 5369 -6 11 5369 -2 5368 -3 11 5368 -13 11 5368 11 5368 11 5368 11 5369 11 5368 -2 11 5369 -2 11 5368 -3 11 5368 11 5368 5369 -9 11 5369 11 5369 5368 11 5369 11 5369 12 -11 0 5374 -4 5369 11 -2 5369 5368 11 5369 -7 11 5369 5368 -3 11 5368 11 21 8 9 -191 0 -2 5369 -3 11 5369 -3 11 5368 5369 -4 11 5369 5368 -2 11 5369 5368 -3 11 5368 11 5368 -2 11 5368 -3 11 -2 5369 11 5369 11 5368 5369 11 5368 11 -2 5368 -8 11 5368 5369 -5 11 -2 5369 -2 5368 5369 -2 11 5368 -4 11 5369 5368 5369 -7 11 -2 5369 11 5368 11 -2 5368 -4 11 5368 -2 11 -4 5368 11 5369 11 5369 -2 11 5369 11 5368 11 5368 -5 11 5369 -2 11 12 -11 0 2938 11 -3 5368 -3 11 5368 -3 11 5369 5368 11 5369 11 5369 11 5369 -2 11 -3 5369 20 14 15 -191 0 5369 11 5368 11 5369 -2 11 5368 -5 11 5369 11 5369 11 5369 11 5369 -2 11 -3 5368 5369 11 -3 5368 11 -2 5369 -3 11 -2 5369 -4 11 5369 -3 11 -2 5368 11 1539 5368 -2 11 5368 -10 11 5368 5369 11 5369 5368 11 5368 11 -2 5369 11 -2 5369 -5 11 5369 -7 11 -2 5369 -4 11 5369 11 -4 5368 -2 11 5369 5368 -2 11 -4 5369 11 5368 11 5369 5368 -2 11 12 -11 0 2939 31 11 -3 5368 11 -3 5368 -3 11 5369 -2 11 5368 5369 -2 11 5368 -6 11 12 -191 0 -2 11 5369 -3 11 5369 -4 11 5368 -2 11 5369 -3 11 5368 -2 11 5368 11 5369 -2 5368 5369 11 -2 5369 11 5368 11 5369 -6 11 -2 5369 11 5369 5368 -3 11 5368 -3 11 5368 11 5368 5369 -7 11 5368 -2 11 5369 5368 -2 11 5369 -4 11 5369 11 -2 5368 -2 11 -2 5368 -2 11 5369 -3 11 -2 5368 -4 11 -2 5368 -2 11 5368 -4 11 -3 5368 5369 -2 11 5368 11 -3 5369 -4 11 5375 -12 0 10 11 -2 5368 5369 -2 11 5369 11 5369 -7 11 -3 5369 -2 11 5368 -3 11 12 -191 0 11 5369 -3 11 5368 -2 5369 5368 11 5369 -11 11 5369 11 5369 -2 5368 5369 -3 11 5368 11 5368 -4 11 -2 5368 -2 11 5368 5369 5368 -3 11 5368 -2 11 5369 5368 11 5368 -4 11 -2 5368 5369 -2 11 5369 -2 11 -2 5369 11 5368 -2 11 5368 -2 11 5369 5368 11 5368 5369 5368 5369 5368 11 5369 11 5368 -3 11 5368 -2 5369 5368 -11 11 5369 -2 11 5368 -3 11 5369 -4 11 5369 2941 -12 0 10 11 -2 5369 -2 11 5368 -5 11 5368 -2 11 5368 11 5369 5368 -4 11 5369 -2 11 12 -191 0 11 -2 5368 11 5369 11 5369 5368 -7 11 5368 -2 11 5369 -2 5368 11 5368 5369 11 -3 5369 11 5369 5368 11 -2 5368 -10 11 5369 -3 11 5369 -4 11 5368 -2 11 5369 -3 11 5368 5369 11 5368 11 5369 5368 11 5368 11 5369 5368 -3 11 5368 -2 11 -2 5369 -2 11 -2 5369 11 5368 -4 11 -2 5368 -4 11 5369 11 -5 5368 -3 11 -4 5369 -3 11 -2 5369 11 5369 11 30 2942 -12 0 10 11 -2 5369 5368 -4 11 5369 -3 11 5368 -2 11 5368 11 19 11 5368 -3 11 5369 11 12 -191 0 -6 11 5369 -5 11 5368 11 5369 11 5368 11 5368 11 5369 -3 5368 5369 -4 11 5368 11 5368 -10 11 5368 5369 5368 -4 11 5369 -2 11 5369 11 5369 11 5368 -2 11 5368 -2 11 5369 11 5369 -2 5368 5369 11 5369 -2 5368 11 5369 -3 11 5368 11 5368 11 5368 11 -2 5368 -4 11 -2 5368 -2 11 5368 -3 11 5369 11 5369 11 5368 5369 -3 11 5368 -3 11 5368 -2 11 5368 -3 11 5369 12 -13 0 10 -6 11 5368 11 5368 5369 -7 11 5368 5369 11 5369 -3 11 5369 12 -191 0 -5 11 5368 -3 11 5368 11 5368 -2 11 5368 5369 -2 11 5368 -3 11 5369 -2 5368 -4 11 5368 -2 11 5369 5368 5369 -2 5368 -5 11 5368 5369 5368 -3 11 5368 5369 -2 11 5369 5368 11 5368 11 5368 -2 11 5369 11 5369 -4 11 5368 11 -2 5369 11 -2 5369 11 5369 -10 11 5368 5369 5368 -2 11 5368 5369 5368 11 5369 -3 11 5369 5368 11 5369 -2 11 5368 -3 11 5369 -2 11 5368 -3 11 -2 5368 12 -13 0 5374 -5 11 5369 -6 11 5369 5368 -3 11 5369 -3 11 5369 5368 11 5368 12 -191 0 11 -2 5369 -4 11 5369 -4 11 -7 5368 5369 11 1539 11 5369 5368 5369 11 5369 5368 11 1539 11 5369 11 5368 -2 11 5369 11 5368 5369 5368 -2 11 5369 -5 11 -2 5368 -2 11 5369 -6 11 5368 -5 11 5369 -2 5368 5369 -3 11 -2 5369 -8 11 -2 5369 5368 -3 11 -2 5369 -4 11 5368 -2 11 5368 -7 5369 -2 11 5368 -2 11 5369 -2 11 5369 -2 11 12 -13 0 2938 -5 11 -2 5368 -5 11 1539 -3 11 5368 -5 11 5369 -2 5368 12 -191 0 -3 11 5368 5369 5368 11 5369 -5 11 5369 5368 -4 11 5369 -2 11 5368 11 -2 5369 11 5368 -3 11 5369 11 -2 5368 -2 11 -2 5369 11 5368 11 -2 5369 5368 -3 11 5368 -6 11 5368 11 5369 -2 11 5369 5368 -3 11 5368 11 5369 5368 5369 -8 11 -2 5368 -2 11 5369 11 5369 -3 11 5368 11 5369 5368 11 5369 -4 11 5368 11 5368 -2 11 5369 11 5368 11 5369 -4 11 5369 -2 11 19 11 5368 12 -13 0 2939 31 -2 5369 -3 5368 11 5369 11 5368 -3 11 5368 5369 -3 11 5368 -5 11 5369 12 -191 0 5368 11 -3 5368 11 5368 -2 5369 5368 -2 11 5369 11 5369 -2 11 5368 -5 11 5368 -3 11 19 -2 11 5368 -6 11 -2 5369 11 5368 11 -2 5369 5368 -3 11 5369 11 5368 -3 5369 5368 -2 11 5369 -3 11 -2 5369 -2 11 5368 -3 11 5368 -5 11 5368 11 5369 1539 5369 5368 -3 11 5368 11 5369 11 5369 11 5369 -3 11 5368 -2 11 19 5368 -4 11 5369 5368 -3 11 5368 5369 11 -3 5369 -4 11 12 -14 0 10 -4 11 5368 -10 11 19 5369 11 5368 -3 11 5368 11 12 -191 0 5368 -2 11 5369 11 5368 -2 5369 5368 11 5368 11 5368 5369 11 5368 5369 11 5369 -5 11 5369 -2 11 5368 -5 11 -2 5368 11 5369 -2 11 5369 11 5369 -4 11 -2 5368 11 5369 -2 11 -2 5368 19 -3 11 -2 5369 5368 -2 5369 11 5368 -4 11 -3 5369 -2 11 5368 -4 11 5368 5369 11 -2 5368 -4 11 -2 5368 -2 11 5368 -2 5369 5368 11 5369 11 5368 5369 -3 11 5368 -2 11 5369 -6 11 5369 5368 -2 11 12 -14 0 10 -2 5368 -2 11 5368 -2 5369 5368 -2 11 5369 1539 -2 11 5369 -2 5368 5369 11 5368 -3 11 30 18 -191 0)
    )
    (tilemap
      (solid #t)
      (z-pos -1)
      (name "0")
      (width 350)
      (height 80)
      (tiles -12719 0 4105 4106 -348 0 4110 4111 -348 0 4110 4111 -348 0 4110 4111 -348 0 4110 4111 -282 0 4105 4106 -64 0 4110 4111 -282 0 4110 4111 -64 0 4110 4111 -282 0 4110 4111 -64 0 4110 4111 -282 0 4110 4111 -64 0 4110 4111 -282 0 4110 4111 -5 0 4104 4105 -57 0 4110 4111 -282 0 4115 4116 -5 0 4109 4110 -57 0 4110 4111 -289 0 4109 4110 -57 0 4110 4111 -289 0 4109 4110 -57 0 4110 4111 -289 0 4114 4115 -37 0 -5 5400 -6 0 -3 5400 -6 0 4110 4111 -328 0 -5 5404 -6 0 -3 5404 -6 0 4110 4111 -348 0 4110 4111 -348 0 4110 4111 -348 0 4110 4111 -348 0 4110 4111 -348 0 4110 4111 -348 0 4110 4111 -348 0 4110 4111 -348 0 4110 4111 -348 0 4110 4111 -348 0 4110 4111 -348 0 4110 4111 -348 0 4110 4111 -348 0 4110 4111 -348 0 4115 4116 -5479 0)
    )
    (tilemap
      (solid #f)
      (z-pos -50)
      (width 350)
      (height 80)
      (tiles -14044 0 2185 2186 -347 0 2185 2200 2198 2199 2186 -345 0 2192 2187 2188 2187 2198 2186 -344 0 2193 2184 -2 2179 2187 2190 -345 0 2193 2184 2179 2180 2190 -346 0 2193 2184 2180 2198 2186 -346 0 2192 2189 2197 2190 2185 -3 2199 2186 -341 0 2192 2181 2188 2198 2200 2180 2187 2182 2194 -341 0 2192 2188 2181 -2 2196 2189 2182 2194 -341 0 2185 2200 2196 2189 2196 2195 2181 2190 -342 0 2192 -2 2187 2180 2181 2179 2188 2198 2186 -340 0 2185 2200 2179 2196 -2 2180 2196 2179 2196 2198 2186 -338 0 2185 2200 2187 2195 2188 2187 2188 2196 2197 2187 2179 2198 2199 2186 -334 0 2185 2199 2200 2189 2197 2196 2182 -2 2183 2184 2181 2197 -2 2180 2179 2198 2186 -333 0 2193 2183 2184 2181 2182 2183 2194 -2 0 2193 -6 2183 2194 -335 0 2193 2183 2194 -8704 0)
    )
    (trampoline
      (type "stationary")
      (z-pos 50)
      (x 3408)
      (y 1376)
    )
    (trampoline
      (type "stationary")
      (z-pos 1)
      (x 4560)
      (y 1920)
    )
  )
)
