(supertux-level
  (version 3)
  (name (_ "Bouncy, Bouncy Mountainside"))
  (author "FrostC")
  (license "CC-BY-SA 4.0 International")
  (allow-item-pocket "inherit")
  (icon "")
  (icon-locked "")
  (statistics
    (enable-coins #t)
    (enable-badguys #f)
    (enable-secrets #t)
  )
  (sector
    (name "main")
    (ambient-light
      (color 1 1 1)
    )
    (background
      (color 1 1 1)
      (scroll-speed-x -0.1)
      (speed 0)
      (image "/images/background/misc/skybox.png")
      (z-pos -290)
    )
    (background
      (color 1 1 1)
      (scroll-speed-x -2)
      (speed 0)
      (image "/images/background/misc/clouds.png")
      (z-pos -280)
    )
    (background
      (scroll-offset-x -120)
      (color 1 1 1)
      (alignment "bottom")
      (speed 0)
      (image-top "/images/background/misc/transparent_up.png")
      (image "/images/background/antarctic/snowmountain_panorama.png")
      (z-pos -250)
    )
    (camera
      (name "Camera")
      (mode "normal")
    )
    (gradient
      (top_color 0.5 0.7 1)
      (bottom_color 1 1 1)
    )
    (music
      (file "/music/antarctic/midday.music")
    )
    (particles-clouds
    )
    (spawnpoint
      (name "main")
      (x 96)
      (y 1600)
    )
    (tilemap
      (solid #t)
      (z-pos 0)
      (width 120)
      (height 350)
      (tiles -6120 0 -7 8 9 -112 0 -2 14 3990 -4 14 15 -112 0 5369 11 5368 -2 11 -2 5368 12 -112 0 -5 11 5369 11 21 -7 8 9 -104 0 -3 11 -2 5369 -2 11 20 14 3990 -4 14 3989 15 -104 0 -4 11 -2 5368 -2 11 5368 11 5369 11 -2 5369 11 12 -104 0 11 5368 11 5369 5368 11 5369 11 5368 11 -2 5369 5368 11 1539 12 -104 0 -6 11 -2 5369 11 -2 5369 11 -2 5369 5368 12 -104 0 11 5368 11 5368 11 -2 5369 -3 11 5369 11 5369 11 5369 12 -104 0 -6 11 -2 5369 5368 -2 5369 5368 -3 11 12 -104 0 1539 5369 11 5369 1539 -2 5369 11 -2 5368 -4 11 5369 12 -104 0 5368 11 5368 11 5368 -3 11 5369 -3 11 5369 -2 11 12 -104 0 5368 5369 5368 5369 5368 -2 11 5369 -2 11 5369 -4 11 12 -104 0 5369 11 5368 11 -2 5369 -3 11 5369 -2 11 5369 11 5369 12 -104 0 5369 11 5369 -3 11 5368 11 -2 5369 5368 11 5368 5369 5368 12 -104 0 11 5368 11 5369 -2 11 5369 -2 11 5369 -4 11 5368 12 -104 0 -8 11 5368 5369 11 5368 11 5368 5369 12 -104 0 11 5369 -2 11 5368 5369 5368 -3 11 5368 -4 11 12 -104 0 -3 11 5369 11 5368 -2 11 5369 -4 11 5369 11 12 -104 0 -2 11 -2 5368 11 5368 -3 11 5368 -3 11 5368 5369 12 -104 0 11 -2 5369 11 5368 -4 11 5369 11 -3 5368 11 12 -104 0 17 31 -4 11 5368 -6 11 5368 11 12 -105 0 10 -5 11 5368 -2 5369 5368 -2 11 -2 5369 12 -105 0 10 11 -2 5369 11 5369 11 5369 11 5369 -3 11 5368 12 -105 0 10 -2 5368 11 -2 5368 11 5369 -3 11 5368 11 5368 12 -105 0 10 11 5368 5369 5368 11 5368 -2 5369 -3 11 5368 5369 12 -105 0 10 -3 11 5369 -3 11 5368 5369 -4 11 12 -105 0 10 5368 11 5369 -2 11 5368 -5 11 5369 11 12 -105 0 10 5369 -3 11 5369 -4 11 5368 -2 11 5369 12 -105 0 10 -3 11 5368 -2 5369 5368 11 5369 -4 11 12 -105 0 10 5368 11 5369 11 5369 5368 -7 11 12 -105 0 10 -4 11 5369 -5 11 5368 11 5369 12 -105 0 16 -3 17 3991 -3 17 3991 17 3991 -2 17 3991 18 -32024 0)
    )
  )
)
