(supertux-level
  (version 3)
  (name (_ "Bouncy, Bouncy Mountainside"))
  (author "FrostC")
  (license "CC-BY-SA 4.0 International")
  (allow-item-pocket "inherit")
  (icon "")
  (icon-locked "")
  (statistics
    (enable-coins #t)
    (enable-badguys #f)
    (enable-secrets #t)
  )
  (sector
    (name "main")
    (ambient-light
      (color 1 1 1)
    )
    (background
      (color 1 1 1)
      (scroll-speed-x -0.1)
      (speed 0)
      (image "/images/background/misc/skybox.png")
      (z-pos -290)
    )
    (background
      (color 1 1 1)
      (scroll-speed-x -2)
      (speed 0)
      (image "/images/background/misc/clouds.png")
      (z-pos -280)
    )
    (background
      (scroll-offset-x -120)
      (color 1 1 1)
      (alignment "bottom")
      (speed 0)
      (image-top "/images/background/misc/transparent_up.png")
      (image "/images/background/antarctic/snowmountain_panorama.png")
      (z-pos -250)
    )
    (camera
      (name "Camera")
      (mode "normal")
    )
    (coin
      (z-pos 49)
      (x 944)
      (y 1792)
    )
    (coin
      (z-pos 49)
      (x 1040)
      (y 1792)
    )
    (coin
      (z-pos 49)
      (x 1902.04)
      (y 1750.97)
    )
    (coin
      (z-pos 49)
      (x 1824)
      (y 1696)
    )
    (coin
      (z-pos 49)
      (x 1744)
      (y 1648)
    )
    (coin
      (z-pos 49)
      (x 1824)
      (y 1600)
    )
    (coin
      (z-pos 49)
      (x 1904)
      (y 1552)
    )
    (gradient
      (top_color 0.5 0.7 1)
      (bottom_color 1 1 1)
    )
    (infoblock
      (z-pos 51)
      (x 1312)
      (y 1856)
    )
    (jumpy
      (z-pos 50)
      (x 640)
      (y 1824)
    )
    (jumpy
      (z-pos 50)
      (x 864)
      (y 1856)
    )
    (mriceblock
      (z-pos 50)
      (x 1584)
      (y 1920)
    )
    (music
      (file "/music/antarctic/midday.music")
    )
    (particles-clouds
    )
    (smartball
      (z-pos 50)
      (x 2752)
      (y 1568)
    )
    (snowman
      (z-pos 50)
      (x 2656)
      (y 1536)
    )
    (spawnpoint
      (name "main")
      (x 80)
      (y 1728)
    )
    (tilemap
      (solid #t)
      (z-pos 0)
      (width 120)
      (height 350)
      (tiles -4965 0 83 102 83 -355 0 7 -6 8 9 -112 0 13 -6 14 15 -112 0 10 -2 11 5368 11 5368 11 12 -112 0 10 11 -2 5368 -2 11 5368 21 -2 8 9 -109 0 10 -6 11 20 -2 14 15 -13 0 2909 2910 -4 8 9 -89 0 10 -2 11 -2 5369 -2 11 5368 5369 11 12 -11 0 1826 1829 2911 2912 -4 14 15 -89 0 16 17 2925 2926 5368 5369 5368 -2 5369 11 12 -7 0 7 8 2921 2922 1830 1833 1834 11 5368 -2 11 5368 21 -20 8 9 -71 0 2928 2937 -5 11 12 -7 0 13 14 2923 2924 1834 -3 5368 1539 -3 11 20 3989 -14 14 3990 -2 14 3990 14 15 -72 0 2938 11 5368 11 -2 5369 12 -7 0 10 -8 11 -5 5368 5369 11 5368 -3 11 5368 -2 11 5368 -3 11 5368 11 5368 11 5369 5368 12 -72 0 2939 31 11 5369 11 5369 12 -7 0 10 5368 -3 5369 5368 -3 11 5369 5368 -3 11 5368 -5 11 5368 -2 11 5368 -2 11 5369 -4 11 -2 5368 12 -73 0 10 11 -2 5368 11 12 -7 0 10 5368 -2 5369 5368 -2 11 5369 5368 -3 11 -2 5369 -2 11 5369 1539 11 5368 11 -2 5369 -3 11 -2 5369 -2 11 -2 5368 11 12 -35 0 2909 2910 -6 8 9 -29 0 5372 2926 5368 1539 11 12 -7 0 10 -4 11 5368 -2 11 5369 -3 11 -2 5369 -2 11 5369 5368 11 5368 -3 11 5368 11 5368 -4 11 5368 5369 5368 12 -25 0 -8 8 2921 2922 2911 2912 -6 14 15 -3 0 7 -2 8 9 -23 0 2928 -3 17 18 -7 0 10 -3 11 5369 -2 11 5369 -2 11 5368 -3 11 5368 5369 -5 11 5369 11 5368 11 5369 5368 5369 5368 5369 11 5369 5368 12 -25 0 14 3989 -2 14 3989 -3 14 2923 2924 1834 11 5368 11 1539 5368 -2 11 12 -3 0 13 -2 14 15 -3 0 7 -3 8 9 -27 0 10 -2 5369 -2 11 5369 11 5369 -2 11 5369 5368 11 1539 5368 11 5368 -2 11 5369 -2 11 5368 -2 11 -2 5368 5369 5368 11 5369 -2 11 12 -25 0 -6 11 -2 5369 11 -2 5369 11 -2 5369 5368 11 5368 11 21 -3 8 22 -2 11 12 -3 0 13 14 3990 14 15 -27 0 10 5369 5368 -2 11 5368 11 5368 11 5369 -5 11 5369 -3 11 5368 -2 11 5369 11 5368 -2 11 -2 5368 -2 11 5368 5369 12 -25 0 11 5368 11 5368 11 -2 5369 -3 11 5369 11 5369 11 5369 -3 11 20 -3 14 23 5369 11 21 -3 8 22 -2 5368 5369 12 -27 0 10 -2 11 5369 11 5369 11 5369 -2 11 5368 -3 11 5368 11 5369 5368 5369 -3 11 5368 11 5368 -4 11 -2 5369 5368 11 12 -25 0 -6 11 -2 5369 5368 -2 5369 5368 -4 11 5368 -2 11 -3 5368 5369 -2 5368 20 -3 14 23 11 -2 5369 21 8 2913 2914 -9 0 2909 2910 -13 8 22 -2 11 5368 11 5368 11 5368 11 5369 -4 11 5368 11 5369 5368 -14 11 5369 12 -25 0 1539 5369 11 5369 1539 -2 5369 11 -2 5368 -4 11 5369 -5 11 5369 -2 11 5369 -2 11 5369 -3 5368 -3 11 20 14 2915 2916 2917 2918 -5 8 2921 2922 2911 2912 -3 14 3990 14 3988 3989 -6 14 23 5369 -5 11 5369 -2 11 5369 -3 5368 11 5368 -2 11 5368 -5 11 -2 5368 11 5369 -2 11 -2 5369 1539 12 -25 0 5368 11 5368 11 5368 -3 11 5369 -3 11 5369 -4 11 5368 11 5368 -2 11 5368 -2 11 5368 11 5368 -6 11 5369 11 1835 2919 2920 -5 14 2923 2924 1834 -3 11 5368 11 5369 -2 11 5368 -6 11 5369 11 5369 11 5369 11 5368 11 5369 5368 -2 11 5368 11 5368 11 5368 11 -2 5368 11 5369 11 5368 5369 -2 11 5369 11 5368 5369 11 12 -25 0 5368 5369 5368 5369 5368 -2 11 5369 -2 11 5369 -4 11 5368 -11 11 5368 11 5368 -7 11 -2 5368 5369 -2 5368 -2 11 -2 5369 11 5369 11 -2 5369 11 5369 11 5369 11 5369 -2 11 5369 -2 11 5368 11 5368 11 5368 11 5368 -5 11 5368 -3 11 5369 5368 5369 -2 11 5368 11 5368 -5 11 5369 11 5368 12 -25 0 5369 11 5368 11 -2 5369 -3 11 5369 -2 11 5369 11 5369 -2 11 5369 5368 -2 11 5368 11 5369 5368 -5 11 5368 -3 11 5368 -5 11 -2 5368 11 5369 -2 11 -2 5368 11 5368 -5 11 5368 5369 -2 11 5369 -2 11 5368 -2 11 5369 11 5369 -6 11 5369 -2 5368 5369 -2 11 5368 -2 11 5369 5368 11 5369 -2 11 5368 5369 11 -2 5368 12 -25 0 5369 11 5369 -3 11 5368 11 -2 5369 5368 11 5368 5369 5368 -2 11 5368 -2 11 5368 -2 11 5368 -2 11 5369 5368 -3 11 5369 -3 11 5368 11 5368 11 5369 -3 11 5369 11 5369 -2 11 -2 5368 19 -3 11 5369 -5 11 5369 11 5369 11 5369 11 5369 11 5369 5368 -2 11 5368 11 5368 -2 11 5369 -2 5368 11 5369 11 -2 5368 -2 11 -2 5369 5368 5369 5368 -2 11 12 -25 0 11 5368 11 5369 -2 11 5369 -2 11 5369 -4 11 5368 -2 11 -9 5368 -2 11 5369 -3 11 5369 -4 11 5369 11 5369 11 -2 5368 -2 11 5369 11 5369 -6 11 5369 -5 11 5368 11 5368 11 5368 11 5368 11 5369 -3 5368 5369 -2 11 5369 11 5368 -9 11 5369 -2 11 -2 5368 11 5369 12 -25 0 -8 11 5368 5369 11 5368 11 5368 -3 5369 5368 -2 11 5368 -2 11 5368 -6 11 5368 -2 11 5369 -2 5368 5369 -2 5368 -2 11 1539 11 -2 5369 -5 11 5369 -2 11 5369 11 5368 -2 5369 5368 -8 11 5368 -4 11 5368 11 -2 5369 11 5369 5368 11 5368 5369 -2 11 5368 11 -2 5369 -6 11 12 -25 0 11 5369 -2 11 5368 5369 5368 -3 11 5368 -4 11 5368 11 5369 -2 11 5369 -2 11 5369 -2 11 5368 -2 11 5368 11 5368 11 5368 11 5369 -3 11 5369 5368 5369 5368 5369 5368 11 5369 11 5368 -4 11 5369 11 -3 5368 -2 11 5369 11 5369 11 5369 11 5369 5368 -4 11 5369 -3 11 5369 -2 5368 -3 11 -2 5369 11 5368 -5 11 5369 -2 11 12 -25 0 -3 11 5369 11 5368 -2 11 5369 -4 11 5369 11 5368 -8 11 5368 5369 11 5369 5368 11 5368 11 -2 5368 5369 -2 11 5369 11 5368 -4 11 5369 11 5369 -3 11 5368 5369 5368 11 5368 -2 11 5369 5368 -2 11 5368 11 5368 11 5368 -2 11 -2 5369 -2 11 5369 -2 11 5368 -3 11 -2 5369 -12 11 5368 12 -25 0 -2 11 -2 5368 11 5368 -3 11 5368 -3 11 5368 -2 5369 5368 -3 11 5368 -3 11 5369 -3 11 5369 5368 11 5368 11 -2 5369 -3 11 -2 5369 -2 11 -2 5369 -3 11 -2 5368 11 -2 5368 -3 11 5368 5369 5368 -2 11 5368 11 5369 -2 11 5368 -5 11 5368 -9 11 -2 5369 -2 11 -2 5369 11 5368 11 5368 5369 -2 11 12 -25 0 11 -2 5369 11 5368 -4 11 5369 11 -3 5368 -2 11 5368 -4 11 5369 11 5369 -6 11 -2 5368 5369 -7 11 5368 19 -2 5369 -2 11 5369 -2 11 5368 -2 11 5369 11 5368 -3 5369 5368 11 5369 -2 11 5368 -2 11 -2 5368 11 5368 -5 11 5369 5368 5369 -7 11 5369 -8 11 12 -25 0 17 31 -4 11 5368 -6 11 5368 -2 11 5368 -2 5369 -3 11 19 5369 11 5368 -5 11 -2 5369 11 -2 5369 -10 11 5369 -3 11 -2 5369 -3 11 19 5368 -2 11 5369 5368 11 5369 -2 11 5369 -3 5368 5369 11 5369 5368 5369 11 5369 5368 11 5368 5369 -2 11 5368 11 5369 5368 -2 11 5369 -2 11 5368 -2 5369 12 -26 0 10 -5 11 5368 -2 5369 5368 -2 11 -4 5369 5368 -8 11 5369 -3 11 5368 -3 11 -2 5368 5369 -2 5368 -4 11 5369 11 5369 -3 11 5368 -2 5369 5368 -2 11 -2 5368 -3 11 5368 -2 11 5368 -5 11 5368 11 -2 5369 -4 11 -2 5369 11 5368 5369 -4 11 5369 -2 11 1539 -2 5368 -2 11 12 -26 0 10 11 -2 5369 11 5369 11 5369 11 5369 -3 11 5368 -2 11 5368 11 5368 11 5369 5368 -4 11 5369 -3 11 5369 -2 11 5369 -2 5368 -2 11 -2 5368 -2 11 5368 5369 5368 -2 11 5369 -4 11 5368 5369 -3 11 5369 5368 -2 11 5368 -7 11 5368 -2 11 5369 -2 11 5368 -2 11 5369 5368 11 5369 11 5369 -2 11 5368 5369 5368 -3 11 5368 12 -26 0 10 -2 5368 11 -2 5368 11 5369 -3 11 5368 11 5368 -2 11 5368 -2 11 5368 5369 11 5369 5368 -3 11 5369 5368 11 5368 -3 11 -2 5369 -4 11 -2 5368 -2 11 5369 -2 11 5369 -5 11 5369 -3 11 5369 5368 -2 11 5369 -4 5368 5369 11 5369 -2 11 5368 -3 11 5368 11 5368 -2 11 -2 5369 -8 11 5368 5369 5368 12 -26 0 10 11 5368 5369 5368 11 5368 -2 5369 -3 11 5368 -2 5369 -7 11 5368 11 5368 -2 11 5368 11 -2 5369 11 -2 5369 -8 11 5368 5369 11 -2 5368 11 5368 5369 5368 11 5369 -6 11 5369 -2 5368 -3 11 5368 -13 11 5368 11 5368 11 5368 11 5369 11 5368 -2 11 5369 -2 11 12 -26 0 10 -3 11 5369 -3 11 5368 5369 -4 11 5369 5368 -2 11 5369 5368 -3 11 5368 11 5368 -2 11 5368 -3 11 -2 5369 11 5369 11 5368 5369 11 5368 11 -2 5368 -8 11 5368 5369 -5 11 -2 5369 -2 5368 5369 -2 11 5368 -4 11 5369 5368 5369 -7 11 -2 5369 11 5368 11 -2 5368 -2 11 5368 11 5369 12 -26 0 10 5368 11 5369 -2 11 5368 -5 11 5369 11 5369 11 5369 11 5369 -2 11 -3 5368 5369 11 -3 5368 11 -2 5369 -3 11 -2 5369 -4 11 5369 -3 11 -2 5368 11 1539 5368 -2 11 5368 -10 11 5368 5369 11 5369 5368 11 5368 11 -2 5369 11 -2 5369 -5 11 5369 -7 11 5369 -3 11 12 -26 0 10 5369 -3 11 5369 -4 11 5368 -2 11 5369 -3 11 5368 -2 11 5368 11 5369 -2 5368 5369 11 -2 5369 11 5368 11 5369 -6 11 -2 5369 11 5369 5368 -3 11 5368 -3 11 5368 11 5368 5369 -7 11 5368 -2 11 5369 5368 -2 11 5369 -4 11 5369 11 -2 5368 -2 11 -2 5368 -2 11 5369 -3 11 -2 5368 11 5368 30 18 -26 0 10 -3 11 5368 -2 5369 5368 11 5369 -11 11 5369 11 5369 -2 5368 5369 -3 11 5368 11 5368 -4 11 -2 5368 -2 11 5368 5369 5368 -3 11 5368 -2 11 5369 5368 11 5368 -4 11 -2 5368 5369 -2 11 5369 -2 11 -2 5369 11 5368 -2 11 5368 -2 11 5369 5368 11 5368 5369 5368 5369 5368 11 5369 11 5368 -5 11 12 -27 0 10 5368 11 5369 11 5369 5368 -7 11 5368 -2 11 5369 -2 5368 11 5368 5369 11 -3 5369 11 5369 5368 11 -2 5368 -10 11 5369 -3 11 5369 -4 11 5368 -2 11 5369 -3 11 5368 5369 11 5368 11 5369 5368 11 5368 11 5369 5368 -3 11 5368 -2 11 -2 5369 -2 11 -2 5369 11 5368 -4 11 5368 5369 11 12 -27 0 10 -4 11 5369 -5 11 5368 11 5369 11 5368 11 5368 11 5369 -3 5368 5369 -4 11 5368 11 5368 -10 11 5368 5369 5368 -4 11 5369 -2 11 5369 11 5369 11 5368 -2 11 5368 -2 11 5369 11 5369 -2 5368 5369 11 5369 -2 5368 11 5369 -3 11 5368 11 5368 11 5368 11 -2 5368 -4 11 -2 5368 11 5368 12 -27 0 16 -3 17 3991 31 -2 11 5368 11 5368 -2 11 5368 5369 -2 11 5368 -3 11 5369 -2 5368 -4 11 5368 -2 11 5369 5368 5369 -2 5368 -5 11 5368 5369 5368 -3 11 5368 5369 -2 11 5369 5368 11 5368 11 5368 -2 11 5369 11 5369 -4 11 5368 11 -2 5369 11 -2 5369 11 5369 -10 11 5368 5369 5368 -4 11 12 -32 0 10 5369 -4 11 -7 5368 5369 11 1539 11 5369 5368 5369 11 5369 5368 11 1539 11 5369 11 5368 -2 11 5369 11 5368 5369 5368 -2 11 5369 -5 11 -2 5368 -2 11 5369 -6 11 5368 -5 11 5369 -2 5368 5369 -3 11 -2 5369 -8 11 -2 5369 5368 -3 11 5369 -2 11 12 -32 0 10 5369 -5 11 5369 5368 -4 11 5369 -2 11 5368 11 -2 5369 11 5368 -3 11 5369 11 -2 5368 -2 11 -2 5369 11 5368 11 -2 5369 5368 -3 11 5368 -6 11 5368 11 5369 -2 11 5369 5368 -3 11 5368 11 5369 5368 5369 -8 11 -2 5368 -2 11 5369 11 5369 -3 11 5368 11 5369 5368 11 12 -32 0 16 -2 17 3991 -7 17 3991 -5 17 3991 -3 17 3991 -2 17 3991 -9 17 3991 -3 17 3991 -5 17 3991 -3 17 3991 -10 17 3991 -3 17 3991 31 -4 11 5368 11 5369 1539 5369 5368 -3 11 5368 11 5369 11 5369 11 -2 5369 30 18 -96 0 16 -3 17 3991 -4 17 3991 -2 17 -2 3991 -4 17 -2 3991 -2 17 18 -31467 0)
    )
    (tilemap
      (solid #t)
      (z-pos -1)
      (name "0")
      (width 120)
      (height 350)
      (tiles -5933 0 4105 4106 -118 0 4110 4111 -118 0 4110 4111 -118 0 4110 4111 -118 0 4110 4111 -5 0 4104 4105 -111 0 4115 4116 -5 0 4109 4110 -118 0 4109 4110 -118 0 4109 4110 -118 0 4114 4115 -35098 0)
    )
    (tilemap
      (solid #f)
      (z-pos -50)
      (width 120)
      (height 350)
      (tiles -5804 0 2185 2186 -117 0 2185 2200 2198 2199 2186 -115 0 2192 2187 2188 2187 2198 2186 -114 0 2193 2184 -2 2179 2187 2190 -115 0 2193 2184 2179 2180 2190 -116 0 2193 2184 2180 2198 2186 -116 0 2192 2189 2197 2190 2185 -3 2199 2186 -111 0 2192 2181 2188 2198 2200 2180 2187 2182 2194 -111 0 2192 2188 2181 -2 2196 2189 2182 2194 -111 0 2185 2200 2196 2189 2196 2195 2181 2190 -112 0 2192 -2 2187 2180 2181 2179 2188 2198 2186 -110 0 2185 2200 2179 2196 -2 2180 2196 2179 2196 2198 2186 -108 0 2185 2200 2187 2195 2188 2187 2188 2196 2197 2187 2179 2198 2199 2186 -104 0 2185 2199 2200 2189 2197 2196 2182 -2 2183 2184 2181 2197 -2 2180 2179 2198 2186 -103 0 2193 2183 2184 2181 2182 2183 2194 -2 0 2193 -6 2183 2194 -105 0 2193 2183 2194 -34394 0)
    )
  )
)
