(supertux-level
  (version 3)
  (name (_ "Picnic With Penny"))
  (author "SuperTux Team")
  (license "GPL 2+ / CC-by-sa 3.0")
  (allow-item-pocket "inherit")
  (icon "")
  (icon-locked "")
  (statistics
    (enable-coins #t)
    (enable-secrets #t)
  )
  (sector
    (name "main")
    (init-script "import(\"levels/world1/intro.nut\");
logo <- FloatingImage(\"images/engine/menu/logo.png\");
Text.set_anchor_point(ANCHOR_BOTTOM);
Text.set_anchor_offset(0, -160);
start_cutscene();
trigger_state(\"start\");")
    (ambient-light
      (color 1 1 1)
    )
    (background
      (color 1 1 1)
      (alignment "bottom")
      (speed 0)
      (image "/images/background/antarctic/snow_panorama.png")
      (z-pos -290)
    )
    (background
      (color 1 1 1)
      (alignment "bottom")
      (speed 0.01)
      (speed-y 0)
      (image "/images/background/antarctic/ice_floes_back.png")
      (image-bottom "/images/background/antarctic/snow_bottom.png")
      (z-pos -285)
    )
    (background
      (color 1 1 1)
      (alignment "bottom")
      (speed 0.03)
      (speed-y 0)
      (image "/images/background/antarctic/ice_floes_front.png")
      (z-pos -280)
    )
    (background
      (color 1 1 1)
      (scroll-speed-x -0.1)
      (speed 0)
      (image "/images/background/misc/skybox.png")
      (z-pos -292)
    )
    (background
      (color 1 1 1)
      (scroll-speed-x -2)
      (speed 0)
      (image "/images/background/misc/clouds.png")
      (z-pos -291)
    )
    (camera
      (name "Camera")
      (mode "manual")
    )
    (gradient
      (top_color 0.5 0.7 1)
      (bottom_color 1 1 1)
    )
    (music
      (file "/music/misc/intro.music")
    )
    (particles-snow
    )
    (scriptedobject
      (z-pos 50)
      (physic-enabled #f)
      (solid #f)
      (name "RADIO")
      (sprite "images/objects/radio/radio.sprite")
      (x 3292.799)
      (y 1302.4)
    )
    (scriptedobject
      (z-pos -105)
      (physic-enabled #f)
      (solid #f)
      (name "BUSH")
      (sprite "/images/tiles/snow/iceshrub.png")
      (x 3607)
      (y 1220)
    )
    (scriptedobject
      (z-pos 50)
      (name "NOLOK")
      (sprite "images/creatures/nolok/nolok.sprite")
      (x 3631)
      (y 1276)
    )
    (scriptedobject
      (z-pos 50)
      (name "PENNY")
      (sprite "images/creatures/penny/penny.sprite")
      (x 3489)
      (y 1280)
    )
    (scriptedobject
      (z-pos 50)
      (physic-enabled #f)
      (solid #f)
      (name "FISH")
      (sprite "/images/objects/eat-me/eat-me.sprite")
      (x 3408)
      (y 1312)
    )
    (scriptedobject
      (z-pos 20)
      (physic-enabled #f)
      (solid #f)
      (name "LETTER")
      (sprite "/images/objects/letter/letter-small.sprite")
      (x 3360)
      (y 1272)
    )
    (scripttrigger
      (script "wait(2);
Effect.fade_out(2);
wait(2);
Level.finish(true);")
      (button #f)
      (width 32)
      (height 1376)
      (x 4288)
      (y 0)
    )
    (scripttrigger
      (oneshot #t)
      (script "Tux.walk(0);")
      (button #f)
      (width 32)
      (height 1376)
      (x 3392)
      (y 0)
    )
    (spawnpoint
      (name "main")
      (x 1)
      (y 1)
    )
    (tilemap
      (solid #f)
      (z-pos -100)
      (width 200)
      (height 50)
      (tiles -7062 0 1321 1322 1323 1324 -182 0 122 209 123 -11 0 1325 1326 1327 1328 -8 0 122 209 123 -10 0 122 123 -147 0 122 123 -10 0 124 210 125 -5 0 106 107 108 -3 0 1329 1330 1331 1332 -8 0 124 210 125 -10 0 124 125 -2 0 122 123 -124 0 1321 1322 1323 1324 -15 0 124 125 -10 0 124 210 125 0 24 -3 0 109 110 111 0 24 0 1333 1334 1335 1336 -8 0 1345 1346 1344 -2 0 24 -2 0 24 -4 0 1345 1344 -2 0 124 125 -8 0 1321 1322 1323 1324 -68 0 1321 1322 1323 1324 -32 0 122 209 123 -5 0 1325 1326 1327 1328 -6 0 122 123 -6 0 24 1345 1344 -2 0 24 -7 0 1345 1346 1344 -40 0 124 125 -8 0 1325 1326 1327 1328 -54 0 122 209 123 -11 0 1325 1326 1327 1328 -17 0 122 209 123 -12 0 124 210 125 -5 0 1329 1330 1331 1332 106 107 108 -3 0 1345 1344 0 24 -11 0 106 107 108 -11 0 106 -34 0 1345 1344 -2 0 106 107 108 -3 0 1329 1330 1331 1332 -20 0 106 107 108 -14 0 106 107 108 -14 0 124 210 125 -2 0 106 107 108 -6 0 1329 1330 1331 1332 -17 0 124 210 125 -4 0 24 -7 0 1345 1346 1344 -5 0 1333 1334 1335 1336 109 110 111 -18 0 109 110 111 -50 0 109 110 111 0 24 0 1333 1334 1335 1336 -15 0 24 -4 0 109 110 111 -6 0 24 0 24 -5 0 109 110 111 -9 0 24 0 24 -2 0 1345 1346 1344 -2 0 109 110 111 -2 0 24 -3 0 1333 1334 1335 1336 0 24 -15 0 1345 1346 1344 0 24 -1601 0)
    )
    (tilemap
      (solid #t)
      (z-pos 0)
      (width 200)
      (height 50)
      (tiles -7649 0 2909 2910 -37 8 9 -144 0 2909 2910 -12 8 2921 2922 2911 2912 -13 14 3990 -2 14 3989 -4 14 3989 3990 -10 14 3990 -3 14 113 -2 8 9 -134 0 2909 2910 -3 8 2921 2922 2911 2912 -12 14 2923 2924 1834 -5 11 5369 11 5368 -4 11 -2 5368 -2 11 5368 5369 -10 11 5368 11 5368 -2 11 5368 -4 11 20 -2 14 113 -2 8 9 -105 0 -24 8 2921 2922 2911 2912 -3 14 2923 2924 1834 -3 11 5368 11 -2 5369 -9 11 5369 -3 11 5369 -3 11 -2 5368 -4 11 5369 11 -5 5368 -3 11 -3 5369 -2 11 1539 11 -2 5369 -4 11 5368 11 5368 11 20 -2 14 113 -105 8 -3 14 3989 -6 14 3990 -3 14 3990 -5 14 -2 3990 -2 14 2923 2924 1834 -14 11 5369 -5 11 5369 -6 11 -2 5369 11 5369 5368 11 5368 5369 5368 11 5368 -3 11 5369 5368 -2 11 5369 5368 -5 11 5368 11 5369 5368 5369 -10 11 20 -2 14 3990 -6 14 3990 14 3990 -3 14 3989 -4 14 3988 -7 14 3990 -3 14 3989 -2 14 3990 -69 14 -3 11 -2 5368 -4 11 5368 -3 11 5369 -2 11 5369 -3 11 5369 11 5368 -2 11 5369 11 -2 5369 -11 11 5368 -3 11 5368 11 5368 -2 11 -2 5369 -8 11 5368 5369 5368 11 5369 -3 11 5369 5368 11 5369 19 11 5369 -6 11 5369 -3 11 5369 -2 5368 11 5369 11 -2 5368 -2 11 -2 5369 11 5368 -3 11 5369 11 -2 5368 11 5369 -6 11 5369 5368 -6 11 5368 11 -2 5368 5369 11 -2 5369 11 5369 -3 11 -2 5368 -2 5369 -32 11 19 -32 11 5369 -8 11 -2 5369 5368 -3 11 5369 -5 11 5369 -2 11 5368 -2 11 5368 -3 11 5369 -3 5368 11 -2 5368 5369 -3 11 -2 5368 5369 5368 5369 5368 5369 5368 -2 11 5368 5369 5368 -5 11 -3 5369 5368 11 5369 -3 11 5369 -2 11 5368 -3 11 5368 11 5368 11 5368 11 -2 5369 -5 11 -2 5368 -8 11 5369 -3 11 5369 11 5369 -9 11 5368 5369 -2 11 -2 5368 5369 -6 11 5368 11 5369 11 5368 11 5369 5368 -7 11 19 -55 11 5368 11 5368 5369 -2 5368 11 5368 11 -2 5368 -9 11 5369 -5 11 -2 5369 -3 5368 5369 11 5368 -4 11 5369 5368 5369 -3 11 5369 -3 11 -2 5369 11 5368 11 -2 5368 -2 11 5368 11 5369 -4 11 5368 11 5368 -2 11 5369 11 5368 11 5369 1539 -2 11 19 5369 -3 11 5369 -2 5368 -5 11 -2 5369 5368 5369 5368 -2 11 5369 -2 11 5369 11 5368 5369 5368 -3 11 5369 -2 11 1539 5369 -2 11 5368 11 5368 -3 11 5368 11 5369 -9 11 5369 11 5369 11 5369 -3 11 -2 5368 -60 11 -2 5369 -6 11 5368 11 5368 5369 5368 11 -4 5368 -7 11 5369 -3 11 -2 5369 11 5368 -3 11 5369 5368 5369 -2 11 5368 11 5368 -3 11 5368 -3 11 5369 -3 11 5369 -4 11 5368 11 5368 -2 11 5368 5369 11 5368 11 5368 -2 11 5369 -3 11 5369 -4 11 5369 5368 5369 5368 5369 5368 5369 5368 -2 5369 -3 11 5369 11 5369 5368 -5 11 5368 11 5368 11 5368 11 5368 11 5369 1539 -2 11 5368 -4 11 5369 -2 5368 11 -2 5369 -2 5368 -2 11 -2 5369 5368 5369 5368 -3 11 5369 -59 11 -2 5369 -2 11 -2 5369 11 5368 -4 11 5368 -3 11 5368 11 5368 5369 -7 11 5368 5369 11 5369 -3 11 5369 -3 11 -2 5369 11 -2 5368 -2 11 5368 1539 -2 11 5369 11 5369 11 -2 5368 11 5368 -2 5369 5368 11 5369 11 5368 5369 -3 11 5368 -2 11 5369 -4 11 5368 -3 11 5368 -3 11 5369 -6 11 -2 5369 11 -2 5368 11 -2 5368 -2 11 5368 -3 5369 5368 -3 11 5368 -3 11 -2 5369 -2 11 5369 -2 11 5368 11 5368 5369 11 5369 11 -2 5368 -6 11 5369 -2 11 5369 -3 11 5369 -56 11 5368 11 -2 5369 -2 11 -2 5368 11 -2 5368 11 -2 5368 -3 11 5368 5369 5368 -2 11 5369 5368 11 5369 -3 11 -2 5369 -2 11 5369 -2 5368 5369 -43 11 5369 -3 11 -2 5369 -2 11 5368 11 -2 5369 -3 11 -2 5368 -8 11 -6 5368 1539 -2 5368 5369 11 5368 -4 11 5368 11 5368 11 -2 5369 -2 11 5369 5368 11 5369 -2 11 5369 11 5369 -3 11 5369 -3 11 5369 -61 11 5369 11 5369 -3 11 5369 -3 11 5369 -3 11 5368 5369 -2 11 5368 5369 -3 11 5368 -2 11 5368 11 5369 -75 11 5368 5369 11 5368 -6 11 5369 -4 11 -2 5369 11 5369 -4 11 -2 5368 -7 11 5369 11 5368 -51 11)
    )
    (tilemap
      (solid #f)
      (alpha 0.8)
      (z-pos 100)
      (width 200)
      (height 50)
      (tiles -9000 0 2019 2140 2141 2142 2019 2140 2141 2142 2019 2140 2141 2142 2019 2140 2141 2142 2019 2140 2141 2142 2019 2140 2141 2142 2019 2140 2141 2142 2019 2140 2141 2142 2019 2140 2141 2142 2019 2140 2141 2142 2019 2140 2141 2142 2019 2140 2141 2142 2019 2140 2141 2142 2019 2140 2141 2142 2019 2140 2141 2142 2019 2140 2141 2142 2019 2140 2141 2142 2019 2140 2141 2142 2019 2140 2141 2142 2019 2140 2141 2142 2019 2140 2141 2142 2019 2140 2141 2142 2019 2140 2141 2142 2019 2140 2141 2142 2019 2140 2141 2142 2019 2140 2141 2142 2019 2140 2141 2142 2019 2140 2141 2142 2019 2140 2141 2142 2019 2140 2141 2142 2019 2140 2141 2142 2019 2140 2141 2142 2019 2140 2141 2142 2019 2140 2141 2142 2019 2140 2141 2142 2019 2140 2141 2142 2019 2140 2141 2142 2019 2140 2141 2142 2019 2140 2141 2142 2019 2140 2141 2142 2019 2140 2141 2142 2019 2140 2141 2142 2019 2140 2141 2142 2019 2140 2141 2142 2019 2140 2141 2142 2019 2140 2141 2142 2019 2140 2141 2142 2019 2140 2141 2142 2019 2140 2141 2142 2019 2140 2141 2142 -800 2020)
    )
    (tilemap
      (solid #f)
      (z-pos -110)
      (width 200)
      (height 50)
      (tiles -7312 0 122 123 -190 0 122 123 -6 0 124 125 -190 0 124 125 -6 0 124 125 -3 0 122 123 -185 0 124 125 -6 0 124 125 -3 0 124 125 -185 0 124 125 -6 0 124 125 -3 0 124 125 -185 0 1345 1344 -6 0 1345 1344 -3 0 1345 1344 -1681 0)
    )
    (tilemap
      (solid #f)
      (speed-x 0.8)
      (speed-y 0.8)
      (z-pos -120)
      (width 200)
      (height 50)
      (tiles -10000 0)
    )
  )
)
