(supertux-level
  (version 3)
  (name (_ "The Journey Begins"))
  (author "Carsten Wirtz")
  (license "CC-BY-SA 4.0 International")
  (allow-item-pocket "inherit")
  (icon "")
  (icon-locked "")
  (statistics
    (enable-coins #t)
    (enable-badguys #f)
    (enable-secrets #t)
  )
  (sector
    (name "main")
    (ambient-light
      (color 1 1 1)
    )
    (background
      (color 1 1 1)
      (speed 0.5)
      (image-top "/images/background/misc/transparent_up.png")
      (image "/images/background/antarctic/snowy_trees.png")
      (image-bottom "/images/background/antarctic/snow_bottom.png")
      (z-pos -200)
    )
    (background
      (color 1 1 1)
      (alignment "bottom")
      (speed 0)
      (image-top "/images/background/misc/transparent_up.png")
      (image "/images/background/antarctic/snow_panorama.png")
      (z-pos -250)
    )
    (background
      (color 1 1 1)
      (scroll-speed-x -0.1)
      (speed 0)
      (image "/images/background/misc/skybox.png")
      (z-pos -290)
    )
    (background
      (color 1 1 1)
      (scroll-speed-x -2)
      (speed 0)
      (image "/images/background/misc/clouds.png")
      (z-pos -280)
    )
    (bonusblock
      (type "orange")
      (z-pos 51)
      (x 3168)
      (y 736)
    )
    (bonusblock
      (type "purple")
      (z-pos 51)
      (x 10864)
      (y 736)
    )
    (camera
      (name "Camera")
      (mode "normal")
    )
    (decal
      (z-pos -10)
      (sprite "/images/decal/snow/igloo_bg.png")
      (x 11680)
      (y 576)
    )
    (decal
      (z-pos 100)
      (sprite "/images/decal/snow/igloo_fg.png")
      (x 11680)
      (y 576)
    )
    (decal
      (z-pos -10)
      (sprite "/images/decal/explanations/billboard-star.png")
      (x 6560)
      (y 544)
    )
    (decal
      (z-pos -10)
      (sprite "/images/decal/explanations/billboard-star.png")
      (x 1984)
      (y 512)
    )
    (firefly
      (z-pos 0)
      (x 6448)
      (y 512)
    )
    (gradient
      (top_color 0.5 0.7 1)
      (bottom_color 1 1 1)
    )
    (jumpy
      (z-pos 50)
      (x 5248)
      (y 672)
    )
    (mrbomb
      (z-pos 50)
      (direction "left")
      (x 9088)
      (y 768)
    )
    (mrbomb
      (z-pos 50)
      (direction "left")
      (x 4000)
      (y 736)
    )
    (mriceblock
      (z-pos 50)
      (direction "left")
      (x 3168)
      (y 608)
    )
    (music
      (file "/music/antarctic/midday.music")
    )
    (path
      (name "gen16170397632312775096672")
      (path
        (mode "oneshot")
        (adapt_speed #f)
        (node
          (x 6400)
          (y 640)
        )
      )
    )
    (secretarea
      (fade-tilemap "secret")
      (width 64)
      (height 224)
      (x 6432)
      (y 640)
    )
    (sequencetrigger
      (sequence "stoptux")
      (width 64)
      (height 768)
      (x 11936)
      (y 0)
    )
    (sequencetrigger
      (sequence "endsequence")
      (width 32)
      (height 768)
      (x 11200)
      (y 0)
    )
    (smartball
      (z-pos 50)
      (direction "left")
      (x 2720)
      (y 704)
    )
    (smartball
      (z-pos 50)
      (direction "left")
      (x 5632)
      (y 768)
    )
    (smartball
      (z-pos 50)
      (direction "left")
      (x 6080)
      (y 768)
    )
    (smartball
      (z-pos 50)
      (direction "left")
      (x 10496)
      (y 512)
    )
    (smartball
      (z-pos 50)
      (direction "left")
      (x 9792)
      (y 512)
    )
    (smartblock
      (z-pos 50)
      (direction "left")
      (x 4320)
      (y 512)
    )
    (snowball
      (z-pos 50)
      (direction "left")
      (x 1184)
      (y 768)
    )
    (snowball
      (z-pos 50)
      (direction "left")
      (x 7968)
      (y 832)
    )
    (snowball
      (z-pos 50)
      (direction "left")
      (x 8064)
      (y 832)
    )
    (snowball
      (z-pos 50)
      (direction "left")
      (x 8352)
      (y 832)
    )
    (snowball
      (z-pos 50)
      (direction "left")
      (x 8448)
      (y 832)
    )
    (snowball
      (z-pos 50)
      (direction "left")
      (x 2528)
      (y 704)
    )
    (snowball
      (z-pos 50)
      (direction "left")
      (x 2624)
      (y 704)
    )
    (spawnpoint
      (name "main")
      (x 96)
      (y 608)
    )
    (sspiky
      (z-pos 50)
      (direction "left")
      (x 7232)
      (y 704)
    )
    (stalactite
      (z-pos -1)
      (x 3312)
      (y 704)
    )
    (stalactite
      (z-pos -1)
      (x 4160)
      (y 608)
    )
    (tilemap
      (solid #f)
      (z-pos -100)
      (width 380)
      (height 35)
      (tiles -5836 0 106 107 108 -178 0 106 107 108 -191 0 24 0 2621 -2 0 109 110 111 -163 0 24 -2 0 2622 -11 0 109 110 111 -3 0 2621 -2 0 24 -149 0 122 123 -2 0 122 123 -247 0 130 -126 0 124 125 -2 0 124 125 -99 0 24 2621 -146 0 129 -34 0 106 107 108 -89 0 1345 1344 -2 0 1345 1344 24 -246 0 129 -32 0 24 0 109 110 111 -342 0 129 -52 0 122 123 -3 0 122 123 -35 0 106 107 108 -79 0 5203 5204 -74 0 106 107 108 -124 0 129 -40 0 2622 -6 0 122 123 -3 0 124 125 -3 0 124 125 -3 0 122 123 -17 0 24 -12 0 109 110 111 -4 0 2621 -9 0 24 -2 0 5203 5204 -76 0 106 107 108 -9 0 122 123 -11 0 122 123 -22 0 24 -10 0 109 110 111 -53 0 122 123 -2 0 122 123 -65 0 129 -8 0 106 107 108 -36 0 124 125 -3 0 124 125 -3 0 124 125 -3 0 124 125 -90 0 5203 5204 -30 0 2622 -5 0 109 110 111 -9 0 124 125 -11 0 124 125 -49 0 122 123 -2 0 122 123 -34 0 124 125 -2 0 124 125 -61 0 2623 2624 -2 0 4967 -3 0 2622 0 24 -2 0 109 110 111 -16 0 24 0 2621 -17 0 1345 1344 -3 0 1345 1344 5203 5204 0 1345 1344 0 2622 0 1345 1344 -138 0 2622 0 1345 1344 -11 0 1345 1344 -45 0 122 123 -2 0 124 125 -2 0 124 125 -2 0 122 123 -21 0 106 107 108 -3 0 24 -2 0 1345 1344 -2 0 1345 1344 -227 0 2625 2626 -101 0 124 125 -2 0 124 125 -2 0 124 125 -2 0 124 125 -21 0 109 110 111 -20 0 106 107 108 -181 0 2623 2624 -4 0 2622 -131 0 1345 1344 -2 0 1345 1344 -2 0 1345 1344 -2 0 1345 1344 -7 0 5203 5204 -2 0 2625 2626 -28 0 2621 -2 0 109 110 111 -674 0 4137 4138 4139 4140 -373 0 2622 -2 0 4141 4142 4143 4144 -2067 0)
    )
    (tilemap
      (solid #f)
      (z-pos 100)
      (width 380)
      (height 35)
      (tiles -6811 0 130 -379 0 129 -379 0 129 -379 0 129 -379 0 129 -379 0 129 -379 0 4967 -1928 0 5540 0 5538 5539 5540 -375 0 5547 5539 5548 5549 5547 5540 -13 0 5538 5539 5540 -27 0 5538 5539 5540 -146 0 5538 -2 5539 5540 -24 0 5538 -3 5539 5540 -144 0 5538 -2 5539 5540 0 -2 5549 -2 5543 5549 5547 5539 5540 -2 0 5538 -3 5539 5540 -3 0 5538 5548 5543 5547 5539 5540 -8 0 5538 5539 5540 -13 0 5538 5548 5549 5547 5540 -6 0 5538 -3 5539 5540 -7 0 5538 -2 5539 5540 -34 0 5538 -2 5539 5540 -6 0 5538 5539 5540 -38 0 5538 -2 5539 5540 -32 0 5538 5539 5548 -2 5543 5547 5540 -12 0 5538 -2 5539 5540 -6 0 5538 5548 -2 5543 5549 5547 -2 5539 5540 -14 0 5538 -2 5539 5540 -115 0 5538 -2 5539 5540 -2 0 5538 5539 5548 5549 5543 5547 5539 5549 -3 5543 5549 5543 5549 5547 -2 5539 5548 -2 5549 5543 5547 -3 5539 5548 5543 5549 5543 5549 5547 5540 0 5538 5539 5540 -2 0 5538 5548 5549 5547 5539 5540 -8 0 5538 -2 5539 5548 5543 -2 5549 5547 5540 -2 0 5538 -2 5539 5548 5543 -2 5549 5547 -2 5539 5540 0 5538 -2 5539 5548 5549 5543 5547 -2 5539 5540 -23 0 5538 -2 5539 5540 0 5538 -2 5539 5548 -2 5549 5547 5539 5540 0 5538 -2 5539 5548 5543 5547 -2 5539 5540 -5 0 5538 5539 5540 -20 0 5538 5539 5540 -2 0 5538 5539 5548 5549 5543 5547 5540 -2 0 5538 -2 5539 5540 -20 0 5538 -4 5539 5548 -3 5543 5549 5543 5547 5540 -9 0 5538 5539 5548 -2 5549 5547 5539 5540 0 5538 -2 5539 5548 5543 5549 5543 -4 5549 5547 5539 5540 -11 0 5538 5548 -2 5543 5547 -2 5539 5540 -3 0 5538 5539 5540 -19 0 5538 -4 5539 5540 -61 0 5538 -4 5539 5540 -13 0 5538 5548 -2 5543 5547 -2 5539 5548 5549 5543 -2 5549 -2 5543 -3 5549 5543 -2 5549 -2 5543 5549 5543 5549 -3 5543 5549 5543 5549 5543 5549 5543 5549 -2 5543 5549 5547 5539 5548 5549 5547 -2 5539 5548 5543 5549 5543 5549 5547 5539 5540 -4 0 5538 5539 5548 -7 5543 5547 -2 5539 5548 5549 -2 5543 -3 5549 5543 -2 5549 5547 5539 5548 -3 5543 -2 5549 -3 5543 5547 5539 5540 -20 0 5538 5548 5549 5543 5547 5539 5548 -2 5549 5543 5549 -3 5543 5547 5539 5548 5549 -6 5543 5547 5540 -2 0 5538 5539 5548 5543 5547 5540 -18 0 5538 5548 5543 5547 -2 5539 5548 -5 5549 5547 -2 5539 5548 -2 5549 5547 -2 5539 5540 -15 0 5538 5539 5548 5543 5549 -4 5543 5549 5543 5549 5543 5549 5547 -2 5539 5540 -4 0 5538 5539 5548 5543 5549 5543 -2 5549 5543 5547 5539 5548 5549 5543 5549 5543 5549 5543 -3 5549 -3 5543 5547 -2 5539 5540 -6 0 5538 5539 5548 5543 5549 5543 5549 -2 5543 5547 -3 5539 5548 5549 5547 5539 5540 -15 0 5538 5539 5548 -2 5543 -2 5549 5547 -3 5539 5540 -53 0 5538 -3 5539 5548 5543 5549 5543 5549 5547 5539 5540 -7 0 5538 -3 5539 5548 -5 5549 -2 5543 -3 5549 -2 5543 -3 5549 5543 5549 -6 5543 -2 5549 -5 5543 -3 5549 5543 -3 5549 5543 5549 5543 -10 5549 5543 5547 5540 -2 0 5538 5548 -7 5543 5549 5543 5549 -3 5543 -2 5549 5543 5549 -3 5543 5549 5543 5549 5543 -6 5549 -2 5543 -3 5549 5547 5540 -18 0 5538 5548 5549 5543 -2 5549 5543 -3 5549 -3 5543 -9 5549 -2 5543 5549 5543 5547 -2 5539 5548 -3 5549 5543 5547 5540 -16 0 5538 5548 5549 -2 5543 5549 5543 5549 5543 5549 5543 5549 -2 5543 -4 5549 -2 5543 5549 5543 5547 5540 -13 0 5538 5548 5543 5549 5543 -4 5549 5543 5549 5543 -2 5549 -2 5543 5549 5543 5547 5540 -2 0 5538 5548 -2 5549 -2 5543 -3 5549 -10 5543 -3 5549 -3 5543 5549 5543 5549 5547 5539 5540 -2 0 5538 5539 5548 5543 5549 -2 5543 -4 5549 5543 -6 5549 5543 5547 5539 5540 -11 0 5538 5539 5548 5543 5549 -2 5543 -2 5549 5543 -3 5549 5547 5539 5540 -49 0 5538 5539 5548 5543 5549 -7 5543 5549 5547 5539 5540 -3 0 5538 5539 5548 5549 -2 5543 5549 -11 5543 -2 5549)
    )
    (tilemap
      (solid #t)
      (z-pos 0)
      (width 380)
      (height 35)
      (tiles -5074 0 2947 -185 0 78 83 78 83 78 -943 0 7 -11 8 9 -152 0 -2 44 -3 0 7 -8 8 9 -5 0 7 -15 8 9 -178 0 13 -2 14 3990 -4 14 -2 3990 -2 14 15 -152 0 -2 44 -3 0 13 -2 14 3989 -5 14 15 -5 0 13 -7 14 3990 -7 14 15 -105 0 44 -35 0 7 8 9 -10 0 7 8 9 -21 0 5372 2926 5369 2929 2930 3991 17 3991 2925 2926 11 2929 5373 -59 0 7 -2 8 9 -12 0 103 -76 0 2067 2069 -3 0 5372 2926 19 5368 5369 5368 11 2929 2930 18 -5 0 16 2925 2926 -2 5368 11 -2 5368 -3 5369 5368 -2 5369 2929 2930 18 -127 0 78 83 78 -2 0 78 83 78 -6 0 13 14 113 -10 8 114 14 15 -22 0 2928 17 2931 -5 0 2928 17 2931 -40 0 44 0 44 -17 0 13 -2 14 15 -89 0 5420 2074 -4 0 2928 -5 17 2931 -9 0 2928 -3 17 2925 2926 5369 5368 11 2929 2930 17 2931 -6 0 2067 2068 2069 -43 0 -8 8 9 -34 0 102 83 -7 0 44 -5 0 44 -32 0 10 5369 20 -9 14 3989 23 5368 12 -91 0 7 8 3045 17 3991 18 -92 0 -2 44 -22 0 2928 3991 -2 17 2931 -9 0 2072 2073 2074 -43 0 -3 14 3990 14 3990 -2 14 15 -11 0 83 -4 0 83 -4 0 83 -60 0 5372 2926 -2 5368 2929 2930 -4 17 2925 2926 5368 5369 2929 5373 -3 0 2067 2068 2069 -31 0 7 -4 8 2913 2914 -26 0 44 -7 0 44 -12 0 13 14 3048 -14 0 7 8 9 -78 0 -2 44 -82 0 11 5368 11 -2 5369 5368 -2 5369 21 -3 8 9 -35 0 2909 2910 -2 8 9 -5 0 7 -27 8 9 -5 0 2928 -2 17 2931 -6 0 2928 -2 17 2931 -4 0 2072 2073 2074 -19 0 -3 83 102 83 -7 0 13 -3 14 3989 2915 2916 1832 1827 -43 0 7 8 22 5369 12 -2 0 7 -11 8 114 14 113 -9 8 2913 2914 -67 0 2067 2069 -82 0 11 5369 -2 5368 5369 -3 5368 20 -3 14 15 -27 0 2909 2910 -4 8 2921 2922 2911 2912 -2 14 15 -5 0 13 -3 14 3990 -7 14 3989 -9 14 3990 -2 3988 3990 -2 14 15 -29 0 7 -9 8 9 -17 0 5370 5368 11 -3 5368 1835 1836 1831 2917 2918 -2 8 9 -4 0 7 -3 8 9 -29 0 13 14 23 5369 12 -2 0 13 3990 -2 14 3990 -7 14 23 5368 20 -7 14 3989 14 2915 2916 3139 3140 -21 0 -3 83 -6 0 83 102 83 -32 0 5420 2074 -44 0 7 -37 8 11 -2 5369 5368 5369 -2 5368 -3 5369 -2 5368 21 -25 8 2921 2922 2911 2912 3990 -3 14 2923 2924 1834 -3 11 12 -5 0 10 -3 5368 -3 11 5368 -2 5369 5368 5369 -4 5368 11 5369 5368 11 5369 5368 11 -2 5369 -2 5368 5369 5375 -29 0 13 -9 14 15 -17 0 2934 2925 2926 5369 11 -3 5368 1835 2919 2920 14 3988 15 -4 0 13 14 3989 14 15 -4 0 7 -5 8 9 -7 0 7 -5 8 9 -4 0 10 -2 5368 5369 12 -2 0 16 -9 17 2925 2926 11 5368 11 5369 11 -3 5368 -2 5369 5368 -2 11 1835 3143 3144 3149 -43 0 7 -9 8 9 -56 0 13 -3 14 3990 -5 14 3990 3989 -12 14 3990 -2 14 3988 -8 14 3990 14 -3 5368 -6 5369 11 5369 11 20 -6 14 3988 -10 14 3990 -2 14 3990 -4 14 2923 2924 1834 11 5368 5369 5368 5369 -6 11 12 -5 0 10 -2 11 5369 -2 11 -3 5368 11 5368 -3 5369 -2 5368 5369 5368 5369 11 5368 5369 5368 11 5369 -3 5368 2941 -29 0 10 5368 11 5369 5368 5369 5368 11 -2 5369 21 -11 8 9 -7 0 2928 2933 11 -2 5368 11 5368 11 -2 5368 19 12 -4 0 10 -3 5369 12 -4 0 13 -5 14 15 -7 0 13 -4 14 3990 15 -4 0 10 5369 5368 5369 12 -5 0 -3 44 0 -3 44 0 2928 31 11 -3 5368 5369 -2 5368 11 5369 5368 11 5369 11 5368 3147 3151 3152 -36 0 7 8 9 -3 0 13 -4 14 3990 -4 14 15 -56 0 10 5368 -2 11 5368 -3 5369 -2 5368 -4 5369 11 5369 -2 5368 5369 -2 11 -4 5369 5368 -4 5369 5368 11 5369 5368 5369 5368 5369 -3 5368 -2 5369 5368 5369 -5 5368 -2 5369 -2 5368 -2 5369 5368 5369 5368 -3 11 -2 5369 11 -2 5369 5368 -2 5369 11 -6 5368 5369 11 5368 -2 5369 5368 -4 5369 -3 11 5368 21 -5 8 22 5369 11 -2 5368 -3 11 5369 11 -2 5368 11 5369 5368 5369 11 -2 5368 -2 5369 11 5368 5369 5368 5369 2929 2930 2942 -7 0 7 -21 8 22 5368 11 5369 5368 5364 5365 -3 5369 20 -2 14 3990 3989 -7 14 15 -8 0 2934 2937 5369 -2 5368 1539 5369 11 -2 5368 12 -4 0 10 11 5368 1539 12 -4 0 10 5369 5368 5369 11 5369 5375 -7 0 5374 5368 5369 11 5369 5368 12 -4 0 10 5369 -2 11 21 8 9 -3 0 -3 44 128 -3 44 -2 0 10 5368 5369 -2 5368 5369 -2 5368 -4 5369 11 -2 5369 11 3155 3156 2917 2918 -30 8 9 -3 0 13 14 15 -3 0 10 5368 5369 5368 11 -3 5368 11 5368 21 -9 8 9 -42 0 7 -3 8 22 5368 -3 5369 5368 11 19 -4 5369 11 5369 11 5369 -2 5368 5369 5368 11 5369 -2 11 5369 5368 5369 -3 5368 11 -2 5369 5368 -2 5369 -3 5368 5369 -3 5368 11 -2 5369 -2 5368 -6 5369 -2 11 -3 5369 -4 5368 5369 11 1539 11 -2 5369 5368 5369 5368 5369 5368 11 5369 5368 -3 11 5368 5369 -2 5368 5369 -5 11 20 -5 14 23 5368 11 5369 11 5369 5368 11 -4 5368 5369 -2 5368 -7 5369 11 5368 5369 2935 2931 -9 0 13 -7 14 3989 3990 14 -2 3989 14 3990 14 3990 -5 14 23 11 -3 5369 5366 5367 -2 5368 5369 11 -2 5368 11 5368 5369 -2 5368 5369 -2 5368 5369 5375 -9 0 2938 -2 5368 -4 5369 5368 5369 21 -4 8 22 -3 5369 12 -4 0 10 11 5368 11 5369 5368 2941 -7 0 2938 11 5368 11 5368 5369 12 -4 0 10 11 5368 11 20 14 113 9 -2 0 -3 44 0 -3 44 -2 0 10 5368 5369 5368 11 5368 -2 5369 5368 11 5368 11 5368 11 -3 5368 1835 2919 2920 -9 14 3989 -2 14 3990 -8 14 3988 14 3988 14 3989 -3 14 3988 15 -3 0 10 5368 12 -3 0 10 5368 5369 -2 11 5369 1539 -3 5368 20 -2 14 3988 14 3989 14 3990 -2 14 15 -42 0 13 -3 14 23 11 5368 11 -4 5368 -8 5369 -2 11 5369 -2 11 5369 11 5368 11 5369 -2 5368 -4 5369 -2 5368 11 -3 5369 5368 11 5369 11 -3 5368 5369 5368 5369 -2 5368 11 5368 -5 5369 5368 -2 5369 5368 -3 5369 5368 5369 -2 5368 -7 5369 11 -2 5368 5369 -4 5368 -3 5369 -3 11 5368 11 5368 11 5368 11 5369 5368 -2 11 5368 -2 5369 5368 5369 11 -2 5368 5369 11 -3 5368 -2 11 -2 5369 -4 5368 2940 2936 -10 0 5372 2926 -6 5368 -6 5369 11 -2 5368 11 5369 11 5368 -8 5369 11 5368 5369 1539 -3 5369 5368 -2 5369 11 5369 5368 5369 5368 2941 -9 0 2939 31 -2 5368 5369 -2 5368 5369 5368 20 -4 14 23 5368 11 5369 21 -4 8 22 5369 5368 5369 5368 30 2942 -7 0 2939 31 11 -2 5369 5368 21 -4 8 22 11 -2 5369 5368 5369 20 113 9 0 -3 44 0 -3 44 0 1826 22 -2 5368 -3 5369 5368 11 -6 5368 5369 5368 11 5369 -2 11 -2 5369 5368 5369 1539 -2 5368 -2 5369 5368 5369 5368 5369 5368 5369 5368 11 -4 5369 5368 -3 5369 5368 5369 11 -2 5368 12 -3 0 10 5368 12 -3 0 10 5368 11 5369 11 19 11 5369 5368 -2 5369 -7 11 -2 5368 5375 -42 0 10 5368 5369 -3 5368 5369 -3 5368 -2 11 -8 5368 -2 5369 5368 -2 5369 5368 5369 -2 11 5369 5368 5369 11 -12 5368 5369 -2 5368 -3 5369 5368 11 -2 5368 -2 5369 -2 5368 5369 -2 5368 5369 -2 11 5369 5368 -4 5369 5368 11 5368 11 5368 11 5368 11 5369 -2 5368 11 5368 5369 11 -2 5369 5368 5369 -4 11 -2 5368 11 5369 -2 11 5368 5369 11 -2 5369 11 5369 11 5369 11 5368 -4 5369 5368 11 5369 5368 11 5369 -2 5368 11 2941 -12 0 2928 2933 -5 5369 -2 5368 11 -3 5368 5369 -3 11 5369 5368 -2 5369 11 -2 5368 -3 5369 -2 5368 11 5369 -3 5368 5369 -3 5368 -3 5369 5368 2940 2942 -10 0 5374 5369 -2 11 -2 5369 11 -2 5368 -8 5369 20 3990 -2 14 3989 23 5368 11 -2 5369 5375 -9 0 10 5368 5369 5368 5369 20 -4 14 23 5369 5368 5369 11 -2 5368 20 113 -7 8 2921 2922 1830 23 -2 5369 11 -2 5369 5368 1539 -3 5368 11 5368 11 -2 5368 11 5368 11 -4 5369 5368 -4 5369 -2 5368 5369 5368 11 5369 -2 5368 -3 11 5368 5369 5368 11 5368 5369 -5 5368 12 -3 0 10 5368 12 -3 0 10 -4 5368 5369 11 -2 5368 11 5369 5368 5369 5368 5369 5368 5369 5368 5369 5368 2941 -42 0 5374 5369 11 5369 -2 5368 5369 -2 11 5368 -2 5369 11 5369 11 -5 5369 -2 5368 5369 -2 5368 11 -4 5369 5368 5369 -2 5368 -2 5369 -2 11 -2 5368 -4 5369 11 -3 5369 -2 5368 -5 5369 5368 -2 5369 -2 11 5369 -2 11 5369 19 -2 5368 11 5369 11 -9 5368 -2 5369 5368 5369 -3 5368 5369 -3 5368 -5 11 -2 5369 -8 11 -3 5368 -2 11 -3 5368 5369 5368 11 5369 11 5368 11 5368 11 5369 30 2942 -13 0 2934 2937 11 5369 -2 11 5368 5369 5368 -3 5369 5368 -3 5369 -2 5368 5369 19 5368 5369 11 5368 5369 11 5368 11 5369 -2 5368 -2 5369 -3 5368 -3 5369 5368 11 2941 -11 0 2938 5368 11 5368 -3 5369 5368 11 5369 5368 5369 11 5369 11 5369 5368 11 -2 5369 11 5368 -3 5369 -2 5368 2941 -9 0 5374 5368 11 -3 5369 5368 -3 5369 5368 5369 11 -5 5368 20 -5 14 3990 14 2923 2924 1834 11 -2 5369 11 -2 5369 11 5369 5368 5369 11 5369 11 5369 -2 5368 5369 11 5369 5368 -3 5369 5368 5369 11 -3 5368 11 -2 5369 -2 5368 -3 11 -2 5368 5369 -3 5368 5369 -3 5368 -2 11 5368 12 -3 0 10 5368 12 -3 0 10 -2 5368 -3 5369 5368 5369 5368 -4 5369 115 116 -4 5369 30 2942 -42 0 2938 5369 11 5368 -2 11 1539 5369 -2 5368 11 5369 5368 11 5368 5369 11 5369 11 5369 -3 5368 -2 5369 5368 11 -4 5368 5369 5368 5369 11 5368 -2 5369 -2 5368 5369 5368 5369 11 5369 5368 5369 5368 11 5368 11 5368 -2 5369 -2 5368 11 5368 5369 -2 5368 11 -3 5368 5369 -4 5368 11 5369 5368 5369 5368 5369 11 5369 5368 -2 5369 5368 -2 5369 5368 -2 5369 11 -2 5368 5369 -2 11 5368 -7 11 -2 5369 5368 -3 11 5368 -2 11 5369 5368 11 5369 11 5368 5369 11 5368 -2 5369 5368 5369 12 -15 0 2938 11 5369 -2 11 5368 5369 5368 5369 -2 11 5369 11 -3 5368 11 5369 5368 5369 5368 5369 5368 5369 5368 5369 -3 5368 -2 5369 -3 5368 5369 -2 5368 -2 5369 30 2942 -11 0 2939 31 5368 11 5369 -2 5368 -9 5369 11 5368 5369 5368 -2 5369 11 5368 -2 11 30 2942 -9 0 2938 5369 11 -2 5368 5369 11 5368 11 5369 11 -5 5368 11 -2 5369 -5 5368 5369 11 5369 5368 -2 5369 -2 5368 5369 -2 5368 5369 5368 5369 -5 5368 -2 5369 5368 -2 5369 5368 -3 5369 5368 11 5368 -10 5369 11 5368 5369 -3 5368 5369 -3 5368 -2 5369 11 5369 12 -3 0 10 5368 12 -3 0 10 5369 11 5369 5368 -4 5369 5368 11 5368 11 117 118 5368 5369 5368 11 5375 -43 0 2939 31 5369 11 -3 5368 -3 5369 11 5369 5368 5369 11 5369 11 5369 11 5369 -3 5368 -3 5369 5368 5369 -3 11 5369 5368 5369 5368 5369 5368 5369 11 5369 5368 -2 5369 -3 5368 -3 5369 -2 5368 -2 5369 11 5369 -2 5368 5369 11 5369 11 5368 11 5368 -3 5369 5368 -2 5369 11 -3 5368 19 -3 11 -2 5368 5369 11 5369 -2 5368 5369 5368 -2 11 5369 -2 5368 -2 11 5369 5368 11 5369 -2 11 5369 11 5368 5369 11 5369 5368 -3 5369 5368 11 5368 5369 11 -3 5368 -2 5369 11 5368 5369 12 -15 0 2939 31 5368 -2 5369 -3 5368 5369 -2 5368 5369 5368 -5 5369 5368 11 5369 5368 5369 -2 5368 -3 11 5368 5369 5368 11 -2 5368 19 11 5368 11 5368 5375 -13 0 10 5368 -4 5369 5368 5369 5368 5369 5368 5369 5368 5369 5368 11 -3 5369 11 5369 -2 5368 5369 5368 12 -10 0 2939 31 -2 5368 11 -3 5368 5369 -5 5368 11 5369 5368 5369 5368 11 -2 5369 -2 5368 5369 11 -4 5368 11 5369 11 5369 5368 -3 5369 5368 5369 5368 5369 5368 -2 11 5369 -2 11 5369 -2 5368 5369 5368 11 5368 5369 -3 5368 -3 5369 11 -2 5368 11 -2 5368 11 -2 5368 11 5369 11 -3 5368 -2 11 12 -3 0 10 5369 12 -3 0 10 5368 5369 5368 1539 5369 5368 11 -11 5368 2941 -44 0 5374 11 5368 5369 -2 5368 5369 -2 5368 -5 5369 5368 5369 5368 -2 5369 -3 5368 5369 11 -2 5369 11 5368 -2 5369 -2 5368 5369 5368 11 5369 5368 11 5369 -2 5368 -3 5369 5368 -2 11 5369 5368 5369 5368 5369 5368 5369 5368 -2 5369 11 5368 11 5368 -2 5369 5368 5369 -2 11 -2 5369 5368 5369 5368 5369 5368 5369 5368 5369 -2 5368 -2 11 5368 5369 5368 -2 11 -3 5368 5369 -2 5368 1539 5368 -2 5369 -2 5368 11 -2 5368 5369 11 5369 5368 -3 5369 5368 5369 -2 5368 -9 5369 11 12 -16 0 10 11 -2 5368 11 5368 11 5369 -3 11 5369 11 -5 5368 11 -2 5369 -5 5368 5369 11 -3 5369 11 5369 5368 5369 -2 5368 11 2941 -13 0 10 -2 5369 5368 -2 5369 -6 11 5369 -2 11 5368 5369 5368 -3 5369 11 -3 5369 12 -11 0 10 5368 11 -3 5368 5369 -4 5368 5369 5368 11 5369 11 5368 5369 5368 11 5369 -4 5368 11 5369 5368 5369 5368 -2 11 5369 5368 -3 5369 5368 5369 5368 -2 5369 -2 11 5369 -3 5368 5369 11 5368 11 5369 5368 11 5368 5369 11 5368 5369 11 5368 5369 5368 -4 5369 11 5369 -2 5368 -3 5369 5368 11 5368 12 -3 0 10 5368 12 -3 0 10 5368 11 5369 11 -3 5368 11 5369 5368 5369 5368 5369 11 5368 11 5369 30 2942 -44 0 2938 -2 11 5368 -2 11 5368 -2 11 5368 11 5368 11 5368 5369 1539 5369 -2 5368 5369 11 5369 5368 -3 5369 5368 5369 -4 11 -2 5369 5368 11 -6 5369 11 5368 11 5368 5369 -4 5368 -2 5369 -5 5368 5369 -2 11 -2 5369 11 -2 5369 11 5368 -9 5369 11 5368 5369 5368 -3 11 5369 -2 5368 5369 -2 5368 5369 5368 5369 5368 5369 5368 5369 5368 -2 5369 5368 -2 5369 5368 -2 5369 5368 11 -2 5369 -3 11 -2 5369 -2 5368 -2 11 -2 5369 11 12 -16 0 10 5368 -2 5369 5368 -2 5369 5368 -4 5369 5368 -2 5369 -8 11 -2 5368 5369 5368 -3 5369 5368 -3 5369 -2 5368 5369 30 2942 -13 0 10 -4 5369 5368 11 5368 11 5368 11 5368 5369 -2 5368 -3 5369 11 5369 5368 11 5368 -2 5369 12 -11 0 10 5369 11 5368 11 -2 5369 -2 11 5369 5368 11 5368 5369 11 5368 5369 11 5368 5369 5368 -4 5369 11 5369 5368 5369 11 -2 5369 -7 5368 19 -2 5368 5369 11 5369 -3 5368 11 5368 -3 5369 5368 11 5369 19 5369 11 5368 11 -2 5368 -4 5369 5368 -3 5369 11 -2 5369 5368 11 5368 5369 12 -3 0 10 5369 12 -3 0 10 11 -3 5368 11 5368 5369 -2 11 5368 -6 11 5368 12 -45 0 2939 31 11 5369 -2 5368 5369 -2 5368 5369 5368 5369 -2 5368 11 -2 5368 -2 5369 -3 5368 11 5368 -2 5369 5368 5369 -2 5368 -4 5369 -4 5368 -2 5369 11)
    )
    (tilemap
      (handle
        (scale_x 0)
        (scale_y 0)
        (offset_x 0)
        (offset_y 0)
      )
      (solid #f)
      (z-pos 110)
      (name "secret")
      (path-ref "gen16170397632312775096672")
      (width 16)
      (height 11)
      (tiles 22 -2 11 3250 -12 0 23 -2 11 2128 -12 0 5368 -2 11 5535 -12 0 5369 -2 11 20 -12 0 5369 -2 11 5368 -3 11 5368 11 5368 11 5368 11 5368 5369 0 -3 11 5369 -2 5368 5369 11 5368 -4 11 5369 11 5368 11 5368 -5 11 5368 -3 11 5368 -2 11 5368 -2 11 5369 -4 11 5369 -2 11 5369 11 5368 11 5368 -2 11 -2 0 5369 -2 5368 -3 11 -2 5369 11 -2 5369 11 -2 5369 -3 0 -4 11 -2 5368 5369 -3 11 5369 5368 5369 -4 0 5368 11 5368 11 5368 5369 5368 11 5369 -2 11 0)
    )
    (tilemap
      (solid #f)
      (z-pos -110)
      (width 380)
      (height 35)
      (tiles -6589 0 2185 -9 2199 2186 -158 0 2185 -8 2199 2186 -5 0 2185 -3 2199 2186 -7 0 2185 -3 2199 2186 -179 0 2192 2195 2181 2180 2181 2187 -2 2180 2188 2179 2190 -158 0 2193 2184 2180 2181 2195 2180 -2 2179 2182 2194 -5 0 2193 2184 2195 2181 2198 -7 2199 2200 2195 2187 2182 2194 -179 0 2192 2187 -2 2188 2195 2182 2184 2179 2187 2188 2190 -60 0 2185 -2 2199 2186 -88 0 2052 -6 0 2192 2179 2196 -2 2195 2179 2195 2190 -7 0 2193 2184 2179 2196 -2 2179 2189 2195 2189 2179 -2 2181 2179 2182 2194 -142 0 2185 -14 2199 2186 -22 0 2192 -2 2189 2195 2182 2201 2200 2180 -2 2197 2190 -60 0 2192 2179 2181 2198 2186 -87 0 2057 2061 2059 -4 0 2193 2184 2187 2179 2187 2189 2182 2194 -8 0 2193 2184 2195 2187 2180 2181 2180 2195 2197 2196 2189 2182 2194 -143 0 2193 2184 -2 2181 2187 2181 2188 2179 2182 2184 2187 2179 2180 2197 2180 2190 -22 0 2193 2184 2187 2182 2194 2193 2183 2184 2180 2182 2194 -59 0 2185 2200 -3 2179 2190 -86 0 2052 2056 2058 2059 -5 0 2192 2196 2195 2196 2180 2190 -10 0 2192 2179 2195 2196 2195 2179 2181 2180 2196 2180 2190 -7 0 2057 2058 2059 -135 0 2192 2196 2187 2197 2189 2187 2182 2194 2192 2189 -2 2179 2195 2182 2194 -23 0 2192 2195 2190 -2 0 2185 2200 2187 2190 -60 0 2192 2196 2195 2189 2180 2198 2186 -85 0 2057 2058 2050 2064 -5 0 2193 2184 2196 2188 2181 2190 -10 0 2193 2184 2180 2179 2189 2187 2189 2179 2188 2189 2190 -7 0 2062 2051 2055 2054 -134 0 2193 2183 2184 2197 2189 2188 2190 0 2193 2184 2187 2195 2181 2190 -4 0 2057 2065 2059 -17 0 2192 2196 2198 2186 0 2192 2195 2182 2194 -60 0 2192 2181 2179 2189 2197 2181 2198 -10 2199 2186 -73 0 2052 2056 2070 2059 0 2052 -5 0 2192 2182 2184 2197 2190 -11 0 2192 2179 2187 2196 2187 2180 2188 2189 2182 2194 -8 0 2057 2058 2059 -136 0 2192 2195 2180 2179 2198 2186 0 2192 -2 2179 2182 2194 -4 0 2057 2058 2055 2054 -15 0 2185 2200 -2 2179 2190 2185 2200 2179 2190 -61 0 2192 2188 2196 2179 2180 2188 2189 2187 2195 2197 2179 2188 2196 2188 -3 2179 2190 -73 0 2057 2060 2050 2064 0 2057 2061 2059 -2 0 2185 2200 2198 2200 2182 2194 -11 0 2193 2184 2196 2187 2179 2182 2184 2179 2190 -9 0 2057 2066 2055 2054 -135 0 2193 2184 2187 2189 2196 2190 2185 2200 -2 2181 2198 2186 -3 0 2052 2056 2066 2058 2059 -14 0 2185 2200 -2 2180 2188 2198 2200 2197 2188 2198 2186 -60 0 2192 -2 2179 2180 -3 2179 2182 2183 2184 2196 2182 2183 2184 2180 -2 2197 2190 -72 0 2052 2056 2058 2059 0 2052 2056 2050 2064 -2 0 2192 -2 2179 2188 2190 -13 0 2192 2188 2182 2184 2190 2192 2180 2190 -9 0 2062 2051 2065 2055 2054 -134 0 2185 2200 2196 2187 2197 2198 2200 2197 2181 2188 2179 2198 2186 0 2052 2056 2060 2058 2060 2055 2054 -13 0 2193 -9 2183 2194 -60 0 2192 -2 2179 2197 2187 2181 2179 2190 0 2192 2180 2190 0 2192 2197 2189 2188 2190 -71 0 2052 2056 -2 2070 2059 2052 2056 2060 2059 -2 0 2185 2200 2179 2187 2189 2190 -13 0 2192 2189 2198 2202 2201 2200 2197 2190 -10 0 2057 2060 2058 2055 2054 -133 0 2193 -11 2183 2194 0 2057 2065 2061 2058 2066 2058 2059 -84 0 2192 2197 2187 2180 2195 2180 2195 2190 0 2192 2179 2190 0 2192 2181 2196 2189 2190 -71 0 2057 2058 2060 2058 2059 2057 2066 2050 2064 0 2185 2200 2189 2181 2189 2182 2194 -13 0 2193 2184 2179 2190 2192 2180 2182 2194 -10 0 2062 2051 2058 2065 2059 -147 0 2062 -5 2063 2064 -84 0 2193 2183 2184 2179 2188 2195 2179 2198 2199 2200 2196 2198 2199 2200 2188 2195 2181 2190 -71 0 2062 -3 2063 2064 2062 2063 2064 -2 0 2192 2188 2189 2179 2195 2190 -15 0 2192 2197 2198 2200 2180 2190 -12 0 2062 2051 2060 2059 -240 0 2193 2184 2187 2195 2197 2179 2181 2187 2179 2189 2180 -2 2179 2188 2197 2190 -81 0 2192 2180 -2 2179 2182 2194 -15 0 2192 2180 2181 2179 2195 2190 -13 0 2062 2063 2064 -241 0 2193 -13 2183 2194 -76 0 2185 2186 -2 0 2185 2200 2188 2182 2184 2190 -16 0 2192 2179 2196 2188 2196 2190 -347 0 2185 2200 2198 2186 0 2192 2181 2182 2201 2200 2190 -15 0 2185 2200 2181 2197 2180 2181 2190 -347 0 2192 2189 2196 2198 2199 2200 2187 2198 2200 2179 2198 2186 -14 0 2192 2187 2180 2189 2187 2188 2198 2186 -346 0 2192 2188 -2 2180 2181 2195 2180 -2 2179 2189 2180 2190 -14 0 2192 2180 -2 2189 2188 2179 2189 2190 -346 0 2192 2189 2196 2188 -2 2179 2180 2187 2181 2180 2189 2198 2186 -12 0 2185 2200 2180 2181 2179 2196 2180 2189 2198 2186 -53 0)
    )
    (tilemap
      (solid #t)
      (z-pos -1)
      (width 380)
      (height 35)
      (tiles -9933 0 -5 5400 -375 0 -5 5404 -100 0 -4 5400 -376 0 -4 5404 -5 0 -4 5400 -21 0 -4 5400 -351 0 -4 5404 -21 0 -4 5404 -2084 0)
    )
  )
)
