(supertux-level
  (version 3)
  (name (_ "Welcome to Antarctica"))
  (author "Marek Moeckel & Carsten Wirtz")
  (license "CC-BY-SA 4.0 International")
  (target-time 31)
  (allow-item-pocket "inherit")
  (icon "")
  (icon-locked "")
  (statistics
    (enable-coins #t)
    (enable-secrets #t)
  )
  (sector
    (name "main")
    (ambient-light
      (color 1 1 1)
    )
    (background
      (color 1 1 1)
      (alignment "bottom")
      (speed 0)
      (image-top "/images/background/misc/transparent_up.png")
      (image "/images/background/antarctic/snow_panorama.png")
      (z-pos -250)
    )
    (background
      (color 1 1 1)
      (speed 0.5)
      (image-top "/images/background/misc/transparent_up.png")
      (image "/images/background/antarctic/snowy_trees.png")
      (image-bottom "/images/background/antarctic/snow_bottom.png")
      (z-pos -200)
    )
    (background
      (color 1 1 1)
      (scroll-speed-x -0.1)
      (speed 0)
      (image "/images/background/misc/skybox.png")
      (z-pos -290)
    )
    (background
      (color 1 1 1)
      (scroll-speed-x -2)
      (speed 0)
      (image "/images/background/misc/clouds.png")
      (z-pos -280)
    )
    (camera
      (name "Camera")
      (mode "normal")
    )
    (decal
      (z-pos -10)
      (sprite "/images/decal/explanations/billboard-fireflower.png")
      (x 3520)
      (y 384)
    )
    (decal
      (z-pos -10)
      (x 960)
      (y 512)
    )
    (decal
      (z-pos -10)
      (sprite "images/decal/explanations/billboard-resetpoint.png")
      (x 5632)
      (y 380)
    )
    (decal
      (z-pos -10)
      (sprite "images/decal/explanations/billboard-runjump.png")
      (x 7392)
      (y 480)
    )
    (decal
      (z-pos -10)
      (sprite "images/decal/explanations/billboard-buttjump.png")
      (x 6784)
      (y 288)
    )
    (decal
      (z-pos -10)
      (sprite "images/decal/explanations/billboard-backflip.png")
      (x 2432)
      (y 512)
    )
    (decal
      (z-pos 100)
      (sprite "/images/decal/snow/igloo_fg.png")
      (x 9440)
      (y 512)
    )
    (decal
      (z-pos -10)
      (sprite "/images/decal/snow/igloo_bg.png")
      (x 9440)
      (y 512)
    )
    (decal
      (z-pos -10)
      (sprite "/images/decal/sign_icons/run.png")
      (x 7776)
      (y 640)
    )
    (firefly
      (z-pos 0)
      (x 5360)
      (y 512)
    )
    (gradient
      (top_color 0.5 0.7 1)
      (bottom_color 1 1 1)
    )
    (infoblock
      (z-pos 50)
      (message (_ "-Eggs
!images/powerups/egg/egg-shade.png
#The egg makes Tux grow larger. Tux can then smash wooden blocks with his head."))
      (fadetransition #f)
      (x 1344)
      (y 576)
    )
    (infoblock
      (z-pos 50)
      (message (_ "-Fire Flower
!images/powerups/fireflower/fire_flower-0.png
#The fire flower gives Tux the ability to shoot fireballs."))
      (fadetransition #f)
      (x 3904)
      (y 448)
    )
    (infoblock
      (z-pos 50)
      (message (_ "-Tux Doll
!images/powerups/1up/1up.png
#Tux Dolls are a rare collectible which are needed to unlock the Bonus Islands!

#Collect all of them to unlock fun, additional levels!"))
      (fadetransition #f)
      (x 4672)
      (y 448)
    )
    (jumpy
      (z-pos 50)
      (x 8608)
      (y 384)
      (glinting #t)
    )
    (mrbomb
      (z-pos 50)
      (direction "left")
      (x 4992)
      (y 672)
      (glinting #t)
    )
    (mriceblock
      (z-pos 50)
      (direction "left")
      (x 2592)
      (y 672)
      (glinting #f)
    )
    (music
      (file "/music/antarctic/midday.music")
    )
    (path
      (name "gen15435273991679206239792")
      (path
        (adapt_speed #f)
        (node
          (x 8544)
          (y 544)
        )
      )
    )
    (secretarea
      (fade-tilemap "secret")
      (width 128)
      (height 160)
      (x 8544)
      (y 544)
    )
    (sequencetrigger
      (sequence "stoptux")
      (width 64)
      (height 704)
      (x 9696)
      (y 0)
    )
    (sequencetrigger
      (sequence "endsequence")
      (width 32)
      (height 704)
      (x 8960)
      (y 0)
    )
    (smartball
      (z-pos 50)
      (direction "left")
      (x 1632)
      (y 672)
      (glinting #f)
    )
    (smartball
      (z-pos 50)
      (direction "left")
      (x 7552)
      (y 672)
      (glinting #f)
    )
    (smartball
      (z-pos 50)
      (direction "left")
      (x 3008)
      (y 672)
      (glinting #f)
    )
    (snowball
      (z-pos 50)
      (direction "left")
      (x 1088)
      (y 672)
      (glinting #f)
    )
    (snowball
      (z-pos 50)
      (direction "left")
      (x 1984)
      (y 672)
      (glinting #f)
    )
    (snowball
      (z-pos 50)
      (direction "left")
      (x 2912)
      (y 672)
      (glinting #f)
    )
    (snowball
      (z-pos 50)
      (direction "left")
      (x 4032)
      (y 544)
      (glinting #f)
    )
    (snowball
      (z-pos 50)
      (direction "left")
      (x 4640)
      (y 672)
      (glinting #f)
    )
    (snowball
      (z-pos 50)
      (direction "left")
      (x 4800)
      (y 672)
      (glinting #t)
    )
    (snowball
      (z-pos 50)
      (direction "left")
      (x 7648)
      (y 672)
      (glinting #f)
    )
    (spawnpoint
      (name "main")
      (x 96)
      (y 640)
    )
    (stalactite
      (glinting #f)
      (z-pos -1)
      (x 6240)
      (y 320)
    )
    (tilemap
      (solid #f)
      (z-pos -100)
      (name "Background")
      (width 310)
      (height 30)
      (tiles -2981 0 2185 -7 2199 2186 -301 0 2192 2196 2197 2187 -2 2179 2187 2179 2190 -301 0 2193 2184 2181 -2 2187 2180 -2 2189 2190 -302 0 2192 2180 2179 2182 2184 2196 2189 2198 2186 -301 0 2193 2184 2180 2190 2193 2184 -2 2179 2190 -239 0 2057 2065 2070 -2 2058 2050 2064 -56 0 2192 2195 2198 2186 2193 2184 2196 2198 2186 -14 0 106 107 108 -52 0 24 -167 0 2052 2056 2061 2058 2061 2050 2064 -31 0 122 123 -24 0 2192 2196 2180 2198 2186 2192 2179 2180 2198 2186 24 0 2625 2626 -7 0 24 0 109 110 111 -60 0 130 -158 0 2052 2056 2058 2061 2058 2070 2059 -32 0 124 125 -23 0 2185 2200 2188 2189 2180 2198 2200 2179 2196 2188 2190 -2 0 2185 2199 2186 2185 2199 2186 0 2185 2186 -52 0 2185 -4 2199 2186 -7 0 129 -131 0 2057 2071 2050 2051 2059 -7 0 2622 -5 0 24 0 2623 2624 -3 0 24 2052 2056 2066 2058 2061 2058 2050 2064 -32 0 124 125 -23 0 2192 2188 2189 2180 2187 2196 2195 2188 2197 2182 2194 -2 0 2192 2196 2198 2200 2197 2198 2199 2200 2190 -52 0 2192 2197 2189 2187 2179 2190 -7 0 129 -51 0 122 123 -64 0 122 123 -11 0 2052 2056 2050 2064 2057 2059 -21 0 2062 2063 2051 2058 2061 2060 2059 -32 0 2621 1345 1344 -11 0 24 -10 0 2185 2200 2188 2179 2189 2187 2188 2179 2188 2189 2190 -3 0 2192 2196 2180 2195 2180 2195 2180 2197 2190 -52 0 2192 2197 2196 2179 2196 2190 -7 0 129 -51 0 124 125 -3 0 122 123 -59 0 124 125 0 122 123 -8 0 2057 2058 2059 2052 2056 2055 2054 -22 0 2062 2063 2051 2065 2059 -24 0 122 123 -31 0 2193 -9 2183 2194 -3 0 2192 2188 2187 2196 2179 2188 2195 2180 2190 -41 0 122 123 -9 0 2192 -2 2179 -2 2195 2190 -7 0 129 -51 0 124 125 -3 0 124 125 -35 0 106 107 108 -21 0 124 125 0 124 125 -3 0 2057 -3 2058 2055 2056 2050 5423 2056 2058 2060 2059 -24 0 2062 2063 2064 -4 0 106 107 108 -14 0 122 123 0 124 125 0 122 123 -42 0 2193 2184 -3 2187 2195 2196 2182 2194 -29 0 7399 7400 -10 0 124 125 0 122 123 -6 0 2192 2181 2187 2188 2187 2190 -7 0 129 -9 0 106 107 108 -14 0 106 107 108 -5 0 5203 5204 -7 0 2622 -7 0 1345 1344 0 24 0 1345 1344 -15 0 5203 5204 -5 0 2625 2626 -11 0 109 110 111 -9 0 2621 -3 0 24 2622 -6 0 1345 1344 0 1345 1344 5203 5204 2052 2056 2061 2065 -2 2058 2066 2055 2056 2060 2058 2060 2055 2054 -30 0 109 110 111 -8 0 2621 -2 0 5203 5204 0 1345 1344 0 1345 1344 0 1345 1344 -43 0 2192 2180 2179 2196 2195 2187 2190 -14 0 2622 -5 0 2621 5203 5204 -7 0 7401 7402 -10 0 1345 1344 0 1345 1344 24 -5 0 2192 2187 -2 2180 2195 2190 -3 0 2622 -3 0 4967 -5 0 24 -3 0 109 110 111 0 24 -12 0 109 110 111 -95 0 2057 2058 2050 2063 2051 2058 -2 2066 -2 2058 2050 -2 2063 2064 -98 0 2193 -5 2183 2194 -53 0 2193 -4 2183 2194 -132 0 2062 2063 2064 0 2062 -5 2063 2064 -2065 0)
    )
    (tilemap
      (solid #t)
      (z-pos 0)
      (width 310)
      (height 30)
      (tiles -190 0 10 -7 11 5369 11 12 -299 0 10 -6 11 -2 5369 5368 12 -299 0 10 -5 11 5368 5369 11 5368 12 -299 0 10 5368 11 5368 11 5369 5368 -3 11 12 -299 0 10 11 5368 11 5369 5368 -3 11 5368 12 -299 0 10 5368 11 5369 5368 -2 11 5369 -2 11 12 -299 0 10 11 5369 5368 -2 11 5369 -2 11 30 18 -299 0 16 31 5368 -2 11 5368 -2 5369 11 12 -301 0 10 -3 11 5368 -3 11 12 -301 0 10 5369 -3 11 -2 5368 11 12 -240 0 -7 44 -9 0 128 -44 0 16 -7 17 18 -240 0 -7 44 -303 0 -7 44 -66 0 102 -236 0 2072 -5 2073 2074 -274 0 -5 44 -15 0 102 0 -3 83 -19 0 83 0 83 -118 0 7 -4 8 9 -139 0 2067 -3 2068 2069 -94 0 7 -5 8 9 -5 0 7 -7 8 9 -45 0 13 14 3990 -2 14 15 -79 0 44 0 44 0 44 -22 0 -4 44 -29 0 2072 -3 2073 2074 -94 0 13 -3 14 3990 14 15 -5 78 13 -2 14 3989 -4 14 15 -44 0 7 22 11 5368 11 5369 12 -106 0 7 -2 8 9 -23 0 -5 44 -9 0 7 -21 8 9 -44 0 -9 44 -8 0 -2 44 0 -2 44 -2 0 10 -4 5368 11 12 -5 0 10 -2 5368 -3 11 -2 5369 12 -44 0 13 23 30 -2 44 31 12 -50 0 83 78 83 78 83 78 83 -21 0 102 78 0 78 83 78 83 -7 0 -4 44 -10 0 13 -2 14 15 -23 0 2067 -3 2068 2069 -9 0 13 3988 -12 14 3989 -5 14 3990 14 113 9 -11 0 -5 83 -16 0 7 -4 8 9 -5 0 7 -7 8 9 -6 0 7 -8 8 22 -2 5369 -2 11 5368 12 0 -3 44 0 10 11 5369 -2 11 5368 11 30 18 -42 0 7 8 22 5369 12 -2 44 10 12 -92 0 7 -2 8 9 -10 0 10 11 5368 12 -23 0 2072 -3 2073 2074 -9 0 10 5369 -3 11 5369 11 5368 -4 5369 -2 5368 -4 11 5368 5369 -2 11 20 113 9 -31 0 13 -4 14 15 -5 0 13 -5 14 3989 14 15 -6 0 13 3989 14 -2 3990 -4 14 23 5369 11 5369 -2 11 21 9 -3 44 7 22 11 5369 5368 5369 11 1539 12 -43 0 13 14 23 5368 12 -2 44 16 18 0 44 -90 0 13 -2 14 15 -10 0 10 11 5368 12 -37 0 10 5369 -5 11 5369 -8 11 5368 5369 -3 11 -2 5369 20 113 9 -30 0 10 11 -3 5369 12 -5 0 10 -2 11 5368 -2 11 5369 5368 12 -6 0 10 5369 -4 11 -2 5368 -3 11 5368 5369 -2 11 20 15 -3 44 13 23 5369 -4 11 30 18 -41 0 7 8 22 -2 11 5368 12 -2 44 -2 0 -5 44 -33 0 -54 8 22 5369 11 21 -10 8 22 5369 11 21 -23 8 9 -3 0 7 -9 8 22 5369 -4 11 5368 -2 11 5368 5369 -5 11 5368 -3 11 -2 5369 -2 11 20 113 -30 8 22 11 5368 11 5368 12 -5 0 10 11 5369 5368 5369 -2 11 5369 12 -6 0 10 -2 5369 11 5369 11 5369 -8 11 5369 21 -3 8 22 -2 11 5368 11 -2 5369 12 -6 0 7 -35 8 114 14 23 5368 11 5369 21 -2 44 -3 8 44 -36 8 -5 14 3990 -2 14 3989 -2 14 3990 3988 14 3990 -4 14 3990 14 3988 -3 14 3989 -12 14 3990 -3 14 3990 -2 14 3990 14 -2 3990 -3 14 3990 14 23 -2 5369 20 -4 14 3990 3989 -4 14 23 -2 11 20 14 3990 -7 14 3989 -4 14 3990 3989 3990 14 3990 14 3990 -2 14 15 -3 0 13 -9 14 23 5368 -4 11 5368 11 5368 -3 11 5368 5369 -2 11 5369 11 5369 -3 5368 11 5368 11 20 -6 14 3990 -16 14 3988 -4 14 3990 14 23 5369 -3 5368 12 -5 0 10 11 19 5369 5368 5369 -2 11 12 -6 0 10 11 5368 -3 11 5368 -4 11 5369 5368 11 5368 11 20 -2 14 3990 23 -2 11 5368 5369 -2 11 12 -6 0 13 14 -2 3990 -2 14 3990 14 3989 -8 14 3990 -3 14 3989 -10 14 3989 -3 14 23 -3 11 -2 5369 20 -3 14 3989 -2 14 3990 -4 14 3990 -8 14 3989 -4 14 3990 -2 14 3990 -2 14 -2 3989 -7 14 3990 14 -2 11 -2 5369 11 -2 5368 5369 -5 11 5369 11 -2 5368 11 5368 11 5369 11 5369 11 5368 -2 11 5368 -4 11 5369 5368 -2 11 5368 -2 11 -3 5369 -2 11 5369 -2 11 5368 -3 11 5368 11 5368 -4 11 5368 5369 11 5369 5368 -3 11 5369 -3 11 5368 -7 11 -2 5369 -4 5368 5369 11 5369 -2 11 5368 11 5369 -3 11 12 -3 0 10 5368 -3 11 5368 11 5369 11 -2 5368 11 5369 -3 11 5368 11 5369 11 5368 5369 11 5368 -2 11 5369 5368 -3 11 5368 -11 11 -2 5369 11 5368 11 -2 5368 11 -2 5368 11 5368 -3 5369 11 5369 11 5368 5369 -4 11 5369 -3 11 21 -5 8 22 11 -2 5368 11 5368 5369 11 21 -6 8 22 5369 -3 11 5368 5369 -2 11 5368 11 5369 11 5368 -2 11 5368 -2 11 5369 -5 11 5369 11 21 -6 8 22 11 -2 5369 -2 11 -2 5369 5368 -2 11 5369 -4 11 5368 -7 11 5369 5368 -3 11 5368 5369 11 5369 -2 5368 5369 -4 11 5369 11 5369 -2 11 5368 -2 11 5369 -3 11 5368 11 5369 -2 11 5368 -2 11 -2 5368 -3 11 5368 -2 11 5368 -6 11 5369 -2 5368 5369 -3 11 5368 11 5368 -3 11 5368 11 -2 5369 -3 11 5369 5368 -4 11 -2 5368 -3 11 5368 5369 5368 11 -3 5368 11 5369 11 5368 5369 -4 11 5368 5369 -3 11 5368 -2 11 5369 -6 11 5368 11 5368 11 5368 11 5368 11 -2 5368 -3 11 5369 -2 11 5369 11 5368 -2 5369 5368 -2 11 5369 -2 11 5368 -3 11 -2 5369 11 5368 -8 11 21 -3 8 22 -7 11 5369 -2 11 5369 11 5368 -2 5369 5368 11 5369 11 5369 11 5368 11 5368 -2 11 5369 5368 5369 11 5368 -2 11 5368 -7 11 5369 5368 -11 11 5369 11 19 5368 -3 11 5368 -2 11 5368 11 5369 -3 5368 20 14 3990 -2 14 3990 23 -2 11 -2 5368 11 5369 11 20 14 3990 -4 14 23 -4 11 5368 5369 5368 11 5369 -2 11 5368 -2 5369 -4 11 5369 11 5369 -3 11 5369 11 20 -2 14 3990 -3 14 23 5368 11 5369 -2 11 5368 5369 5368 -2 11 5369 11 5368 1539 11 5369 11 5368 -6 5369 -2 5368 5369 -2 11 5368 -4 11 5369 -2 5368 11 -2 5369 -2 11 5369 5368 11 5369 -2 11 5369 11 5369 -3 11 5369 -3 11 5368 11 5368 -4 11 -2 5368 5369 -2 11 5368 11 5369 -2 5368 5369 -6 11 5368 11 -2 5368 5369 -11 11 5369 11 5369 -2 11 -2 5368 -4 11 5369 11 5368 -2 5369 5368 -2 11 5368 11 5369 -2 11 5369 5368 -2 11 5368 11 5368 -2 11 5368 -5 11 5368 11 5369 5368 11 5369 -2 11 5369 -2 11 5368 -2 5369 11 5369 -3 11 5369 5368 11 5368 -2 11 5369 11 5369 -2 11 5369 -2 5368 -5 11 -2 5369 11 5368 20 -3 14 23 -2 11 -2 5368 11 -2 5368 -4 11 5369 -5 11 5369 -2 11 5368 11 5369 -6 11 5369 -2 5368 5369 -3 11 5369 5368 11 5368 5369 11 5368 11 5368 11 -2 5369 11 -2 5369 11 5369 -2 11 5369 19 -2 11 5368 -2 5369 -5 11 5368 11 5368 -5 11 -2 5369 -3 11 5369 5368 11 5369 -4 11 -2 5369 5368 -2 11 5369 -4 11 5368 -3 11 5368 -8 11 5368 11 5368 -3 11 5369 -2 5368 11 -2 5369 -2 11 5368 11 5369 5368 11 5369 11 5368 11 5368 5369 5368 -6 11 5369 -3 11 -3 5368 5369 -4 11 5368 -2 11 5368 11 -2 5368 11 -2 5368 11 5369 11 5368 5369 11 5368 11 -2 5368 -4 11 -2 5368 11 5369 -4 11 5369 -2 11 5368 11 5368 -2 11 5369 -2 5368 5369 11 5368 -2 11 5369 -2 11 5368 -2 11 -2 5368 5369 -2 11 5369 11 -2 5368 5369 -2 5368 -2 11 -2 5368 -2 11 5368 11 5369 -8 11 5368 -3 11 -4 5368 -2 5369 -2 11 5369 -2 11 5369 -2 11 -2 5369 -3 11 5368 -2 11 5369 5368 -2 11 5368 5369 11 -2 5368 -5 11 -2 5368 -2 11 5368 -2 11 5368 5369 -3 11 5369 11 5368 -6 11 5369 -4 11 -2 5369 -6 11 5368 5369 11 -2 5368 11 -3 5368 11 5368 5369 -2 11 5369 5368 -2 11 5369 -8 11 -2 5368 5369 -6 11 -2 5369 -2 11 -2 5369 -3 11 -2 5368 11 -2 5368 1539 -2 11 5368 5369 5368 -2 11 5368 11 5369 11 5369 1539 -2 11 -2 5369 -3 11 5369 -7 11 -2 5369 -2 11 -2 5368 -3 11 -2 5368 11 5369 11 5369 5368 -7 11 5368 -2 11 5369 -2 5368 11 5368 5369 11 -3 5369 11 5369 5368 11 -2 5368 -10 11 5369 -3 11 5369 -4 11 5368 -2 11 5368 5369 -2 11 5368 5369 -3 11 5368 -2 11 5368 11 -2 5368 5369 -2 11 5368 -2 11 -2 5369 -2 11 -2 5368 -3 11 5369 11 5369 11 -2 5369 5368 11 5369 11 5368 -4 5369 -4 11 5368 5369 -6 11 5369 -3 11 5368 -2 11 5369 11 5369 5368 5369 -3 11 -2 5369 -11 11 5368 -2 5369 5368 -2 11 1539 -3 11 5368 11 5369 11 5369 -2 11 5368 -3 11 5368 11 5369 5368 5369 -5 11 5368 -4 11 5368 5369 5368 11 5369 11 5369 5368 11 -3 5369 5368 11 5368 5369 -8 11 5368 -3 11 -2 5369 11 5368 -2 11 5368 -3 11 5369 -6 11 -2 5368 11 -2 5368 11 5368 5369 5368 11 5369 -8 11 -4 5369 -2 11 5369 5368 11 5368 11 -2 5368 11 -2 5368 -8 11 5368 5369 11 -2 5369 5368 -4 11 5368 -2 11 5368 -2 5369 -6 11 5368 11 5368 -3 11 5368 -2 11 5368 -7 11 5368 5369 11 5368 11 5369 11 5369 -3 11 5369 -2 11 5368 -3 11 5368 11 5368 11 5368 11 5369 -4 11 5368 11 -2 5369 11 5368 11 5368 -2 11 5368 11 5368 11 5368 11 -2 5369 -3 11 5368 -2 5369 11 5369 -2 11 5369 -2 11 5368 -2 11 5368 -2 11 5369 11 5369 -3 11 19 5369 5368 11 5368 11 5369 11 5368 11 5369 5368 5369 5368 5369 5368 -2 11 5368 5369 5368 -4 11 1539 -3 5369 5368 -2 11 5368 11 5368 11 5368 11 5369 5368 19 5368 5369 11 5369 5368 5369 -5 11 5368 11 5369 -3 11 5369 -2 5368 11 5369 11 -2 5369 11 5368 -5 11 5369 -2 11 5368 -3 11 5368 11 5368 5369 -8 11 5368 5369 11 5369 -2 5368 5369 -6 11 5368 11 5368 11 5368 11 5369 5368 -2 11 5368 -2 5369 5368 5369 11 5369 5368 -2 11 -3 5368 -4 11 -2 5369 5368 5369 -2 11 5369 -3 11 5369 -2 11 5368 -2 11 5369 5368 5369 5368 5369 5368 -2 5369 -7 11 -2 5368 -3 11 5369 -9 11 5368 11 1539 -3 11 5368 -4 11 5369 11 5369 11 5368 5369 -6 11 5368 11 5368 5369 5368 11 5368 5369 11 5369 5368 11 5369 11 5369 11 5369 -2 11 5368 -3 11 5369 -2 11 5369 11 5368 11 5368 -8 11 5368 -3 11 5369 -5 11 5368 -3 11 5368 -2 11 5369 -2 11 5368 11 5368 11 5369 -2 5368 5369 11 -2 5368 5369 -3 11 5368 11 5369 5368 5369 5368 5369 5368 11 5369 11 5368 -4 11 5369 11 1539 -2 5368 -2 11 5368 11 5368 11 5368 11 5368 -5 11 5368 -3 11 5368 -2 11 5369 5368 5369 -4 11 5368 5369 5368 -2 5369 11 5368 -3 11 19 -2 11 5368 -9 11 5368 5369 -3 11 -3 5369 -8 11 5368 -3 5369 11 -2 5369 -3 11 5368 11 -2 5369 -2 11 -2 5368 11 -2 5368 -4 11 5369 -4 11 5369 11 5369 11 5369 11 5369 -2 11 -2 5368 11 5368 -4 11 5368 -5 11 -2 5368 11 5369 -2 11 5368 5369 11 -2 5369 11 5369 11 5369 11 5369 -4 11 5369 -2 11 5369 -2 11 5369 5368 11 5368 5369 11 5368 -2 11 5368 -4 11 5369 -8 11 -2 5368 11 -2 5369 5368 -5 11 5368 -3 11 5368 5369 -3 11 5368 5369 -2 11 -3 5368 11 -3 5368 -3 11 -2 5369 -2 11 5368 11 -2 5369 11 5368 11 -2 5369 5368 -6 11 5368 5369 -9 11 5368 11 5369 -2 5368 5369 -3 11 5368 11 5368 -2 11 5368 11 -2 5369 -2 11 5369 11 5369 -8 11 5368 -2 11 5368 5369 -4 11 5368 -2 11 5369 5368 -2 11 5369 -6 11 5368 1539 5369 5368 5369 11 5368 11 -2 5369 11 5368 -5 11 5368 -4 11 5369 5368 11 5369 -2 11 5369 5368 -3 11 5368 11 5368 11 5368 11 -2 5368 5369 -2 5368 -4 11 5369 5368 -2 11 5369 -2 11 5368 -2 5369 5368 -2 11 -2 5368 -2 11 5368 11 5368 11 5368 11 5368 11 5369 -2 5368 5369 11 5368 -2 11 5368 -5 11 5368 11)
    )
    (tilemap
      (solid #f)
      (z-pos 100)
      (width 310)
      (height 30)
      (tiles -4931 0 130 -309 0 129 -309 0 129 -309 0 129 -309 0 129 -309 0 129 -309 0 4967 -766 0 5538 -3 5539 5540 -187 0 5540 -117 0 5544 -2 5543 5549 5547 5539 5540 -138 0 5538 -2 5539 5540 -43 0 5547 5539 5540 -42 0 5538 -2 5539 5540 -59 0 5538 5539 5540 -6 0 5538 5548 5549 5543 -3 5549 5547 -3 5539 5540 -4 0 5538 5539 5540 -29 0 5538 -2 5539 5540 -32 0 5538 5539 5540 -6 0 5538 -3 5539 5540 -47 0 5538 5548 5543 5549 5547 5540 -13 0 5538 5539 5540 -17 0 5538 -4 5539 5540 -3 0 5543 5549 5547 5540 -5 0 5538 -3 5539 5540 -11 0 5538 -3 5539 5540 -15 0 5544 5543 5549 5547 -7 5539 5540 -26 0 5538 -4 5539 5540 -17 0 5538 5539 5548 5543 5547 5540 -4 0 5538 5548 -2 5549 -6 5543 5549 5543 5547 5540 -2 0 5538 5548 5543 5547 -2 5539 5540 -25 0 5538 5548 5549 5543 5547 5540 -9 0 5538 -2 5539 5540 -16 0 5538 5539 5548 5543 5547 5539 5540 -3 0 5538 5548 -2 5549 5543 5547 5540 -42 0 5538 -3 5539 5548 -2 5543 5549 5543 5547 5540 -10 0 5538 5539 5548 5543 5547 -2 5539 5540 -13 0 5538 5548 5543 5549 5543 5549 5547 -2 5539 5540 5543 -2 5549 5547 -5 5539 5548 -2 5543 5549 5547 5540 -7 0 5538 -2 5539 5548 5543 5549 5543 5547 5539 5540 -10 0 5538 -2 5539 5548 5543 -4 5549 5543 5549 5543 5549 5543 5547 5540 -9 0 5538 -3 5539 5540 -7 0 5538 -3 5539 5548 5543 -3 5549 5547 -3 5539 5540 -10 0 5538 -2 5539 5548 5543 5549 -2 5543 5547 -4 5539 5548 -7 5549 -3 5543 -2 5549 5547 -2 5539 5548 5549 -2 5543 5549 5543 5547 -3 5539 5540 -7 0 5538 -3 5539 5540 -5 0 5538 -3 5539 5548 -2 5543 -2 5549 5547 -2 5539 5540 -4 0 5538 5539 5548 -2 5549 5547 5540 -12 0 5538 -2 5539 5548 -2 5543 5549 5543 5549 5547 -3 5539 5548 -4 5543 5549 5547 -2 5539 5540 -23 0 5538 -3 5539 5540 -9 0 5538 5539 5548 5549 5543 -2 5549 -3 5543 -2 5549 5547 5539 5540 -5 0 5538 -2 5539 5548 5543 -2 5549 -2 5543 5549 5547 -3 5539 5540 -6 0 5538 -2 5539 5548 -8 5549 5547 -3 5543 5549 -2 5543 5549 5543 5549 5543 5549 -2 5543 5549 5547 -2 5539 5540 -3 0 5538 5548 5549 5543 -4 5549 5543 5549 5547 5539 5540 -5 0 5538 -2 5539 5548 -3 5549 5543 -5 5549 -4 5543 5549 5547 -3 5539 5540 -3 0 5538 5539 5548 5543 -2 5549 5547 5539 5540 -4 0 5538 5548 5543 5549 -2 5543 5549 5543 -2 5549 5543 -3 5549 5547 5540 -8 0 5538 5548 5549 -3 5543 -4 5549 -3 5543 -2 5549 -3 5543 -2 5549 -2 5543 5549 -4 5543 5549 -3 5543 5549 5543 5549 -2 5543 -2 5549 5543 5549 5547 5539 5540 -3 0 5538 5539 5548 -3 5549 5547 5540 -3 0 5538 5548 5549 -2 5543 -3 5549 5543 5549 -3 5543 5547 5540 -2 0 5538 5548 5543 -2 5549 5543 5549 5547 -2 5539 5540 -7 0 5538 5539 5548 5549 5543 -2 5549 -3 5543 -3 5549 -2 5543 5549 -2 5543 -2 5549 5543 5549 5543 5549 5547 -2 5539 5540 -5 0 5538 -2 5539 5540 -10 0 5538 5548 -2 5543 5549 5547 5539 5540 -4 0 5538 -2 5539 5548 -8 5543 -4 5549 5543 5547 5539 5540 -2 0 5538 5548 -3 5543 -2 5549 -2 5543 -2 5549 5543 5549 5543 5549 5547 5540 -3 0 5538 5539 5548 5549 5543 -2 5549 5543 -5 5549 5543 5549)
    )
    (tilemap
      (handle
        (scale_x 0)
        (scale_y 0)
        (offset_x 0)
        (offset_y 0)
      )
      (solid #f)
      (z-pos 110)
      (name "secret")
      (path-ref "gen15435273991679206239792")
      (width 5)
      (height 6)
      (tiles 19 5369 11 5369 12 5368 5369 5368 5369 12 5368 5369 5368 5369 3250 5368 5369 5368 11 2128 5368 11 5369 5368 5535 5369 11 5369 5368 20)
    )
    (tilemap
      (solid #t)
      (z-pos -1)
      (width 310)
      (height 30)
      (tiles -3850 0 2067 -5 2068 2069 -1353 0 48 -308 0 -2 48 -17 0 3991 17 -289 0 50 49 -308 0 51 52 48 -307 0 50 49 50 49 -306 0 51 52 51 52 48 -14 0 -2 8 -3 0 8 -517 0 -5 5400 -9 0 -6 5400 -28 0 -6 5400 -181 0 -3 5400 -72 0 -5 5404 -9 0 -6 5404 -28 0 -6 5404 -181 0 -3 5404 -1451 0)
    )
    (tilemap
      (solid #f)
      (z-pos -150)
      (width 310)
      (height 30)
      (tiles -1052 0 7734 7735 7736 7737 -78 0 7877 7878 -226 0 7743 7744 7745 7746 7747 -76 0 7879 7880 7881 7882 -115 0 7877 7878 -107 0 7751 7752 7753 7754 7755 7756 7757 -75 0 7883 7884 7885 7886 -49 0 7931 7810 7811 7812 -61 0 7879 7880 7881 7882 -106 0 7760 7761 7762 7763 7764 7765 7766 -74 0 7887 7888 7889 7890 7891 7892 -48 0 7935 7814 7815 7816 -61 0 7883 7884 7885 7886 -31 0 7931 7810 7811 7812 -70 0 7768 7769 7770 7771 7772 7773 7774 7775 7776 -73 0 7893 7894 7895 7896 7897 7898 -47 0 7817 7818 7819 7820 7821 7822 -59 0 7887 7888 7889 7890 7891 7892 -30 0 7935 7814 7815 7816 -70 0 7777 7778 7779 7780 7781 7782 7783 7784 7785 -73 0 7899 7900 7901 7902 7903 7904 -47 0 7823 7824 7825 7826 7827 7828 -59 0 7893 7894 7895 7896 7897 7898 -29 0 7817 7818 7819 7820 7821 7822 -69 0 7786 7787 7788 7789 7790 7791 7792 7793 7794 -27 0 7931 7810 7811 7812 -42 0 7905 7906 7907 7908 7909 7910 -46 0 7829 7830 7831 7832 7833 7834 7835 7836 -58 0 7899 7900 7901 7902 7903 7904 -29 0 7823 7824 7825 7826 7827 7828 -69 0 7795 7796 7797 7798 7799 7800 7801 7802 7803 -27 0 7935 7814 7815 7816 -42 0 7911 7912 7913 7914 7915 7916 -46 0 7837 7838 7839 7840 7841 7842 7843 7844 -58 0 7905 7906 7907 7908 7909 7910 -28 0 7829 7830 7831 7832 7833 7834 7835 7836 -68 0 7804 7805 7806 7807 7808 7809 7767 7758 7759 -26 0 7817 7818 7819 7820 7821 7822 -41 0 7917 7918 7919 7920 7921 7922 -46 0 7845 7846 7847 7848 7849 7850 7851 7852 -58 0 7899 7900 7901 7902 7903 7904 -28 0 7837 7838 7839 7840 7841 7842 7843 7844 -71 0 7732 7733 7750 -29 0 7823 7824 7825 7826 7827 7828 -43 0 7923 7924 -48 0 7837 7838 7839 7840 7841 7842 7843 7844 -58 0 7905 7906 7907 7908 7909 7910 -28 0 7845 7846 7847 7848 7849 7850 7851 7852 -71 0 7741 7742 7749 -28 0 7829 7830 7831 7832 7833 7834 7835 7836 -42 0 7925 7926 -48 0 7845 7846 7847 7848 7849 7850 7851 7852 -58 0 7911 7912 7913 7914 7915 7916 -28 0 7853 7854 7855 7856 7857 7858 7859 7860 -71 0 7732 7733 7750 -28 0 7837 7838 7839 7840 7841 7842 7843 7844 -42 0 7927 7928 -48 0 7853 7854 7855 7856 7857 7858 7859 7860 -58 0 7917 7918 7919 7920 7921 7922 -28 0 7861 7862 7863 7864 7865 7866 7867 7868 -71 0 7741 7742 7749 -28 0 7845 7846 7847 7848 7849 7850 7851 7852 -42 0 7929 7930 -48 0 7861 7862 7863 7864 7865 7866 7867 7868 -60 0 7923 7924 -33 0 7869 7870 -74 0 7739 7740 7813 -28 0 7853 7854 7855 7856 7857 7858 7859 7860 -95 0 7869 7870 -63 0 7925 7926 -33 0 7871 7872 -74 0 7932 7933 7934 -28 0 7861 7862 7863 7864 7865 7866 7867 7868 -95 0 7871 7872 -63 0 7923 7924 -33 0 7869 7870 -108 0 7869 7870 -98 0 7869 7870 -63 0 7925 7926 -33 0 7871 7872 -108 0 7871 7872 -98 0 7871 7872 -63 0 7927 7928 -33 0 7873 7874 -108 0 7873 7874 -98 0 7873 7874 -63 0 7929 7930 -33 0 7875 7876 -108 0 7875 7876 -98 0 7875 7876 -2531 0)
    )
    (weak_block
      (version 2)
      (z-pos 0)
      (x 4128)
      (y 320)
    )
    (weak_block
      (version 2)
      (z-pos 0)
      (x 4128)
      (y 352)
    )
    (weak_block
      (version 2)
      (z-pos 0)
      (x 4128)
      (y 384)
    )
    (weak_block
      (version 2)
      (z-pos 0)
      (x 4128)
      (y 416)
    )
    (weak_block
      (version 2)
      (z-pos 0)
      (x 4160)
      (y 416)
    )
    (weak_block
      (version 2)
      (z-pos 0)
      (x 4192)
      (y 416)
    )
    (weak_block
      (version 2)
      (z-pos 0)
      (x 4224)
      (y 416)
    )
    (weak_block
      (version 2)
      (z-pos 0)
      (x 4256)
      (y 416)
    )
    (weak_block
      (version 2)
      (z-pos 0)
      (x 4288)
      (y 416)
    )
    (weak_block
      (version 2)
      (z-pos 0)
      (x 4320)
      (y 416)
    )
    (weak_block
      (version 2)
      (z-pos 0)
      (x 4352)
      (y 416)
    )
    (weak_block
      (version 2)
      (z-pos 0)
      (x 4384)
      (y 416)
    )
    (weak_block
      (version 2)
      (z-pos 0)
      (x 4384)
      (y 384)
    )
    (weak_block
      (version 2)
      (z-pos 0)
      (x 4384)
      (y 352)
    )
    (weak_block
      (version 2)
      (z-pos 0)
      (x 4384)
      (y 320)
    )
    (weak_block
      (version 2)
      (z-pos 0)
      (x 4384)
      (y 288)
    )
    (weak_block
      (version 2)
      (z-pos 0)
      (x 4352)
      (y 288)
    )
    (weak_block
      (version 2)
      (z-pos 0)
      (x 4320)
      (y 288)
    )
    (weak_block
      (version 2)
      (z-pos 0)
      (x 4288)
      (y 288)
    )
    (weak_block
      (version 2)
      (z-pos 0)
      (x 4256)
      (y 288)
    )
    (weak_block
      (version 2)
      (z-pos 0)
      (x 4224)
      (y 288)
    )
    (weak_block
      (version 2)
      (z-pos 0)
      (x 4192)
      (y 288)
    )
    (weak_block
      (version 2)
      (z-pos 0)
      (x 4160)
      (y 288)
    )
    (weak_block
      (version 2)
      (z-pos 0)
      (x 4128)
      (y 288)
    )
  )
)
