; Generated by Flexlay Editor
(supertux-worldmap
  (properties
    (name (_ "Icyisland"))
    (music "music/salcon.ogg")
    (start_pos_x 0)
    (start_pos_y 0)
  )
  (tilemap
    (width 40)
    (height 30)
    (layer "interactive")
    (solid #t)
    (speed 1.000000)
    (tiles 9 9 9 9 9 9 9 9 9 9 9 9 9 9 9 9 9 9 9 9 9 9 9 9 9 9 9 9 9 9 9 9 9 9 9 9 9 9 9 9 9 9 9 9 9 9 9 9 9 9 9 9 9 9 9 9 9 9 9 9 9 9 9 9 9 9 11 12 9 9 9 9 9 9 9 9 9 9 9 9 9 9 9 9 9 9 9 11 16 12 11 16 16 16 16 12 9 9 9 9 11 16 16 12 9 9 14 13 9 9 9 9 9 9 9 9 9 9 9 9 9 9 9 11 16 16 16 22 19 17 15 24 25 25 26 23 16 12 9 9 14 18 18 13 9 9 9 9 9 9 9 9 9 9 9 9 9 9 9 9 9 9 11 22 58 19 19 20 18 13 15 31 32 32 34 26 19 23 16 12 9 9 9 9 9 9 11 16 16 16 16 12 9 9 9 9 9 9 9 9 9 9 15 19 59 19 20 13 9 9 15 31 35 29 29 28 19 19 60 23 16 12 9 9 9 11 22 24 25 25 26 23 12 11 16 16 12 9 9 9 9 9 15 19 47 19 17 11 16 16 22 30 28 19 48 40 40 40 39 20 18 13 9 9 11 22 19 30 29 29 28 19 23 22 19 19 23 12 9 9 9 9 15 19 47 19 23 22 19 19 19 19 19 19 47 19 19 19 47 23 16 16 16 16 22 48 40 40 40 40 40 39 24 25 25 25 26 17 9 9 9 9 15 19 37 40 39 19 19 48 40 40 40 40 44 39 69 40 44 40 43 40 40 40 43 42 24 25 25 25 26 47 30 29 29 36 27 17 9 9 9 9 15 19 19 60 47 19 19 47 24 25 25 26 19 47 19 19 19 19 47 20 18 21 47 19 30 36 32 35 28 37 40 40 39 31 27 23 12 9 9 9 14 18 21 19 37 40 40 46 31 32 32 27 19 37 40 40 40 40 42 17 9 15 37 40 39 30 29 28 19 19 19 60 47 31 34 26 17 9 9 9 9 9 15 19 24 25 26 47 31 32 32 27 20 18 18 18 18 18 18 13 9 14 18 21 47 19 19 48 40 40 40 40 42 30 29 28 17 9 9 9 9 9 15 19 31 32 27 47 31 32 35 28 17 9 11 16 16 16 12 9 9 9 9 15 37 40 40 46 24 25 26 20 18 18 18 18 13 9 9 9 9 9 14 21 30 29 28 47 31 35 28 20 13 9 15 49 50 51 17 9 9 9 9 15 24 25 26 47 31 32 27 17 9 9 9 9 9 9 9 9 11 12 9 14 21 19 19 47 30 28 20 13 9 9 15 52 53 54 23 16 16 16 16 22 30 29 28 47 30 29 28 23 16 16 12 9 9 9 9 9 14 13 11 12 14 18 21 47 20 18 13 9 9 9 15 55 56 57 40 40 40 40 40 40 40 40 40 45 40 40 40 40 40 71 17 9 9 9 9 9 9 9 14 13 9 9 15 47 23 16 16 16 12 9 14 18 18 18 18 18 18 18 18 18 18 18 21 47 19 24 26 20 18 18 13 9 9 9 9 9 9 9 9 11 16 16 22 47 19 19 24 26 23 16 16 16 16 16 16 16 12 9 9 9 9 9 15 47 19 30 28 17 9 9 9 9 9 9 9 9 9 11 16 22 19 48 40 44 40 39 31 34 25 26 24 25 25 25 25 26 23 16 16 16 16 16 22 47 20 18 18 13 9 9 9 9 9 9 9 9 9 15 24 26 19 47 24 25 26 47 30 29 29 28 30 29 36 32 32 34 25 26 24 26 48 40 40 42 17 9 9 9 9 9 9 9 9 9 9 9 9 15 31 27 19 47 30 29 28 37 40 40 40 40 39 19 30 29 29 29 29 28 30 28 47 20 18 18 13 9 9 9 9 9 9 9 9 9 9 9 9 15 31 34 26 37 40 40 40 39 60 24 25 26 47 19 60 48 40 40 40 43 40 40 42 23 12 9 9 9 9 11 12 9 9 9 9 9 9 9 9 15 30 29 28 19 19 19 19 47 19 31 32 27 41 40 40 46 24 26 19 47 19 19 24 26 17 9 9 9 9 14 13 9 9 9 9 9 9 9 9 14 18 18 18 18 21 24 26 47 19 30 29 28 47 19 48 42 31 27 48 42 24 25 33 27 17 9 9 9 9 9 9 9 9 9 9 9 9 9 9 9 9 9 9 9 15 30 28 37 40 40 40 40 42 19 47 19 30 28 47 19 30 29 36 27 17 9 9 9 9 9 9 9 9 9 9 9 9 9 9 11 12 9 9 9 14 18 21 19 24 25 25 26 19 19 37 40 40 40 42 19 20 21 30 28 17 9 9 11 16 16 12 9 9 9 9 9 9 9 9 14 13 9 9 9 9 9 14 21 31 32 32 34 25 25 25 25 26 19 19 20 13 14 18 18 13 9 9 14 21 60 23 12 9 9 9 9 9 9 9 9 9 9 9 9 9 9 9 15 30 29 29 29 29 29 29 29 28 19 20 13 11 12 9 9 9 9 9 9 14 18 18 13 9 9 9 9 9 9 9 9 9 9 9 9 9 9 9 14 18 18 18 18 18 18 18 18 18 18 13 9 14 13 9 9 9 9 9 9 9 9 9 9 9 9 9 9 9 9 9 9 9 9 9 9 9 9 9 9 9 9 9 9 9 9 9 9 9 9 9 9 9 9 9 9 9 9 9 9 9 9 9 9 9 9 9 9)
  )
  (spawnpoint
    (x 4)
    (y 5)
    (name "main")
  )
  (level
    (x 4)
    (y 8)
    (name "level1.stl")
  )
  (level
    (x 9)
    (y 10)
    (name "level2.stl")
  )
  (level
    (x 14)
    (y 6)
    (name "level4.stl")
  )
  (level
    (x 22)
    (y 25)
    (name "level5.stl")
  )
  (level
    (x 21)
    (y 21)
    (name "level6.stl")
  )
  (level
    (x 29)
    (y 17)
    (name "level7.stl")
  )
  (level
    (x 18)
    (y 6)
    (name "level8.stl")
  )
  (level
    (x 16)
    (y 8)
    (name "level9.stl")
  )
  (level
    (x 34)
    (y 10)
    (name "level10.stl")
  )
  (level
    (x 24)
    (y 10)
    (name "level11.stl")
  )
  (level
    (x 27)
    (y 7)
    (name "level12.stl")
  )
  (level
    (x 31)
    (y 9)
    (name "level13.stl")
  )
  (level
    (x 9)
    (y 16)
    (name "level14.stl")
  )
  (level
    (x 14)
    (y 24)
    (name "level15.stl")
  )
  (level
    (x 7)
    (y 19)
    (name "level16.stl")
  )
  (level
    (x 9)
    (y 21)
    (name "level17.stl")
  )
  (level
    (x 13)
    (y 20)
    (name "level18.stl")
  )
  (level
    (x 11)
    (y 23)
    (name "level19.stl")
  )
  (level
    (x 16)
    (y 22)
    (name "level20.stl")
  )
  (level
    (x 18)
    (y 23)
    (name "level21.stl")
  )
  (level
    (x 29)
    (y 12)
    (name "level22.stl")
  )
  (level
    (x 26)
    (y 21)
    (name "level23.stl")
  )
  (level
    (x 26)
    (y 15)
    (name "level24.stl")
  )
  (level
    (x 22)
    (y 15)
    (name "level25.stl")
  )
  (level
    (x 18)
    (y 15)
    (name "level26.stl")
    (quit-worldmap #t)
  )
  (level
    (x 18)
    (y 10)
    (name "level3.stl")
  )
)
