(supertux-level
  (version 2)
  (name (_ "Icyisland"))
  (author "SuperTux Team")
  (contact "http://developer.berlios.de/projects/supertux/")
  (license "GPL 2 / CC-by-sa 3.0")
  (sector
    (name "main")
    (music "music/salcon.ogg")
    (ambient-light 1 1 1)
    (special-tile
      (teleport-to-x 0)
      (teleport-to-y 0)
      (map-message (_ "You found a secret area!"))
      (invisible-tile #t)
      (passive-message #t)
      (x 1)
      (y 27)
    )
    (special-tile
      (invisible-tile #t)
      (script "fadeout_screen( 2 );
state.world <- \"levels/world2/worldmap.stwm\";")
      (apply-to-direction "north")
      (x 37)
      (y 20)
    )
    (special-tile
      (invisible-tile #t)
      (script "abort_screenfade();")
      (apply-to-direction "south")
      (x 37)
      (y 19)
    )
    (sprite-change
      (change-on-touch #t)
      (initial-stay-action #f)
      (x 33)
      (y 15)
      (sprite "images/worldmap/common/tux.sprite")
    )
    (sprite-change
      (change-on-touch #t)
      (stay-action "")
      (initial-stay-action #f)
      (stay-group "world2-boat")
      (x 38)
      (y 21)
      (sprite "images/worldmap/common/boat/boat.sprite")
    )
    (sprite-change
      (change-on-touch #f)
      (stay-action "empty")
      (initial-stay-action #t)
      (stay-group "world2-boat")
      (x 34)
      (y 15)
      (sprite "images/worldmap/common/boat/boat.sprite")
    )
    (teleporter
      (worldmap "levels/world2/worldmap.stwm")
      (spawnpoint "world1")
      (automatic #t)
      (x 54)
      (y 21)
    )
    (teleporter
      (spawnpoint "bridge")
      (x 1)
      (y 26)
      (sprite "images/worldmap/common/teleporterdot.sprite")
    )
    (teleporter
      (spawnpoint "bonus")
      (x 29)
      (y 18)
    )
    (teleporter
      (spawnpoint "bridge")
      (x 16)
      (y 25)
      (sprite "images/worldmap/common/teleporterdot.sprite")
    )
    (tilemap
      (z-pos -100)
      (solid #t)
      (width 80)
      (height 30)
      (tiles
      9 9 9 9 9 9 9 9 9 9 9 9 9 9 9 9 9 9 9 9 9 9 9 9 9 9 9 9 9 9 9 9 9 9 9 9 9 9 9 9 9 9 9 9 9 9 9 9 9 9 9 9 9 9 9 9 9 9 9 9 9 9 9 9 9 9 9 9 9 9 9 9 9 9 9 9 9 9 9 9
      9 9 9 9 9 9 9 9 9 9 9 9 9 9 9 9 9 9 9 9 9 9 9 9 9 9 11 12 9 9 9 9 9 9 9 9 9 9 9 9 9 9 9 9 9 9 9 9 9 9 9 9 9 9 9 9 9 9 9 9 9 9 9 9 9 9 9 9 9 9 9 9 9 9 9 9 9 9 9 9
      9 9 9 9 9 9 9 11 16 12 11 16 16 16 16 12 9 9 9 9 11 16 16 16 12 9 14 13 9 9 9 9 9 9 9 9 9 9 9 9 9 9 9 9 9 9 9 9 9 9 9 9 9 9 9 9 9 9 9 9 9 9 9 9 9 9 9 9 9 9 9 9 9 9 9 9 9 9 9 9
      9 9 9 11 16 16 16 22 19 17 15 24 25 25 26 23 16 12 9 9 15 19 58 19 17 9 9 9 9 9 9 9 9 9 9 9 9 9 9 9 9 9 9 9 9 9 9 9 9 9 9 9 9 9 9 9 9 9 9 9 9 9 9 9 9 9 9 9 9 9 9 9 9 9 9 9 9 9 9 9
      9 9 11 22 19 19 19 20 18 13 15 31 32 32 34 26 19 23 16 12 15 19 59 19 17 9 11 16 16 16 16 12 9 9 9 9 9 9 9 9 9 9 9 9 9 9 9 9 9 9 9 9 9 9 9 9 9 9 9 9 9 9 9 9 9 9 9 9 9 9 9 9 9 9 9 9 9 9 9 9
      9 9 15 24 25 26 20 13 9 9 15 31 35 29 29 28 19 19 60 17 14 21 47 20 13 11 22 24 25 25 26 23 12 11 16 16 12 9 9 9 9 9 9 9 9 9 9 9 9 9 9 9 9 9 9 9 9 9 9 9 9 9 9 9 9 9 9 9 9 9 9 9 9 9 9 9 9 9 9 9
      9 9 15 31 32 27 17 11 16 16 22 30 28 19 48 40 40 40 39 17 9 15 47 17 11 22 19 30 29 29 28 19 23 22 19 19 23 12 9 9 9 9 9 9 9 9 9 9 9 9 9 9 9 9 9 9 9 9 9 9 9 9 9 9 9 9 9 9 9 9 9 9 9 9 9 9 9 9 9 9
      9 9 15 31 32 27 23 22 19 19 19 19 19 19 47 19 19 19 47 23 16 22 47 23 22 48 40 40 40 40 40 39 24 25 25 25 26 17 9 9 9 9 9 9 9 9 9 9 9 9 9 9 9 9 9 9 9 9 9 9 9 9 9 9 9 9 9 9 9 9 9 9 9 9 9 9 9 9 9 9
      9 9 15 30 29 28 48 40 40 43 40 40 40 40 44 39 69 40 44 40 43 40 44 40 43 42 24 25 25 25 26 47 30 29 29 36 27 17 9 9 9 9 9 9 9 9 9 9 9 9 9 9 9 9 9 9 9 9 9 9 9 9 9 9 9 9 9 9 9 9 9 9 9 9 9 9 9 9 9 9
      9 9 15 19 19 60 68 19 19 47 24 25 25 26 19 47 19 19 19 19 47 20 18 21 47 19 30 36 32 35 28 37 40 40 39 30 28 23 12 9 9 9 9 9 9 9 9 9 9 9 9 9 9 9 9 9 9 9 9 9 9 9 9 9 9 9 9 9 9 9 9 9 9 9 9 9 9 9 9 9
      9 9 14 18 21 24 25 25 26 47 31 32 32 27 19 37 40 40 40 40 42 17 9 15 37 40 39 30 29 28 19 19 19 60 41 40 71 19 17 9 9 9 9 9 9 9 9 9 9 9 9 9 9 9 9 9 9 9 9 9 9 9 9 9 9 9 9 9 9 9 9 9 9 9 9 9 9 9 9 9
      9 9 9 9 15 31 32 32 27 47 31 32 32 27 20 18 18 18 18 18 18 13 9 14 18 21 47 19 19 48 40 40 40 40 42 19 19 19 17 9 9 9 9 9 9 9 9 9 9 9 9 9 9 9 9 9 9 9 9 9 9 9 9 9 9 9 9 9 9 9 9 9 9 9 9 9 9 9 9 9
      9 9 9 9 15 30 29 29 28 47 30 29 29 28 17 9 9 9 9 11 16 16 16 12 9 15 37 40 40 42 19 19 19 20 18 18 18 18 13 9 9 9 9 9 9 9 9 9 9 9 9 9 9 9 9 9 9 9 9 9 9 9 9 9 9 9 9 9 9 9 9 9 9 9 9 9 9 9 9 9
      9 9 9 9 14 21 19 19 48 42 20 18 18 18 13 9 9 9 9 15 49 50 51 17 9 14 18 18 18 18 18 18 18 13 9 9 9 9 9 9 9 9 9 9 9 9 9 9 9 9 9 9 9 9 9 9 9 9 9 9 9 9 9 9 9 9 9 9 9 9 9 9 9 9 9 9 9 9 9 9
      9 9 11 12 9 14 21 19 47 19 17 9 9 9 9 9 9 9 9 15 52 53 54 17 9 9 9 11 16 16 16 16 16 12 9 9 9 9 9 9 9 9 9 9 9 9 9 9 9 9 9 9 9 9 9 9 9 9 9 9 9 9 9 9 9 9 9 9 9 9 9 9 9 9 9 9 9 9 9 9
      9 9 14 13 11 12 14 21 41 40 73 74 74 74 74 74 74 74 74 75 77 76 57 73 74 74 74 75 40 40 40 40 914 915 78 78 78 81 9 9 9 9 9 9 9 9 9 9 9 9 9 9 9 9 9 9 9 9 9 9 9 9 9 9 9 9 9 9 9 9 9 9 9 9 9 9 9 9 9 9
      9 9 9 9 14 13 9 15 47 19 17 9 9 9 9 9 9 9 9 14 18 18 18 13 9 9 9 14 18 18 18 18 18 13 9 9 9 79 9 9 9 9 9 9 9 9 9 9 9 9 9 9 9 9 9 9 9 9 9 9 9 9 9 9 9 9 9 9 9 9 9 9 9 9 9 9 9 9 9 9
      9 9 9 9 9 11 16 22 47 19 23 16 16 16 16 16 16 16 16 16 16 16 12 9 9 9 9 9 11 16 12 9 9 9 9 9 9 79 9 9 9 9 9 9 9 9 9 9 9 9 9 9 9 9 9 9 9 9 9 9 9 9 9 9 9 9 9 9 9 9 9 9 9 9 9 9 9 9 9 9
      9 9 9 11 16 22 19 48 44 40 40 39 24 25 25 26 24 25 25 25 25 26 23 16 16 16 16 16 22 70 17 9 9 9 9 9 9 79 9 9 9 9 9 9 9 9 9 9 9 9 9 9 9 9 9 9 9 9 9 9 9 9 9 9 9 9 9 9 9 9 9 9 9 9 9 9 9 9 9 9
      9 9 9 15 24 26 19 47 19 19 19 47 30 29 29 28 30 29 36 32 32 34 25 26 24 26 24 25 26 47 17 9 9 9 9 9 9 79 9 9 9 9 9 9 9 9 9 9 9 9 9 9 9 9 9 9 9 9 9 9 9 9 9 9 9 9 9 9 9 9 9 9 9 9 9 9 9 9 9 9
      9 9 9 15 31 27 19 37 40 39 19 41 40 40 40 40 40 39 30 29 29 29 29 28 30 28 30 29 28 47 17 9 9 9 9 9 9 79 9 9 9 9 9 9 9 9 9 9 9 9 9 9 9 9 9 9 9 9 9 9 9 9 9 9 9 9 9 9 9 9 9 9 9 9 9 9 9 9 9 9
      9 9 9 15 31 34 26 19 19 47 19 47 60 24 25 25 26 47 19 19 19 19 19 48 40 40 40 43 40 42 17 9 9 11 12 9 9 84 78 78 78 78 78 78 78 78 78 78 78 78 78 78 78 78 78 78 78 78 78 78 78 78 78 78 78 78 78 78 78 78 78 78 78 78 78 78 78 78 78 78
      9 9 9 15 30 29 28 19 19 37 40 46 19 31 32 32 27 41 40 40 43 40 40 46 24 26 60 47 20 18 13 9 9 14 13 9 9 9 9 9 9 9 9 9 9 9 9 9 9 9 9 9 9 9 9 9 9 9 9 9 9 9 9 9 9 9 9 9 9 9 9 9 9 9 9 9 9 9 9 9
      9 9 9 14 18 18 18 18 21 24 26 47 19 30 29 29 28 47 60 19 47 19 48 42 31 27 48 42 17 9 9 9 9 9 9 9 9 9 9 9 9 9 9 9 9 9 9 9 9 9 9 9 9 9 9 9 9 9 9 9 9 9 9 9 9 9 9 9 9 9 9 9 9 9 9 9 9 9 9 9
      9 9 9 9 9 9 9 9 15 30 28 37 40 40 40 40 40 42 19 19 47 19 47 19 30 28 47 19 17 9 9 9 9 9 9 9 9 9 9 9 9 9 9 9 9 9 9 9 9 9 9 9 9 9 9 9 9 9 9 9 9 9 9 9 9 9 9 9 9 9 9 9 9 9 9 9 9 9 9 9
      11 16 12 9 9 11 12 9 14 18 21 19 24 25 25 26 69 40 40 40 42 19 37 40 40 40 42 19 17 9 9 11 16 16 12 9 9 9 9 9 9 9 9 9 9 9 9 9 9 9 9 9 9 9 9 9 9 9 9 9 9 9 9 9 9 9 9 9 9 9 9 9 9 9 9 9 9 9 9 9
      15 70 17 9 9 14 13 9 9 9 14 21 31 32 32 34 25 25 25 25 25 26 19 20 18 18 18 18 13 9 9 14 21 60 23 12 9 9 9 9 9 9 9 9 9 9 9 9 9 9 9 9 9 9 9 9 9 9 9 9 9 9 9 9 9 9 9 9 9 9 9 9 9 9 9 9 9 9 9 9
      15 47 23 16 12 9 9 9 9 9 9 15 30 29 29 29 29 29 29 29 29 28 20 13 11 12 9 9 9 9 9 9 14 18 18 13 9 9 9 9 9 9 9 9 9 9 9 9 9 9 9 9 9 9 9 9 9 9 9 9 9 9 9 9 9 9 9 9 9 9 9 9 9 9 9 9 9 9 9 9
      15 37 66 71 17 9 9 9 9 9 9 14 18 18 18 18 18 18 18 18 18 18 13 9 14 13 9 9 9 9 9 9 9 9 9 9 9 9 9 9 9 9 9 9 9 9 9 9 9 9 9 9 9 9 9 9 9 9 9 9 9 9 9 9 9 9 9 9 9 9 9 9 9 9 9 9 9 9 9 9
      14 18 18 18 13 9 9 9 9 9 9 9 9 9 9 9 9 9 9 9 9 9 9 9 9 9 9 9 9 9 9 9 9 9 9 9 9 9 9 9 9 9 9 9 9 9 9 9 9 9 9 9 9 9 9 9 9 9 9 9 9 9 9 9 9 9 9 9 9 9 9 9 9 9 9 9 9 9 9 9
      )
    )
    (level
      (name "01 - Welcome to Antarctica.stl")
      (x 22)
      (y 5)
    )
    (level
      (name "02 - The Journey Begins.stl")
      (x 22)
      (y 8)
    )
    (level
      (name "04 - Tobgle Road.stl")
      (x 14)
      (y 6)
    )
    (level
      (name "05 - The Somewhat Smaller Bath.stl")
      (x 18)
      (y 6)
    )
    (level
      (name "06 - The Frosted Fields.stl")
      (x 25)
      (y 21)
    )
    (level
      (name "07 - Oh No More Snowballs.stl")
      (x 29)
      (y 12)
    )
    (level
      (name "08 - Stone Cold.stl")
      (x 26)
      (y 24)
    )
    (level
      (name "09 - Grumbels Sense of Snow.stl")
      (x 36)
      (y 10)
    )
    (level
      (name "10 - 23rd Airborne.stl")
      (x 16)
      (y 8)
    )
    (level
      (name "11 - Night Chill.stl")
      (x 24)
      (y 10)
    )
    (level
      (name "12 - Into the Stars.stl")
      (x 28)
      (y 7)
    )
    (level
      (name "13 - Above the Arctic Skies.stl")
      (x 6)
      (y 9)
    )
    (level
      (name "14 - Entrance to the Cave.stl")
      (x 9)
      (y 13)
    )
    (level
      (name "15 - Under the Ice.stl")
      (x 14)
      (y 24)
    )
    (level
      (name "16 - Living in a Fridge.stl")
      (x 11)
      (y 18)
    )
    (level
      (name "17 - Or is it just me.stl")
      (x 9)
      (y 21)
    )
    (level
      (name "18 - Ice in the Hole.stl")
      (x 15)
      (y 20)
    )
    (level
      (name "19 - Miyamoto Monument.stl")
      (x 11)
      (y 23)
    )
    (level
      (name "20 - End of the Tunnel.stl")
      (x 17)
      (y 22)
    )
    (level
      (name "21 - A Path in the Clouds.stl")
      (x 22)
      (y 23)
    )
    (level
      (name "22 - A Mysterious House of Ice.stl")
      (x 20)
      (y 23)
    )
    (level
      (name "23 - The Escape.stl")
      (x 20)
      (y 25)
    )
    (level
      (name "24 - The Shattered Bridge.stl")
      (x 13)
      (y 15)
    )
    (level
      (name "25 - Arctic Ruins.stl")
      (x 16)
      (y 15)
    )
    (level
      (name "26 - The Castle of Nolok.stl")
      (x 21)
      (y 15)
    )
    (level
      (name "03 - Via Nostalgica.stl")
      (x 18)
      (y 10)
    )
    (level
      (name "27 - No More Mr Ice Guy.stl")
      (quit-worldmap #t)
      (x 29)
      (y 15)
      (sprite "images/worldmap/common/yeti.sprite")
    )
    (level
      (name "bonus.stl")
      (x 3)
      (y 28)
    )
    (level
      (name "intro.stl")
      (auto-play #t)
      (x 22)
      (y 4)
      (sprite "images/objects/invisible/invisible.sprite")
    )
    (worldmap-spawnpoint
      (name "main")
      (x 22)
      (y 4)
    )
    (worldmap-spawnpoint
      (name "world2")
      (x 38)
      (y 21)
    )
    (worldmap-spawnpoint
      (name "bridge")
      (x 8)
      (y 15)
    )
    (worldmap-spawnpoint
      (name "bonus")
      (x 1)
      (y 26)
    )
  )
  (tileset "images/worldmap.strf")
)
