(supertux-level
  (name (_ "Icyisland"))

  (sector
    (name "main")
    (music "music/salcon.ogg")
  
    (tilemap
      (width 40)
      (height 30)
      (layer "interactive")
      (solid #t)
      (speed 1.000000)
      (tiles 9 9 9 9 9 9 9 9 9 9 9 9 9 9 9 9 9 9 9 9 9 9 9 9 9 9 9 9 9 9 9 9 9 9 9 9 9 9 9 9 9 9 9 9 9 9 9 9 9 9 9 9 9 9 9 9 9 9 9 9 9 9 9 9 9 9 11 12 9 9 9 9 9 9 9 9 9 9 9 9 9 9 9 9 9 9 9 11 16 12 11 16 16 16 16 12 9 9 9 9 11 16 16 16 12 9 14 13 9 9 9 9 9 9 9 9 9 9 9 9 9 9 9 11 16 16 16 22 19 17 15 24 25 25 26 23 16 12 9 9 15 19 58 19 17 9 9 9 9 9 9 9 9 9 9 9 9 9 9 9 9 9 11 22 19 19 19 20 18 13 15 31 32 32 34 26 19 23 16 12 15 19 59 19 17 9 11 16 16 16 16 12 9 9 9 9 9 9 9 9 9 9 15 24 25 26 20 13 9 9 15 31 35 29 29 28 19 19 60 17 14 21 47 20 13 11 22 24 25 25 26 23 12 11 16 16 12 9 9 9 9 9 15 31 32 27 17 11 16 16 22 30 28 19 48 40 40 40 39 17 9 15 47 17 11 22 19 30 29 29 28 19 23 22 19 19 23 12 9 9 9 9 15 31 32 27 23 22 19 19 19 19 19 19 47 19 19 19 47 23 16 22 47 23 22 48 40 40 40 40 40 39 24 25 25 25 26 17 9 9 9 9 15 30 29 28 48 40 40 43 40 40 40 40 44 39 69 40 44 40 43 40 44 40 43 42 24 25 25 25 26 47 30 29 29 36 27 17 9 9 9 9 15 19 19 60 68 19 19 47 24 25 25 26 19 47 19 19 19 19 47 20 18 21 47 19 30 36 32 35 28 37 40 40 39 30 28 23 12 9 9 9 14 18 21 24 25 25 26 47 31 32 32 27 19 37 40 40 40 40 42 17 9 15 37 40 39 30 29 28 19 19 19 60 41 66 71 19 17 9 9 9 9 9 15 31 32 32 27 47 31 32 32 27 20 18 18 18 18 18 18 13 9 14 18 21 47 19 19 48 40 40 40 40 42 19 19 19 17 9 9 9 9 9 15 30 29 29 28 47 30 29 29 28 17 9 9 9 9 11 16 16 16 12 9 15 37 40 40 42 19 19 19 20 18 18 18 18 13 9 9 9 9 9 14 21 19 19 48 42 20 18 18 18 13 9 9 9 9 15 49 50 51 17 9 14 18 18 18 18 18 18 18 13 9 9 9 9 9 9 9 9 11 12 9 14 21 19 47 19 17 9 9 9 9 9 9 9 9 15 52 53 54 17 9 9 9 11 16 16 16 16 16 12 9 9 9 9 9 9 9 9 14 13 11 12 14 21 47 69 73 74 74 74 74 74 74 74 74 75 77 76 57 73 74 74 74 75 40 40 40 40 71 17 9 9 9 9 9 9 9 9 9 9 14 13 9 15 47 19 17 9 9 9 9 9 9 9 9 14 18 18 18 13 9 9 9 14 18 18 18 18 18 13 9 9 9 9 9 9 9 9 9 9 9 11 16 22 47 19 23 16 16 16 16 16 16 16 16 16 16 16 12 9 9 9 9 9 11 16 12 9 9 9 9 9 9 9 9 9 9 9 9 11 16 22 19 48 44 40 40 39 24 25 25 26 24 25 25 25 25 26 23 16 16 16 16 16 22 70 17 9 9 9 9 9 9 9 9 9 9 9 9 15 24 26 19 47 24 25 26 47 30 29 29 28 30 29 36 32 32 34 25 26 24 26 24 25 26 47 17 9 9 9 9 9 9 9 9 9 9 9 9 15 31 27 19 47 30 29 28 37 40 40 40 40 39 19 30 29 29 29 29 28 30 28 30 29 28 47 17 9 9 9 9 9 9 9 9 9 9 9 9 15 31 34 26 37 40 40 40 39 60 24 25 26 47 19 19 19 19 19 19 48 40 40 40 43 40 42 17 9 9 11 12 9 9 9 9 9 9 9 9 15 30 29 28 19 19 19 19 47 19 31 32 27 41 40 40 40 43 40 40 46 24 26 60 47 20 18 13 9 9 14 13 9 9 9 9 9 9 9 9 14 18 18 18 18 21 24 26 47 19 30 29 28 47 19 60 19 47 19 48 42 31 27 48 42 17 9 9 9 9 9 9 9 9 9 9 9 9 9 9 9 9 9 9 9 15 30 28 37 40 40 40 40 42 19 19 19 47 19 47 19 30 28 47 19 17 9 9 9 9 9 9 9 9 9 9 9 11 16 12 9 9 11 12 9 14 18 21 19 24 25 25 26 19 69 40 40 42 19 37 40 40 40 42 19 17 9 9 11 16 16 12 9 9 9 9 9 15 70 17 9 9 14 13 9 9 9 14 21 31 32 32 34 25 25 25 25 25 26 19 20 18 18 18 18 13 9 9 14 21 60 23 12 9 9 9 9 15 47 23 16 12 9 9 9 9 9 9 15 30 29 29 29 29 29 29 29 29 28 20 13 11 12 9 9 9 9 9 9 14 18 18 13 9 9 9 9 15 37 66 71 17 9 9 9 9 9 9 14 18 18 18 18 18 18 18 18 18 18 13 9 14 13 9 9 9 9 9 9 9 9 9 9 9 9 9 9 14 18 18 18 13 9 9 9 9 9 9 9 9 9 9 9 9 9 9 9 9 9 9 9 9 9 9 9 9 9 9 9 9 9 9 9 9 9 9 9)
    )
    (worldmap-spawnpoint
      (x 22)
      (y 4)
      (name "main")
    )
    (level
      (x 22)
      (y 5)
      (name "level1.stl")
    )
    (level
      (x 22)
      (y 8)
      (name "level2.stl")
    )
    (level
      (x 14)
      (y 6)
      (name "level4.stl")
    )
    (level
      (x 26)
      (y 25)
      (name "level5.stl")
    )
    (level
      (x 25)
      (y 21)
      (name "level6.stl")
    )
    (level
      (x 29)
      (y 12)
      (name "level7.stl")
    )
    (level
      (x 18)
      (y 6)
      (name "level8.stl")
    )
    (level
      (x 16)
      (y 8)
      (name "level9.stl")
    )
    (level
      (x 34)
      (y 10)
      (name "level10.stl")
    )
    (level
      (x 24)
      (y 10)
      (name "level11.stl")
    )
    (level
      (x 28)
      (y 7)
      (name "level12.stl")
    )
    (level
      (x 6)
      (y 9)
      (name "level13.stl")
    )
    (level
      (x 8)
      (y 17)
      (name "level14.stl")
    )
    (level
      (x 14)
      (y 24)
      (name "level15.stl")
    )
    (level
      (x 7)
      (y 20)
      (name "level16.stl")
    )
    (level
      (x 9)
      (y 21)
      (name "level17.stl")
    )
    (level
      (x 13)
      (y 20)
      (name "level18.stl")
    )
    (level
      (x 11)
      (y 23)
      (name "level19.stl")
    )
    (level
      (x 16)
      (y 22)
      (name "level20.stl")
    )
    (level
      (x 22)
      (y 23)
      (name "level21.stl")
    )
    (level
      (x 20)
      (y 23)
      (name "level22.stl")
    )
    (level
      (x 20)
      (y 25)
      (name "level23.stl")
    )
    (level
      (x 13)
      (y 15)
      (name "level24.stl")
    )
    (level
      (x 16)
      (y 15)
      (name "level25.stl")
    )
    (level
      (x 21)
      (y 15)
      (name "level26.stl")
    )
    (special-tile
      (x 17)
      (y 25)
      (teleport-to-x 9)
      (teleport-to-y 15)
    )
    (special-tile
      (x 36)
      (y 10)
      (teleport-to-x 9)
      (teleport-to-y 15)
    )
    (special-tile
      (x 9)
      (y 15)
      (map-message (_ "Warp Home"))
      (teleport-to-x 22)
      (teleport-to-y 4)
    )
    (level
      (x 18)
      (y 10)
      (name "level3.stl")
    )
    (level
      (x 29)
      (y 15)
      (name "yeti.stl")
      (quit-worldmap #t)
    )
    (special-tile
      (x 29)
      (y 18)
      (invisible-tile #t)
      (teleport-to-x 1)
      (teleport-to-y 26)
    )
    (special-tile
      (x 1)
      (y 26)
      (teleport-to-x 22)
      (teleport-to-y 4)
    )
    (level
      (x 3)
      (y 28)
      (name "")
    )
    (special-tile
      (x 1)
      (y 28)
      (map-message (_ "You found a secret area!"))
      (passive-message #t)
      (invisible-tile #t)
      (teleport-to-x 0)
      (teleport-to-y 0)
    )
  )
)
