(supertux-level
  (version 3)
  (name (_ "An Unsuspected Follower"))
  (author "Carsten Wirtz")
  (license "CC-BY-SA 4.0 International")
  (allow-item-pocket "off")
  (icon "")
  (icon-locked "")
  (statistics
    (enable-coins #f)
    (enable-badguys #f)
    (enable-secrets #f)
  )
  (sector
    (name "main")
    (init-script "import(\"levels/world1/yeti_cutscene.nut\");

Text.set_anchor_point(7);
Text.set_anchor_offset(0, -160);

trigger_state(\"start\");")
    (ambient-light
      (color 0.9999999 0.9999999 0.9999999)
    )
    (background
      (scroll-offset-y 180)
      (color 1 0.82 0.85)
      (speed 0)
      (image-top "/images/background/misc/transparent_up.png")
      (image "/images/background/antarctic/ice_mountains_panorama.png")
      (z-pos -250)
    )
    (background
      (color 1 1 1)
      (scroll-speed-x -0.1)
      (speed 0)
      (image "/images/background/misc/skybox.png")
      (z-pos -290)
    )
    (background
      (color 1 1 1)
      (scroll-speed-x -2)
      (speed 0)
      (image "/images/background/misc/clouds.png")
      (z-pos -280)
    )
    (camera
      (name "Camera")
      (mode "normal")
    )
    (gradient
      (top_color 0.8 0.45 0.72)
      (bottom_color 1 1 0.6)
    )
    (invisible_wall
      (width 896)
      (height 32)
      (x 2688)
      (y 1408)
    )
    (invisible_wall
      (width 416)
      (height 32)
      (x 128)
      (y 96)
    )
    (music
      (file "/music/antarctic/sunset.music")
    )
    (particles-clouds
      (intensity 30)
    )
    (scriptedobject
      (z-pos 50)
      (name "YETI")
      (sprite "/images/creatures/yeti/yeti.sprite")
      (x 736)
      (y 224)
    )
    (scriptedobject
      (z-pos 50)
      (name "TUX")
      (sprite "/images/creatures/tux/tux.sprite")
      (x 96)
      (y 960)
    )
    (scripttrigger
      (oneshot #t)
      (script "trigger_state(\"textbox\");")
      (button #f)
      (width 32)
      (height 160)
      (x 256)
      (y 0)
    )
    (scripttrigger
      (oneshot #t)
      (script "trigger_state(\"yeti_reveal\");")
      (button #f)
      (width 32)
      (height 160)
      (x 320)
      (y 0)
    )
    (spawnpoint
      (name "main")
      (x 192)
      (y 32)
    )
    (tilemap
      (solid #f)
      (z-pos -100)
      (name "Background")
      (width 112)
      (height 45)
      (tiles -571 0 2622 -346 0 106 107 108 -108 0 24 109 110 111 -2140 0 106 107 108 -89 0 106 107 108 -4 0 4145 4146 4147 4148 -9 0 109 110 111 0 2621 -80 0 2621 0 2625 2626 -2 0 2622 109 110 111 0 5203 5204 0 4149 4150 4151 4152 0 2622 -2 0 24 -16 0 2622 0 5203 5204 -63 0 2623 2624 -1562 0)
    )
    (tilemap
      (solid #t)
      (z-pos 0)
      (name "Interactive")
      (width 112)
      (height 45)
      (tiles 11 1842 1840 1838 -108 0 20 11 1842 1840 1838 -107 0 5368 -2 11 1842 1840 3149 -106 0 5369 -3 11 1842 3151 3152 -105 0 5369 -4 11 3155 3156 1832 1827 -103 0 -3 11 5369 -2 11 1835 1836 1831 2917 2918 8 2913 2914 -98 0 11 5368 -6 11 1835 2919 2920 14 2915 2916 1832 1827 -96 0 11 5369 -4 11 5369 -6 11 1835 1836 1831 1832 1827 -94 0 11 -2 5369 -2 5368 -3 11 -2 5369 11 5369 -3 11 1835 1836 1831 1832 1827 -92 0 -7 11 -2 5368 5369 -3 11 5369 -3 11 1835 1836 1831 2917 2918 -3 8 2913 2914 -85 0 -4 11 5368 11 5368 11 5368 5369 5368 11 5369 -2 11 5369 -3 11 1835 2919 2920 -3 14 2915 2916 3139 3140 -83 0 -3 11 5368 11 5368 -2 11 5368 11 5369 -6 11 5368 -5 11 5369 -2 11 1835 3143 3144 1838 -82 0 11 5368 5369 11 5368 -3 11 5368 -5 11 5368 11 5368 11 5368 11 5369 5368 -2 11 5369 -3 11 3147 1840 1844 -81 0 5368 5369 -3 11 -2 5369 11 -3 5368 -3 11 -2 5369 -2 11 -2 5369 -9 11 1842 1846 -81 0 5368 -2 11 5369 -2 5368 5369 11 -2 5369 11 -2 5369 -13 11 5369 -3 11 5393 -81 0 5369 11 5368 -3 11 5368 -3 11 5369 5368 5369 11 5368 -6 11 5368 -2 5369 11 -2 5368 11 5368 11 5397 -81 0 5369 -2 11 -2 5369 11 5368 -2 11 5369 11 5368 11 5369 11 5369 11 5368 11 5368 -2 11 5368 5369 5368 -5 11 12 -81 0 5369 5368 -2 11 5368 11 -2 5368 5369 -5 11 5369 5368 -2 11 -2 5368 -3 11 5369 11 5369 11 -2 5369 11 5375 -81 0 11 -3 5369 11 5369 5368 5369 -3 11 5368 11 5369 11 5368 11 5368 11 5369 5368 -3 11 5368 -2 5369 11 5369 11 2941 -81 0 -5 11 5368 5369 11 -2 5368 11 5368 5369 -2 11 -2 5369 -6 11 5368 -5 11 2940 2942 -81 0 -2 11 5368 11 -2 5368 5369 -13 11 5369 11 5369 -6 11 2941 -82 0 -3 11 5368 11 5368 11 -2 5369 -3 11 -2 5369 -4 11 2929 2930 17 3991 17 2925 2926 -2 11 2929 2930 2942 -82 0 2929 2930 -3 17 2925 2926 11 5368 -2 11 5368 11 2929 2930 -3 17 2931 -5 0 2928 -2 17 2931 -84 0 2931 -5 0 2928 -5 17 3991 2931 -693 0 2909 2910 -5 8 2913 2914 -76 0 2909 2910 -23 8 2921 2922 2911 2912 -2 14 3989 -2 14 2915 2916 2917 2918 -8 8 2913 2914 -58 0 2909 2910 -2 8 2921 2922 2911 2912 -2 14 3990 -2 14 3988 -8 14 3990 -5 14 3990 -2 14 2923 2924 1834 -3 11 5369 -3 11 1835 2919 2920 14 3990 -3 14 3988 -2 14 2915 2916 1832 1827 -54 0 2921 2922 2911 2912 -2 14 2923 2924 1834 -4 11 -2 5368 -4 11 5368 11 5369 -3 11 5368 -3 11 -3 5368 -5 11 5369 -3 11 5369 -6 11 5368 5369 -2 11 5369 -2 11 1835 1836 1831 1832 1827 -52 0 2923 2924 1834 -8 11 5369 11 5369 -3 11 5368 11 5369 -2 11 5368 -5 11 5369 11 5369 11 5368 11 5368 11 5369 5368 -2 11 5368 11 5368 -2 11 5369 -2 5368 11 -2 5369 11 5368 -4 11 1835 1836 1831 2917 2918 2913 2914 -48 0 -4 11 5368 11 5368 5369 -2 5368 -2 11 -2 5369 5368 -2 5369 -9 11 5369 -10 11 5368 11 5368 -4 11 -2 5368 11 -2 5368 11 5369 11 5369 11 5369 -4 11 1835 2919 2920 2915 2916 1832 1827 -46 0 -4 11 5369 11 5368 -4 11 -2 5368 -2 11 5369 -2 11 5368 -2 11 5369 11 5368 -2 5369 5368 11 5369 -3 11 5369 -2 11 5368 -6 11 -2 5369 11 5369 5368 11 -2 5368 -4 11 -2 5369 -7 11 1835 1836 1831 1832 1827 -44 0 -8 11 5368 11 5368 11 5368 11 5369 11 5368 -2 11 5369 -4 11 5369 -2 11 5368 -6 5369 -3 11 5369 -8 11 5369 5368 11 -2 5369 11 5368 -4 11 5369 -3 11 5368 -3 11 1835 1836 1831 1832 1827 -42 0 5368 11 5369 -2 11 5368 11 5368 -2 11 5369 11 5368 -2 5369 -4 11 -2 5368 11 5368 5369 11 5369 5368 -6 11 5368 -2 11 -3 5369 11 5368 -2 11 5368 -3 11 -2 5369 -9 11 5369 -2 11 5368 -5 11 1835 1836 1831 1832 1827 -40 0 5368 5369 -2 11 5368 -2 11 -2 5369 -2 11 -2 5369 11 -2 5368 -3 11 5368 -3 11 5369 11 5368 -7 11 5368 5369 -3 11 5369 -2 5368 11 5368 11 5368 -7 11 -2 5369 -2 11 5368 11 5368 -3 11 5369 -6 11 1835 1836 1831 1832 1827 -38 0 5368 -7 11 5368 11 5369 5368 -2 11 5369 -2 11 5368 5369 11 5368 11 5368 -3 5369 -2 11 5369 -2 11 5368 11 5369 5368 -2 11 5368 5369 -4 11 5369 5368 5369 -7 11 5369 11 5369 11 5369 -3 11 5369 5368 11 5368 -2 11 5368 -3 11 1835 1836 1831 1832 1827 -36 0 5369 5368 5369 -2 11 5368 11 5368 11 5368 11 5368 11 5369 11 5368 -2 11 5369 11 -2 5368 -2 11 5368 -3 11 5368 -2 5369 -3 11 5368 11 5368 -3 11 5369 -3 11 5369 5368 5369 -2 11 5369 5368 11 5369 -2 11 5369 11 -3 5369 5368 11 5369 -3 11 5368 5369 -5 11 1835 1836 1831 2917 2918 2913 2914 -32 0 5369 11 5368 11 5369 11 5368 -2 11 5369 11 5368 -2 5369 -3 11 5368 -2 5369 -8 11 5368 -2 11 5368 -5 11 5368 11 -2 5369 -4 11 5369 5368 11 5368 5369 -4 11 5369 -3 11 -2 5368 -4 11 5369 11 -2 5368 11 -2 5368 -4 11 1835 2919 2920 2915 2916 1832 1827 -30 0 -3 11 5368 -2 11 5369 5368 -2 11 5368 5369 11 -2 5368 -5 11 -2 5368 -2 11 5368 -2 11 5368 5369 -2 11 5368 5369 11 5368 -6 11 5369 -5 11 5369 -6 11 -2 5369 11 5369 5368 11 5368 5369 5368 11 5368 -3 11 5369 5368 -2 11 5369 5368 -5 11 1835 1836 1831 1832 1827 -28 0 11 5369 11 -2 5368 -4 11 5368 -3 11 5369 -2 11 5369 -3 11 5369 11 5368 -3 5369 5368 -3 11 5369 -2 5368 11 5368 5369 11 5368 -2 11 5368 -3 11 5368 11 5368 -2 11 -2 5369 -8 11 5368 5369 5368 11 5369 -3 11 5369 5368 11 5369 -2 11 5369 -7 11 1835 1836 1831 1832 1827 -26 0 -2 11 -2 5369 -8 11 -2 5369 5368 -3 11 5369 -4 11 5369 11 5369 11 5368 -2 11 5368 -3 11 5369 -3 5368 11 -2 5368 5369 -3 11 -2 5368 5369 5368 5369 5368 5369 5368 -2 11 5368 5369 5368 -5 11 -3 5369 5368 11 5369 -3 11 5369 -2 11 5368 -3 11 5368 -3 11 1835 1836 1831 1832 1827 -24 0)
    )
    (tilemap
      (solid #f)
      (z-pos 100)
      (name "Foreground")
      (width 112)
      (height 45)
      (tiles -672 0 5540 -111 0 5547 5540 -110 0 5549 5546 -110 0 5549 5547 5539 5540 -108 0 -3 5549 5547 5539 5540 -106 0 -3 5549 5543 5549 5547 5539 5540 -104 0 5549 -2 5543 5549 5543 -2 5549 5547 5539 5540 -102 0 -2 5543 -3 5549 -2 5543 5549 5543 5547 5539 5540 -100 0 -2 5543 5549 -4 5543 5549 -2 5543 5541 5552 -100 0 5543 5549 5543 -3 5549 5543 5541 -2 5551 5552 -101 0 5543 5549 -2 5543 5541 -2 5551 5552 -104 0 5543 5541 -2 5551 5552 -107 0 5541 5552 -110 0 5552 -1912 0 5538 -3 5539 5540 -12 0 5538 -2 5539 5540 -83 0 5538 -2 5539 5540 0 5538 -2 5539 5548 -3 5543 5547 5539 5540 -8 0 5538 5539 5548 5549 5543 5547 -2 5539 5540 -8 0 5538 -2 5539 5540 -67 0 5539 5548 -2 5549 5547 5539 5548 -2 5543 -2 5549 -2 5543 5549 5543 5547 5540 -3 0 5538 -3 5539 5548 -2 5543 -5 5549 5547 5540 -2 0 5538 5539 5540 0 5538 5548 -2 5543 5547 -2 5539 5540 -2 0 5538 -2 5539 5540 -58 0 5543 -3 5549 -2 5543 -2 5549 5543 5549 -2 5543 -2 5549 5543 5549 5547 -3 5539 5548 5549 -4 5543 -2 5549 5543 5549 -2 5543 5549 5547 -2 5539 5548 5543 5547 5539 5548 -2 5549 -3 5543 5549 5547 -2 5539 5548 -2 5549 5547 -2 5539 5540 -55 0 -3 5543 -2 5549 5543 5549 5543 5549 5543 5549 5543 5549 -4 5543 5549 5543 5549 -2 5543 -2 5549 -2 5543 -2 5549 -4 5543 -2 5549 5543 5549 5543 -3 5549 5543 -3 5549 -3 5543 -2 5549 -4 5543 -2 5549 5543 5547 -2 5539 5540 -52 0 5543 5549 5543 5549 5543 5549 5543 -2 5549 -5 5543 -3 5549 -3 5543 5549 5543 -5 5549 -2 5543 5549 -2 5543 -5 5549 5543 5549 -3 5543 -3 5549 -5 5543 -2 5549 5543 5549 5543 5549 5543 5549 5543 5547 5539 5540 -50 0 5543 -2 5549 5543 -2 5549 -2 5543 -2 5549 -2 5543 5549 -2 5543 -3 5549 5543 5549 -2 5543 -2 5549 5543 -2 5549 -2 5543 -2 5549 -2 5543 5549 5543 -2 5549 5543 -3 5549 5543 -4 5549 -2 5543 -6 5549 -2 5543 5549 -2 5543 5549 5543 5547 -2 5539 5540 -47 0 5549 5543 5549 -2 5543 5549 5543 -2 5549 5543 5549 5543 5549 5543 -2 5549 5543 -3 5549 5543 5549 -6 5543 -2 5549 -3 5543 5549 -2 5543 5549 5543 -2 5549 5543 5549 5543 5549 5543 5549 5543 -2 5549 -2 5543 -2 5549 5543 5549 5543 -3 5549 -3 5543 5549 5543 5547 -2 5539 5540 -44 0 -2 5549 -2 5543 5549 5543 5549 5543 5549 5543 -2 5549 -3 5543 -3 5549 5543 -4 5549 5543 5549 5543 5549 -2 5543 5549 5543 -3 5549 -4 5543 5549 -3 5543 5549 5543 5549 -8 5543 5549 -4 5543 -3 5549 5543 5549 -4 5543 5547 5539 5540 -42 0)
    )
    (tilemap
      (solid #f)
      (z-pos -110)
      (width 112)
      (height 45)
      (tiles 2192 2187 2179 2187 2180 2197 2195 2187 2195 2190 -102 0 2193 2184 2180 2195 2188 2179 -2 2197 2179 2198 2186 -102 0 2192 2181 2197 2189 2181 2180 2181 2189 2179 2198 2186 -101 0 2193 2184 2179 2196 -2 2187 2195 2179 2187 2181 2198 2186 -101 0 2193 2184 2179 2197 2179 2180 2187 2180 2179 2180 2198 2186 -101 0 2193 2184 2181 2188 2195 2180 -2 2197 2179 2195 2198 2186 -101 0 2193 2184 2197 2181 2197 2195 2196 2180 2196 2197 2198 2186 -101 0 2193 2184 2197 -2 2187 2196 2181 2179 2181 2196 2198 2186 -101 0 2193 2183 2184 2189 2196 2189 2188 2196 2188 2189 2198 2186 -102 0 2193 -2 2183 2184 2197 2188 2180 2189 2182 2194 -105 0 2193 -4 2183 2194 -1116 0 2185 -13 2199 2186 -84 0 -9 2199 2186 -2 0 2185 2200 -2 2179 2187 2195 2181 2189 2188 2196 2179 2195 2180 -2 2189 2190 -84 0 2179 2188 2179 -2 2197 2181 -2 2197 2180 2198 -2 2199 2200 2189 2181 2187 2182 2184 2182 2183 2184 2180 2187 2196 2187 2180 2182 2194 -84 0 2179 2187 -2 2189 2196 2181 2180 2188 2197 2196 2179 2196 2197 2189 2187 2182 2194 2193 2194 0 2192 2187 2182 2184 2180 2182 2194 -85 0 2179 2197 2196 2180 2195 2188 2189 2197 2195 2197 -2 2188 2196 2182 2184 2190 -4 0 2193 2184 2198 2200 2197 2190 -86 0 -2 2180 2188 2197 -2 2187 2197 -2 2187 2182 2184 2179 2182 2201 2202 2194 -5 0 2193 2184 2197 2196 2190 -86 0 2181 2189 2197 2187 2189 2196 2181 2180 2182 2201 2200 2196 2198 2200 2190 -6 0 2185 2200 2187 2182 2194 -86 0 2188 2196 2188 2181 2189 2179 2196 2179 2198 2200 2196 2187 2197 2187 2190 -6 0 2193 2184 2189 2190 -87 0 2188 2179 2197 2179 2189 2180 2181 2195 2189 2196 2182 2184 2179 2180 2198 2186 -6 0 2192 2187 2198 2186 -86 0 2189 2188 2189 2197 -2 2189 2197 2187 2195 2180 2198 2200 2188 2196 2195 2198 2186 -2 0 2185 2186 2185 2200 2197 2188 2190 -86 0 2187 2195 2179 2195 2187 2197 2189 2188 2196 2187 2197 2187 2196 2189 2196 2187 2198 -2 2199 2200 2198 2200 2180 -2 2181 2198 2186 -85 0 2195 2179 2187 2189 2195 2180 2179 2188 2179 2180 2195 2196 2181 2188 2179 2180 2197 2181 2188 2179 2188 2189 2188 2179 2181 2189 2190 -85 0 2196 2188 2180 2188 2196 2187 2196 -2 2188 2196 2195 2179 2197 -2 2181 2196 2179 2195 2179 2180 2179 2189 2196 2182 -2 2183 2194 -85 0 2197 2195 2196 2180 -2 2179 2187 2188 2195 2189 2195 2188 2187 2182 -9 2183 2194 -88 0 2197 2179 2188 2179 2180 2182 -7 2183 2194 -98 0 -5 2183 2194 -1114 0)
    )
  )
)
