(supertux-level
  (version 3)
  (name (_ "Off to the Glacier Isles"))
  (author "Carsten Wirtz")
  (license "CC-BY-SA 4.0 International")
  (allow-item-pocket "off")
  (icon "")
  (icon-locked "")
  (statistics
    (enable-coins #f)
    (enable-secrets #f)
  )
  (sector
    (name "main")
    (init-script "import(\"levels/world1/yetiwin_cutscene.nut\");

Text.set_anchor_point(7);
Text.set_anchor_offset(0, -160);

trigger_state(\"start\");")
    (ambient-light
      (color 1 1 1)
    )
    (background
      (scroll-offset-y -20)
      (color 1 1 1)
      (speed 0)
      (image-top "/images/background/misc/transparent_up.png")
      (image "/images/background/antarctic/snow_panorama.png")
      (z-pos -250)
    )
    (background
      (color 1 1 1)
      (scroll-speed-x -2)
      (speed 0)
      (image "/images/background/misc/clouds.png")
      (z-pos -280)
    )
    (background
      (color 1 1 1)
      (scroll-speed-x -0.1)
      (speed 0)
      (image "/images/background/misc/skybox.png")
      (z-pos -290)
    )
    (camera
      (name "Camera")
      (mode "manual")
    )
    (gradient
      (top_color 0.5 0.7 1)
      (bottom_color 1 1 1)
    )
    (music
      (file "/music/antarctic/midday.music")
    )
    (particles-snow
    )
    (path
      (name "gen16930779661808235560736")
      (path
        (adapt_speed #f)
        (node
          (x 4160)
          (y 768)
          (easing "EaseQuadInOut")
        )
        (node
          (x 4160)
          (y 752)
          (easing "EaseQuadInOut")
        )
      )
    )
    (path
      (name "gen16930779661808235559168")
      (path
        (adapt_speed #f)
        (node
          (x 4544)
          (y 752)
          (easing "EaseQuadInOut")
        )
        (node
          (x 4544)
          (y 768)
          (easing "EaseQuadInOut")
        )
      )
    )
    (path
      (name "gen16930780021808235555136")
      (path
        (adapt_speed #f)
        (node
          (x 5184)
          (y 752)
          (easing "EaseQuadInOut")
        )
        (node
          (x 5184)
          (y 768)
          (easing "EaseQuadInOut")
        )
      )
    )
    (path
      (name "gen16930780031808235553568")
      (path
        (adapt_speed #f)
        (node
          (x 4896)
          (y 768)
          (easing "EaseQuadInOut")
        )
        (node
          (x 4896)
          (y 752)
          (easing "EaseQuadInOut")
        )
      )
    )
    (path
      (name "gen16930780031808235554464")
      (path
        (adapt_speed #f)
        (node
          (x 5920)
          (y 752)
          (easing "EaseQuadInOut")
        )
        (node
          (x 5920)
          (y 768)
          (easing "EaseQuadInOut")
        )
      )
    )
    (path
      (name "gen16930780031808235556480")
      (path
        (adapt_speed #f)
        (node
          (x 5568)
          (y 768)
          (easing "EaseQuadInOut")
        )
        (node
          (x 5568)
          (y 752)
          (easing "EaseQuadInOut")
        )
      )
    )
    (path
      (name "gen16930781311808235552896")
      (path
        (adapt_speed #f)
        (node
          (x 6240)
          (y 768)
          (easing "EaseQuadInOut")
        )
        (node
          (x 6240)
          (y 752)
          (easing "EaseQuadInOut")
        )
      )
    )
    (platform
      (z-pos 50)
      (handle
        (scale_x 0)
        (scale_y 0)
        (offset_x 0)
        (offset_y 0)
      )
      (path-ref "gen16930779661808235560736")
      (sprite "/images/objects/platforms/icefloe.sprite")
    )
    (platform
      (z-pos 50)
      (handle
        (scale_x 0)
        (scale_y 0)
        (offset_x 0)
        (offset_y 0)
      )
      (path-ref "gen16930779661808235559168")
      (sprite "/images/objects/platforms/icefloe_small.sprite")
    )
    (platform
      (z-pos 50)
      (handle
        (scale_x 0)
        (scale_y 0)
        (offset_x 0)
        (offset_y 0)
      )
      (path-ref "gen16930779661808235560736")
      (sprite "/images/objects/platforms/icefloe.sprite")
    )
    (platform
      (z-pos 50)
      (handle
        (scale_x 0)
        (scale_y 0)
        (offset_x 0)
        (offset_y 0)
      )
      (path-ref "gen16930779661808235560736")
      (sprite "/images/objects/platforms/icefloe.sprite")
    )
    (platform
      (z-pos 50)
      (handle
        (scale_x 0)
        (scale_y 0)
        (offset_x 0)
        (offset_y 0)
      )
      (path-ref "gen16930780021808235555136")
      (sprite "/images/objects/platforms/icefloe.sprite")
    )
    (platform
      (z-pos 50)
      (handle
        (scale_x 0)
        (scale_y 0)
        (offset_x 0)
        (offset_y 0)
      )
      (path-ref "gen16930780031808235553568")
      (sprite "/images/objects/platforms/icefloe_small.sprite")
    )
    (platform
      (z-pos 50)
      (handle
        (scale_x 0)
        (scale_y 0)
        (offset_x 0)
        (offset_y 0)
      )
      (path-ref "gen16930780031808235554464")
      (sprite "/images/objects/platforms/icefloe_small.sprite")
    )
    (platform
      (z-pos 50)
      (handle
        (scale_x 0)
        (scale_y 0)
        (offset_x 0)
        (offset_y 0)
      )
      (path-ref "gen16930780031808235556480")
      (sprite "/images/objects/platforms/icefloe_small.sprite")
    )
    (platform
      (z-pos 50)
      (handle
        (scale_x 0)
        (scale_y 0)
        (offset_x 0)
        (offset_y 0)
      )
      (path-ref "gen16930781311808235552896")
      (sprite "/images/objects/platforms/icefloe.sprite")
    )
    (scriptedobject
      (z-pos 50)
      (name "YETI")
      (sprite "/images/creatures/yeti/yeti.sprite")
      (x 736)
      (y 544)
    )
    (scriptedobject
      (z-pos 50)
      (name "TUX")
      (sprite "/images/creatures/tux/tux.sprite")
      (x 672)
      (y 544)
    )
    (scripttrigger
      (oneshot #t)
      (script "trigger_state(\"textbox\");")
      (button #f)
      (width 32)
      (height 96)
      (x 320)
      (y 0)
    )
    (spawnpoint
      (name "main")
      (x 256)
      (y 32)
    )
    (tilemap
      (solid #f)
      (z-pos -100)
      (width 245)
      (height 35)
      (tiles -245 0 2624 0 2621 -4 0 106 107 108 -240 0 24 0 109 110 111 2622 0 5203 5204 -2748 0 1321 1322 1323 1324 -216 0 122 123 -14 0 122 123 -7 0 1325 1326 1327 1328 -211 0 122 123 -3 0 124 125 -10 0 122 123 -2 0 124 125 -2 0 122 123 -3 0 1329 1330 1331 1332 -175 0 5203 5204 -29 0 122 123 -3 0 124 125 -3 0 124 125 -8 0 2622 0 1345 1344 -2 0 1345 1344 24 0 1345 1344 -3 0 1333 1334 1335 1336 2621 0 5203 5204 2622 -175 0 2621 -3 0 106 107 108 -14 0 106 107 108 -2 0 124 125 -3 0 124 125 -3 0 1345 1344 0 5203 5204 -38 0 106 107 108 -167 0 109 110 111 0 2622 0 24 0 2625 2626 -2 0 5203 5204 2621 -2 0 109 110 111 -2 0 1345 1344 0 2621 0 1345 1344 -46 0 109 110 111 24 -250 0 2621 -2 0 2625 2626 0 2622 0 24 -253 0 2622 -250 0 5203 5204 2621 -3310 0)
    )
    (tilemap
      (solid #t)
      (z-pos 0)
      (width 245)
      (height 35)
      (tiles -245 0 -2 8 2913 2914 -241 0 3990 14 2915 2916 2917 2918 -8 8 9 -230 0 5369 -2 11 1835 2919 2920 -4 14 3990 -2 14 3990 15 -230 0 5369 -6 11 5368 11 5368 11 5368 11 2929 5373 -230 0 -3 11 5369 -2 5368 5369 -2 11 2929 2930 -2 17 2931 -231 0 -2 11 2929 2930 -3 17 3991 17 2931 -235 0 11 2935 2931 -242 0 2935 2936 -243 0 2936 -1714 0 2917 2918 2913 2914 -45 0 2909 2910 -26 8 2913 2914 -166 0 2919 2920 2915 2916 2917 2918 8 2913 2914 -32 0 2909 2910 -4 8 2921 2922 2911 2912 -2 14 3990 -2 14 3988 -6 14 3990 -3 14 3989 -2 14 3990 -2 14 3989 -3 14 2915 2916 2917 2918 8 2913 2914 -161 0 -3 11 1835 2919 2920 14 2915 2916 2917 2918 -28 8 2921 2922 2911 2912 -4 14 2923 2924 1834 -2 11 5368 11 5368 5369 11 5368 -2 11 -2 5369 5368 5369 5368 -9 11 5369 -3 11 1835 2919 2920 14 2915 2916 2917 2918 -4 8 2913 2914 -153 0 -8 11 1835 2919 2920 -12 14 3990 -5 14 3990 -2 14 3989 -2 3990 3989 -3 14 2923 2924 1834 -10 11 -2 5368 11 5369 11 5368 5369 11 5368 11 5368 -4 11 5368 -2 11 5368 11 5368 5369 -2 11 5369 -6 11 1835 2919 2920 -4 14 2915 2916 2917 2918 -11 8 2913 2914 -138 0 -2 11 5368 11 -2 5368 5369 -13 11 5369 11 5369 -9 11 5368 -2 11 5369 -7 11 -2 5368 5369 11 5369 5368 5369 -3 11 5369 5368 11 5369 11 5369 11 5369 -2 11 5368 -2 5369 -4 11 5368 5369 11 5369 5368 -2 11 5368 11 5368 11 5368 -4 11 19 5369 -3 11 1835 2919 2920 -9 14 3989 14 2915 2916 2917 2918 -4 8 2913 2914 -130 0 -3 11 5368 11 5368 11 -2 5369 -3 11 -2 5369 -4 11 5368 -2 5369 -3 11 5368 -2 5369 5368 -2 11 5368 -2 5369 5368 -3 11 5369 5368 -3 11 5368 5369 -7 11 5368 -2 11 -2 5369 -4 11 -2 5368 -3 11 -3 5369 11 5369 -2 11 5369 -3 11 5369 -2 11 5368 -2 11 5368 11 5368 -3 11 5368 -5 11 5368 11 5368 5369 -2 11 5369 -2 11 5368 -2 11 1835 2919 2920 -4 14 2915 2916 2917 2918 -3 8 2913 2914 -123 0 11 5369 -3 11 5368 -2 11 5368 -2 11 -2 5368 5369 5368 11 5369 -2 11 5368 5369 5368 -3 11 5368 5369 -2 11 5368 11 5369 -2 11 5369 -3 11 5368 -3 11 5368 -2 11 5368 11 -2 5368 5369 -2 11 5368 -2 11 -2 5369 -2 11 -2 5369 11 -2 5368 -3 11 5368 -3 11 5368 11 5368 -7 11 5368 5369 -3 11 -3 5368 11 5368 11 5368 -3 11 5369 -3 11 -2 5369 -8 11 5368 -3 11 1835 2919 2920 -3 14 2915 2916 1832 1827 -121 0 -2 11 -2 5369 11 -2 5368 5369 -5 11 5369 11 -2 5368 11 5368 11 5369 11 5369 11 5368 -2 11 5368 -4 11 5369 5368 -2 11 5368 -2 11 -3 5369 -2 11 5369 -2 11 5368 -3 11 5368 11 5368 -4 11 5368 5369 11 5369 5368 -3 11 5369 -3 11 5368 -7 11 -2 5369 -4 5368 5369 11 5369 -2 11 5368 11 5369 -4 11 -2 5369 -2 11 5368 -3 11 5368 11 5369 11 -2 5368 11 5369 -9 11 1835 1836 1831 5385 -120 0 -3 11 5368 11 -2 5369 -3 11 5369 5368 -4 11 -2 5368 -3 11 5368 5369 5368 11 -3 5368 11 5369 11 5368 5369 -4 11 5368 5369 -3 11 5368 -2 11 5369 -6 11 5368 11 5368 11 5368 11 5368 11 -2 5368 -3 11 5369 -2 11 5369 11 5368 -2 5369 5368 -2 11 5369 -2 11 5368 -3 11 -2 5369 11 5368 -9 11 5368 11 5369 5368 -7 11 5369 -2 11 5369 11 5368 -2 5369 5368 11 5369 11 5369 -3 11 1835 5389 -120 0 -2 5368 5369 -11 11 5369 11 5369 -2 11 -2 5368 -4 11 5369 11 5368 -2 5369 5368 -2 11 5368 11 5369 -2 11 5369 5368 -2 11 5368 11 5368 -2 11 5368 -5 11 5368 11 5369 5368 11 5369 -2 11 5369 -2 11 5368 -2 5369 11 5369 -3 11 5369 5368 11 5368 -2 11 5369 11 5369 -2 11 5369 -2 5368 -5 11 -2 5369 11 -2 5368 11 5369 -4 11 -2 5368 11 -2 5368 -4 11 5369 -5 11 5369 -2 11 5368 -3 11 5375 -120 0 5368 5369 -2 11 5369 11 -2 5368 5369 -2 5368 -2 11 -2 5368 -2 11 5368 11 5369 -8 11 5368 -3 11 -4 5368 -2 5369 -2 11 5369 -2 11 5369 -2 11 -2 5369 -3 11 5368 -2 11 5369 5368 -2 11 5368 5369 11 -2 5368 -5 11 -2 5368 -2 11 5368 -2 11 5368 5369 -3 11 5369 11 5368 -6 11 5369 -4 11 -2 5369 -6 11 5368 5369 11 -2 5368 11 -3 5368 11 5368 5369 -2 11 5369 5368 -2 11 5369 -3 11 2941 -120 0 5369 11 5369 5368 5369 -3 11 -2 5369 -11 11 5368 -2 5369 5368 -2 11 1539 -3 11 5368 11 5369 11 5369 -2 11 5368 -3 11 5368 11 5369 5368 5369 -5 11 5368 -4 11 5368 5369 5368 11 5369 11 5369 5368 11 -3 5369 5368 11 5368 5369 -8 11 5368 -3 11 -2 5369 11 5368 -2 11 5368 -3 11 5369 -6 11 -2 5368 11 -2 5368 11 5368 5369 5368 11 5369 -8 11 5369 11 2935 2942 -120 0 5369 -3 11 5369 -2 5368 11 5369 11 -2 5369 11 5368 -5 11 5369 -2 11 5368 -3 11 5368 11 5368 5369 -8 11 5368 5369 11 5369 -2 5368 5369 -6 11 5368 11 5368 11 5368 11 5369 5368 -2 11 5368 -2 5369 5368 5369 11 5369 5368 -2 11 -3 5368 -4 11 -2 5369 5368 5369 -2 11 5369 -3 11 5369 -2 11 5368 -2 11 5369 5368 5369 5368 5369 5368 -2 5369 -7 11 -2 5368 -3 11 5369 -7 11 2940 2936 -121 0 -3 5369 11 -2 5369 -3 11 5368 11 -2 5369 -2 11 -2 5368 11 -2 5368 -4 11 5369 -4 11 5369 11 5369 11 5369 11 5369 -2 11 -2 5368 11 5368 -4 11 5368 -5 11 -2 5368 11 5369 -2 11 5368 5369 11 -2 5369 11 5369 11 5369 11 5369 -4 11 5369 -2 11 5369 -2 11 5369 5368 11 5368 5369 11 5368 -2 11 5368 -4 11 5369 -8 11 -2 5368 11 -2 5369 5368 -5 11 5368 -3 11 5368 5369 -3 11 2941 -122 0 -6 11 -2 5369 -5 11 5369 -8 11 19 -2 5368 -3 11 5368 -8 5369 -2 11 5368 11 5369 -2 5368 11 -2 5368 5369 -5 11 -2 5369 -8 11 -3 5368 -2 11 -3 5368 11 5369 -3 11 5369 11 5369 -2 11 -3 5369 11 5368 -3 11 5369 5368 5369 -2 11 5368 11 19 -5 11 5369 11 5368 -3 11 5368 -3 11 5369 5368 11 19 5369 -2 11 5369 11 2940 2942 -122 0 -3 11 5369 11 5368 11 5369 11 5368 -2 11 5368 5369 11 5368 11 5368 5369 11 -3 5369 11 5368 -2 5369 5368 -2 11 5368 11 5368 -3 11 5368 -2 11 5369 -2 11 5368 -3 11 5369 5368 5369 -2 11 5368 -7 11 -2 5369 5368 -3 11 5368 -3 11 5369 -3 11 5369 -2 11 5368 -2 11 5369 11 5369 -2 5368 5369 11 5368 11 5368 11 -2 5369 -2 11 1539 -7 11 5369 11 5369 -5 11 -2 5369 5368 -2 11 5368 11 5368 11 5368 11 2941 -123 0 11 -3 5368 -3 11 -2 5369 -4 11 -2 5368 -4 11 5368 11 5369 -3 11 5368 -3 11 -3 5368 19 -3 11 5368 5369 -3 11 -2 5369 11 5368 -3 11 5368 5369 -2 11 5369 5368 11 5369 -2 11 5369 11 5369 -3 11 5369 -3 11 5369 11 5369 -2 11 5368 -2 5369 -3 11 5368 11 5368 -4 11 5369 -2 5368 11 -2 5368 -5 11 5369 11 5369 -2 11 5368 -2 5369 11 -2 5368 11 5369 -5 11 5368 -2 11 5368 11 2935 2942 -123 0 -3 11 5368 -3 11 5369 11 5369 11 5369 11 5369 -3 11 5368 11 5369 -2 11 5368 -5 11 5369 11 5369 11 5368 11 5368 11 5369 5368 -2 11 5368 11 5368 -2 11 5369 -2 5368 11 -2 5369 1539 5368 -2 11 5368 5369 11 5369 5368 -3 11 5369 -3 11 5369 11 5368 5369 -10 11 5369 -4 11 5368 -2 11 5368 -2 11 5368 11 5368 11 5368 11 5368 11 5369 5368 11 5368 -7 11 5368 -3 5369 5368 -3 11 2940 2936 -124 0 -2 11 5369 11 5368 11 5368 5369 -2 5368 -2 11 -2 5369 5368 -2 5369 -9 11 5369 -10 11 5368 11 5368 -4 11 -2 5368 11 -2 5368 11 5369 11 5369 11 5369 11 5369 -2 11 5369 -2 11 5368 -2 11 5369 -8 11 5369 5368 -5 11 5369 11 5369 5368 5369 11 -2 5368 5369 -2 11 5369 5368 5369 5368 5369 5368 5369 5368 -2 11 5369 -2 11 5369 -4 11 5368 -8 11 2941 -125 0)
    )
    (tilemap
      (solid #t)
      (z-pos -101)
      (width 245)
      (height 35)
      (tiles -6004 0 2019 2140 2141 2142 2019 2140 2141 2142 2019 2140 2141 2142 2019 2140 2141 2142 2019 2140 2141 2142 2019 2140 2141 2142 2019 2140 2141 2142 2019 2140 2141 2142 2019 2140 2141 2142 2019 2140 2141 2142 2019 2140 2141 2142 2019 2140 2141 2142 2019 2140 2141 2142 2019 2140 2141 2142 2019 2140 2141 2142 2019 2140 2141 2142 2019 2140 2141 2142 2019 2140 2141 2142 2019 2140 2141 2142 2019 2140 2141 2142 2019 2140 2141 2142 2019 2140 2141 2142 2019 2140 2141 2142 2019 2140 2141 2142 2019 2140 2141 2142 2019 2140 2141 2142 2019 2140 2141 2142 2019 2140 2141 2142 2019 2140 2141 2142 2019 2140 2141 2142 2019 -124 0 -121 2020 -124 0 -121 2020 -123 0 -122 2020 -122 0 -123 2020 -122 0 -123 2020 -121 0 -124 2020 -121 0 -124 2020 -120 0 -125 2020 -119 0 -126 2020 -119 0 -126 2020)
    )
    (tilemap
      (solid #f)
      (z-pos -110)
      (width 245)
      (height 35)
      (tiles -982 0 2185 -8 2199 2186 -233 0 2185 2199 2200 2189 -2 2181 2188 2195 2180 2197 2182 2194 -233 0 2200 2181 2197 2195 2187 2195 2197 2181 2197 2182 2194 -234 0 2195 2188 -4 2179 2182 2184 2182 2194 -235 0 2196 2189 2188 2181 2188 2182 2194 2193 2194 -236 0 2197 2195 -2 2187 2182 2194 -239 0 2179 2197 2196 2197 2190 -240 0 -3 2179 2182 2194 -240 0 2179 2180 2188 2190 -241 0 2180 2188 2195 2190 -241 0 2181 2187 2179 2198 2186 -240 0 2188 2196 2181 2179 2190 -240 0 2189 2179 2187 2189 2198 2186 -239 0 2189 2180 -2 2179 2180 2198 2186 -238 0 2187 -2 2188 2189 2197 2188 2190 -238 0 -6 2183 2194 -1340 0 2185 2199 2186 -241 0 2185 2200 2179 2198 2186 -239 0 2185 2200 2197 2195 2187 2190 -239 0 2192 2189 -2 2188 2189 2198 2186 -237 0 2185 2200 2195 2196 2179 2180 2187 2190 -237 0 2192 2196 2197 2180 2189 2179 2187 2198 2186 -235 0 2185 2200 2195 2179 2189 2179 2195 2189 2188 2190 -235 0 2192 2180 2195 2180 2196 2189 -2 2188 2187 2198 2186 -233 0 2185 2200 2197 2189 2181 -3 2179 2181 2195 2181 2198 2186 -232 0 2192 2195 2189 2181 2180 2181 2188 2195 2179 2196 2187 2195 2198 2186 -231 0 2192 -3 2179 2180 2188 2196 2181 2197 2196 2197 2180 2196 2198 2186 -113 0)
    )
    (tilemap
      (solid #f)
      (z-pos 100)
      (width 245)
      (height 35)
      (tiles -5635 0 5540 -46 0 5538 -3 5539 5540 -193 0 5547 5539 5540 -6 0 5538 -3 5539 5540 -19 0 5538 5539 5540 -6 0 5538 5539 5540 0 5538 5548 -3 5549 5547 5539 5540 -2 0 5538 -2 5539 5540 -185 0 -2 5543 5547 5540 -3 0 5538 5539 5548 -3 5549 5547 5540 -5 0 5538 -4 5539 5540 -6 0 5538 5548 5549 5547 5540 -2 0 5538 -2 5539 5548 5543 5547 5539 5548 5543 -5 5549 5547 -2 5539 5548 -2 5543 5547 -2 5539 5540 -182 0 -2 5543 5549 5547 -3 5539 5548 -3 5543 -2 5549 5543 5547 -5 5539 5548 5543 5549 5543 5549 5547 5539 5540 -2 0 5538 5539 5548 -3 5543 5547 -2 5539 5548 5543 5549 -3 5543 5549 -3 5543 -2 5549 5543 -2 5549 -2 5543 -2 5549 -2 5543 5549 5543 5547 -3 5539 5540 -178 0 5543 5549 -3 5543 -3 5549 -2 5543 5549 5543 5549 5543 -6 5549 5543 5549 -3 5543 -2 5549 5547 -2 5539 5548 5543 5549 5543 5549 5543 5549 -2 5543 -3 5549 5543 5549 -3 5543 5549 5543 -3 5549 5543 -2 5549 5543 5549 -5 5543 5549 -2 5543 5549 5547 -4 5539 5540 -173 0 5543 -3 5549 -3 5543 5549 5543 5549 -2 5543 5549 5543 -2 5549 5543 -2 5549 5543 5549 -3 5543 5549 -2 5543 5549 -2 5543 -8 5549 -2 5543 5549 -4 5543 5549 5543 -4 5549 5543 5549 5543 5549 5543 5549 -9 5543 5549 -2 5543 -2 5549 5547 -4 5539 5540 -9 0 5538 -4 5539 5540 -153 0 -3 5543 5549 -2 5543 5549 5543 5549 5543 5549 -2 5543 -2 5549 -2 5543 5549 -2 5543 -4 5549 5543 -4 5549 5543 5549 5543 5549 5543 5549 5543 5549 -3 5543 5549 -2 5543 -3 5549 5543 -5 5549 -4 5543 -2 5549 -2 5543 5549 -2 5543 5549 -3 5543 5549 5543 -3 5549 -2 5543 -2 5549 5547 -2 5539 5540 -3 0 5538 -2 5539 5548 5549 5543 -2 5549 5547 -3 5539 5540 -149 0 5543 -3 5549 5543 5549 -2 5543 5549 5543 5549 5543 5549 5543 5549 5543 -6 5549 -3 5543 5549 5543 5549 -10 5543 5549 5543 5549 -3 5543 5549 -3 5543 -5 5549 -2 5543 -8 5549 -3 5543 -2 5549 -3 5543 5549 5543 5549 5543 5549 5543 5549 5543 5547 -3 5539 5548 5549 5543 -3 5549 -3 5543 -2 5549 5543 5547 -3 5539 5540 -145 0 -2 5549 -2 5543 5549 5543 5549 5543 5549 5543 -2 5549 -2 5543 5549 5543 5549 -2 5543 5549 -3 5543 5549 -4 5543 -2 5549 5543 5549 -2 5543 5549 -2 5543 5549 -3 5543 5549 5543 -3 5549 -3 5543 -2 5549 5543 -7 5549 -3 5543 -3 5549 -2 5543 -2 5549 5543 5549 5543 5549 5543 -2 5549 -2 5543 5549 5543 5549 -4 5543 5549 5543 5549 5543 5549 -2 5543 -2 5549 5543 -4 5549 5547 -3 5539 5540 -141 0 5549 -3 5543 5549 5543 5549 -2 5543 -4 5549 -2 5543 -4 5549 5543 5549 5543 -2 5549 -3 5543 -2 5549 -4 5543 -3 5549 -2 5543 -3 5549 -2 5543 5549 5543 -2 5549 -3 5543 -2 5549 -4 5543 -2 5549 -3 5543 -3 5549 5543 -3 5549 5543 5549 5543 -2 5549 -4 5543 -2 5549 5543 5549 5543 -4 5549 -6 5543 5549 5543 5549 5543 5549 5543 5549 5543 -2 5549 5543 5547 -2 5539 5540 -138 0 -3 5549 5543 -2 5549 -2 5543 5549 5543 5549 -3 5543 5549 5543 5549 5543 5549 5543 5549 -2 5543 -5 5549 5543 5549 5543 5549 5543 5549 5543 5549 -2 5543 -2 5549 -3 5543 -2 5549 -8 5543 -2 5549 -2 5543 5549 -2 5543 -3 5549 5543 -3 5549 5543 5549 -3 5543 -2 5549 -5 5543 -2 5549 5543 -4 5549 5543 -2 5549 5543 -2 5549 5543 5549 5543 5549 5543 5549 5543 5549 -2 5543 5549 5543 -2 5549 5547 -2 5539 5540 -135 0 -2 5549 5543 5549 -6 5543 -2 5549 -5 5543 -3 5549 5543 -3 5549 5543 5549 5543 -10 5549 5543 5549 5543 -3 5549 -8 5543 5549 5543 5549 -3 5543 -2 5549 5543 5549 -3 5543 5549 5543 5549 5543 -6 5549 -2 5543 -5 5549 5543 5549 -3 5543 5549 -3 5543 -2 5549 -8 5543 -2 5549 5543 -2 5549 5543 -3 5549 5547 5540 -134 0)
    )
  )
  (sector
    (name "ocean")
    (ambient-light
      (color 1 1 1)
    )
    (background
      (color 1 1 1)
      (alignment "bottom")
      (speed 0)
      (speed-y 0.01)
      (image "/images/background/antarctic/snow_panorama.png")
      (z-pos -250)
    )
    (camera
      (name "Camera")
      (mode "normal")
    )
    (gradient
      (top_color 0.3 0.4 0.75)
      (bottom_color 1 1 1)
    )
    (invisible_wall
      (width 2240)
      (height 32)
      (x 640)
      (y 832)
    )
    (music
      (file "/music/antarctic/airship_remix-2.music")
    )
    (particles-snow
    )
    (path
      (name "gen15420549472276963603392")
      (path
        (adapt_speed #f)
        (node
          (x 960)
          (y 640)
          (time 1.6)
          (speed 10)
          (easing "EaseQuadInOut")
        )
        (node
          (x 960)
          (y 624)
          (time 1.6)
          (speed 10)
          (easing "EaseQuadInOut")
        )
      )
    )
    (path
      (name "gen15420549472276963605856")
      (path
        (adapt_speed #f)
        (node
          (x 1344)
          (y 640)
          (time 1.6)
          (speed 10)
          (easing "EaseQuadInOut")
        )
        (node
          (x 1344)
          (y 624)
          (time 1.6)
          (speed 10)
          (easing "EaseQuadInOut")
        )
      )
    )
    (path
      (name "gen15420549472276963607984")
      (path
        (adapt_speed #f)
        (node
          (x 1568)
          (y 640)
          (time 1.6)
          (speed 10)
          (easing "EaseQuadInOut")
        )
        (node
          (x 1568)
          (y 624)
          (time 1.6)
          (speed 10)
          (easing "EaseQuadInOut")
        )
      )
    )
    (path
      (name "gen15420549472276963606640")
      (path
        (adapt_speed #f)
        (node
          (x 1856)
          (y 640)
          (time 1.6)
          (speed 10)
          (easing "EaseQuadInOut")
        )
        (node
          (x 1856)
          (y 624)
          (time 1.6)
          (speed 10)
          (easing "EaseQuadInOut")
        )
      )
    )
    (path
      (name "gen15420549472276963608992")
      (path
        (adapt_speed #f)
        (node
          (x 2208)
          (y 640)
          (time 1.6)
          (speed 10)
          (easing "EaseQuadInOut")
        )
        (node
          (x 2208)
          (y 624)
          (time 1.6)
          (speed 10)
          (easing "EaseQuadInOut")
        )
      )
    )
    (path
      (name "gen15420549472276963603504")
      (path
        (adapt_speed #f)
        (node
          (x 2624)
          (y 640)
          (time 1.6)
          (speed 10)
          (easing "EaseQuadInOut")
        )
        (node
          (x 2624)
          (y 624)
          (time 1.6)
          (speed 10)
          (easing "EaseQuadInOut")
        )
      )
    )
    (platform
      (z-pos 50)
      (handle
        (scale_x 0)
        (scale_y 0)
        (offset_x 0)
        (offset_y 0)
      )
      (path-ref "gen15420549472276963603392")
      (sprite "/images/objects/platforms/icefloe.sprite")
    )
    (platform
      (z-pos 50)
      (handle
        (scale_x 0)
        (scale_y 0)
        (offset_x 0)
        (offset_y 0)
      )
      (path-ref "gen15420549472276963605856")
      (sprite "/images/objects/platforms/icefloe_small.sprite")
    )
    (platform
      (z-pos 50)
      (handle
        (scale_x 0)
        (scale_y 0)
        (offset_x 0)
        (offset_y 0)
      )
      (path-ref "gen15420549472276963607984")
      (sprite "/images/objects/platforms/icefloe_small.sprite")
    )
    (platform
      (z-pos 50)
      (handle
        (scale_x 0)
        (scale_y 0)
        (offset_x 0)
        (offset_y 0)
      )
      (path-ref "gen15420549472276963606640")
      (sprite "/images/objects/platforms/icefloe.sprite")
    )
    (platform
      (z-pos 50)
      (handle
        (scale_x 0)
        (scale_y 0)
        (offset_x 0)
        (offset_y 0)
      )
      (path-ref "gen15420549472276963608992")
      (sprite "/images/objects/platforms/icefloe_small.sprite")
    )
    (platform
      (z-pos 50)
      (handle
        (scale_x 0)
        (scale_y 0)
        (offset_x 0)
        (offset_y 0)
      )
      (path-ref "gen15420549472276963603504")
      (sprite "/images/objects/platforms/icefloe_small.sprite")
    )
    (scripttrigger
      (script "Tux.deactivate();
Effect.sixteen_to_nine(0);
Effect.fade_in(1.5);
Tux.walk(200);
wait(2.75);
Tux.walk(100);
wait(0.3);
Tux.walk(50);
wait(0.1);
Tux.walk(0);
wait(1);
Text.set_text(_(\"Tux: The thing over there must be the\\n     crystal mine the Yeti was talking\\n     about.\"));
Text.fade_in(1);
wait(3);
Text.fade_out(1);
wait(2);
Tux.walk(200);
Tux.do_jump(-200);
wait(0.68);
Tux.walk(0);
wait(0.3);
Tux.walk(225);
wait(0.3);
Tux.do_jump(-375);
wait(1.7);
Tux.do_jump(-375);
wait(1.2);
Tux.do_jump(-375);
wait(0.5);
Tux.walk(250);
Effect.fade_out(2);
wait(0.3);
Tux.walk(275);
Tux.do_jump(-420);
wait(1.5);
Tux.walk(225);
Tux.do_jump(-375);
wait(1.3);
Level.finish(true);")
      (button #f)
      (width 64)
      (height 160)
      (x 0)
      (y 416)
    )
    (spawnpoint
      (name "ocean")
      (x 0)
      (y 512)
    )
    (tilemap
      (solid #f)
      (z-pos -100)
      (width 90)
      (height 27)
      (tiles -1260 0 123 -89 0 125 -2 0 122 123 -13 0 2622 -71 0 125 -2 0 124 125 -2 0 122 123 -81 0 1344 5203 0 1345 1344 -2 0 1345 1344 0 2621 -7 0 2196 2190 0 106 107 108 -84 0 2179 2198 2186 109 110 111 0 5203 -784 0)
    )
    (tilemap
      (solid #f)
      (z-pos 100)
      (width 90)
      (height 27)
      (tiles -1980 0 -2 5539 5540 -2 0 5538 -2 5539 5540 -83 0 5547 -2 5539 5548 -2 0 5547 5540 -80 0 5538 5539 5540 -6 0 5547 -2 5539 5540 -77 0 5548 0 5547 5540 -4 0 5538 5539 5540 0 5547 5539 5540 -78 0 5547 5539 5540 5538 5539 5548 0 5547 5540 -2 0 5547 -2 5539 5540 -72 0)
    )
    (tilemap
      (solid #t)
      (z-pos 0)
      (width 90)
      (height 27)
      (tiles -1366 0 2909 2910 8 9 -84 0 1826 1829 2911 2912 14 15 -70 0 -12 8 2921 2922 1830 1833 1834 11 30 18 -70 0 -6 14 3990 -5 14 2923 2924 1834 -3 11 21 -6 8 9 -64 0 -18 11 20 -4 14 3990 14 15 -64 0 -25 11 12 -64 0 19 -23 11 30 18 -64 0 -23 11 30 18 -65 0 -15 11 19 -6 11 2935 18 -66 0 -4 11 115 116 -15 11 2940 2936 -67 0 -4 11 117 118 -15 11 2941 -68 0 -20 11 2935 2942 -68 0)
    )
    (tilemap
      (solid #f)
      (z-pos 110)
      (width 90)
      (height 27)
      (tiles -1800 0 2019 2140 2141 2142 2019 2140 2141 2142 2019 2140 2141 2142 2019 2140 2141 2142 2019 2140 2141 2142 2019 2140 2141 2142 2019 2140 2141 2142 2019 2140 2141 2142 2019 2140 2141 2142 2019 2140 2141 2142 2019 2140 2141 2142 2019 2140 2141 2142 2019 2140 2141 2142 2019 2140 2141 2142 2019 2140 2141 2142 2019 2140 2141 2142 2019 2140 2141 2142 2019 2140 2141 2142 2019 2140 2141 2142 2019 2140 2141 2142 2019 2140 2141 2142 2019 2140 2141 2142 2019 2140 -540 2020)
    )
  )
)
