(supertux-level
  (version 3)
  (name (_ "A Yeti in the Distance"))
  (author "Carsten Wirtz")
  (license "GPL 2+ / CC-by-sa 3.0")
  (allow-item-pocket "inherit")
  (icon "")
  (icon-locked "")
  (statistics
    (enable-coins #t)
    (enable-badguys #f)
    (enable-secrets #t)
  )
  (sector
    (name "main")
    (init-script "import(\"levels/world1/yeti_cutscene.nut\");
start_cutscene();
initialize();")
    (ambient-light
      (color 0.9 0.8 0.8)
    )
    (background
      (color 1 0.9 0.9)
      (speed 0.1)
      (speed-y 0)
      (image "/images/background/antarctic/ice_mountains.png")
      (z-pos -200)
    )
    (background
      (color 1 0.75 0.82)
      (speed 0)
      (image-top "/images/background/misc/transparent_up.png")
      (image "/images/background/antarctic/ice_mountains_panorama.png")
      (z-pos -250)
    )
    (background
      (color 1 1 1)
      (alignment "top")
      (scroll-speed-x -5)
      (speed 0)
      (image "/images/background/misc/skybox.png")
      (z-pos -280)
    )
    (background
      (color 1 1 1)
      (speed 0)
      (fill #t)
      (target "lightmap")
      (image "/images/background/misc/vignette.png")
    )
    (camera
      (name "Camera")
      (mode "normal")
    )
    (gradient
      (top_color 0.7 0.1 0.5)
      (bottom_color 1 1 0.1)
    )
    (music
      (file "/music/antarctic/sunset.music")
    )
    (scriptedobject
      (z-pos 50)
      (name "Yeti")
      (sprite "/images/creatures/yeti/yeti.sprite")
      (x 1951.625)
      (y 640.1522)
    )
    (spawnpoint
      (name "main")
      (x 95.43721)
      (y 832.0942)
    )
    (tilemap
      (solid #f)
      (z-pos -100)
      (name "Background")
      (width 100)
      (height 35)
      (tiles 2198 2186 -98 0 2181 2198 2186 -97 0 2189 2197 2198 2186 -2 0 122 123 -92 0 2196 2180 2181 2198 2186 0 124 125 -94 0 2189 2197 2198 2186 1345 1344 -189 0 106 107 108 -10 0 24 -86 0 109 110 111 -196 0 2062 -3 2063 -83 0 24 -190 0 2062 -4 2063 2051 2060 2050 -2 2063 2064 -80 0 122 123 -2 0 122 123 -8 0 2057 2060 2059 -7 0 24 -75 0 124 125 -2 0 124 125 -8 0 2057 2065 2059 -83 0 1345 1344 -2 0 1345 1344 24 -7 0 2057 2058 2059 -3 0 2062 2051 2071 2070 2059 -89 0 2057 2070 2059 -4 0 2057 2058 0 2055 2054 -2 0 1321 1322 1323 1324 -2 0 2062 -64 0 2062 2063 2051 2060 2061 2050 2063 2064 -7 0 2057 2058 2059 -4 0 2062 2051 -5 0 1325 1326 1327 1328 -69 0 2057 2065 2066 2059 -17 0 2057 2071 2058 2050 2064 0 1329 1330 1331 1332 -69 0 2057 2060 2061 2059 -4 0 106 107 108 -2 0 2057 2058 2059 -5 0 2057 2058 2070 2059 -2 0 1333 1334 1335 1336 -69 0 2057 2065 2066 2059 -4 0 109 110 111 -2 0 2057 2058 2059 0 24 -2 0 2052 2056 2058 2050 2064 -8 0 24 2196 2180 2181 2190 -57 0 24 -4 0 2057 2058 -32 0 2179 2188 2189 2190 -96 0 2180 2181 2182 2194 -96 0 2188 2189 2190 -24 0 1321 1322 1323 1324 -69 0 2180 2181 2190 -12 0 122 123 -10 0 1325 1326 1327 1328 -69 0 2188 2189 2198 2186 -7 0 122 123 -2 0 124 125 -2 0 122 123 -6 0 1329 1330 1331 1332 -2 0 122 209 123 -64 0 2187 2195 2196 2198 2186 106 107 108 -3 0 124 125 -2 0 124 125 -2 0 124 125 -6 0 1333 1334 1335 1336 -2 0 124 210 125 -10 0 106 107 108 -51 0 2197 2187 2195 2179 2190 109 110 111 24 -2 0 1345 1344 -2 0 1345 1344 24 0 1345 1344 -12 0 1345 1346 1344 -3 0 24 -2 0 24 -3 0 109 110 111 -51 0 2197 2187 2195 2196 2190 -695 0)
    )
    (tilemap
      (solid #t)
      (z-pos 0)
      (name "Interactive")
      (width 100)
      (height 35)
      (tiles -100 0 3149 -99 0 3151 3152 -98 0 3155 3156 1832 1827 -96 0 11 1835 1836 1831 2917 2918 -2 8 9 -91 0 -3 11 1835 2919 2920 -2 14 113 9 -90 0 -8 11 20 113 9 -85 0 2067 -3 2068 -9 11 20 15 -85 0 2072 -3 2073 -10 11 12 -89 0 -10 11 12 -63 0 2067 -9 2068 2069 -15 0 -10 11 12 -63 0 2072 -9 2073 2074 -15 0 -10 11 12 -89 0 -10 11 12 -74 0 2067 -3 2068 2069 -10 0 -10 11 12 -74 0 2072 -3 2073 2074 -9 0 2067 -10 11 12 -53 0 2067 -6 2068 2069 -27 0 2072 -8 11 2929 2930 18 -53 0 2072 -6 2073 2074 -16 0 2075 -2 2068 2069 -8 0 -7 11 2935 2931 -70 0 2067 2068 2069 -6 0 2077 -2 2073 2074 -8 0 -5 11 2929 2930 2936 -71 0 2072 2073 2074 -18 0 -4 11 30 2931 -86 0 2909 2910 8 2913 2914 -3 0 -3 11 30 18 -61 0 2909 2910 -22 8 2921 2922 2911 2912 14 2915 2916 2917 2918 8 -2 2132 3256 12 -54 0 2909 2910 -4 8 2921 2922 2911 2912 -22 14 2923 2924 1834 -3 11 1835 2919 2920 14 -2 0 10 12 -52 0 3141 3142 2911 2912 -4 14 2923 2924 1834 -33 11 -2 0 16 18 -51 0 1837 3145 3146 1834 -41 11 -54 0 1837 1839 3148 -12 11 19 -30 11 -53 0 1837 1839 1841 -44 11 -52 0 3150 1839 1841 -45 11 -23 0 2909 2910 -5 8 2913 2914 -19 0 3153 3154 1841 -46 11 -3 0 7 -17 8 2921 2922 2911 2912 -5 14 2915 2916 2917 2918 -15 8 2921 2922 3157 3158 -45 11 19 11 -3 0 13 -17 14 2923 2924 1834 -7 11 1835 2919 2920 -15 14 2923 2924 1834 -48 11 -3 0 10 -60 11 115 116 -34 11 0 2121 2122 3252 -60 11 117 118 -34 11 2121 2130 -38 11 19 -59 11 2130 -105 11 19 -193 11)
    )
    (tilemap
      (solid #f)
      (z-pos 100)
      (name "Foreground")
      (width 100)
      (height 35)
      (tiles -3500 0)
    )
    (tilemap
      (solid #t)
      (z-pos -1)
      (name "Cave")
      (width 100)
      (height 35)
      (tiles -2000 0 2398 2391 2392 -97 0 -2 2394 2395 -597 0 -3 2385 2386 -96 0 -3 2388 2389 -96 0 2391 2398 2396 2392 -96 0 2398 2399 2397 2392 -96 0 2399 2397 -98 0 2391 -299 0)
    )
  )
)
