(supertux-level
  (version 3)
  (name (_ "No More Mr. Ice Guy"))
  (author "Carsten Wirtz")
  (license "CC-BY-SA 4.0 International")
  (target-time 508)
  (allow-item-pocket "inherit")
  (icon "")
  (icon-locked "")
  (statistics
    (enable-coins #f)
    (enable-badguys #f)
    (enable-secrets #f)
  )
  (sector
    (name "main")
    (ambient-light
      (color 1 1 1)
    )
    (background
      (color 1 1 1)
      (alignment "bottom")
      (speed 0)
      (image-top "/images/background/misc/transparent_up.png")
      (image "/images/background/antarctic/snow_panorama.png")
      (z-pos -250)
    )
    (background
      (scroll-offset-y 10)
      (color 1 1 1)
      (alignment "bottom")
      (speed 0.03)
      (speed-y 0)
      (image "/images/background/antarctic/ice_floes_front.png")
      (z-pos -200)
    )
    (background
      (color 1 1 1)
      (scroll-speed-x -0.1)
      (speed 0)
      (image "/images/background/misc/skybox.png")
      (z-pos -290)
    )
    (background
      (color 1 1 1)
      (alignment "bottom")
      (speed 0.01)
      (speed-y 0)
      (image "/images/background/antarctic/ice_floes_back.png")
      (z-pos -220)
    )
    (background
      (color 0.85 0.88 0.9)
      (scroll-speed-x -2)
      (speed 0)
      (image "/images/background/misc/clouds.png")
      (z-pos -280)
    )
    (camera
      (name "Camera")
      (mode "normal")
    )
    (gradient
      (top_color 0.2980392 0.4980392 0.8)
      (bottom_color 1 1 1)
    )
    (music
      (file "/music/antarctic/yetiboss.music")
    )
    (particles-snow
    )
    (spawnpoint
      (name "main")
      (x 624)
      (y 672)
    )
    (tilemap
      (solid #t)
      (z-pos 0)
      (width 40)
      (height 30)
      (tiles -134 0 2909 2910 -9 8 2913 2914 -21 0 2909 2910 -2 8 2921 2922 2911 2912 -4 14 3989 3990 -3 14 2915 2916 2917 2918 -2 8 2913 2914 -13 0 1826 1829 2911 2912 -2 14 2923 2924 1834 11 5368 11 5369 -7 11 1835 2919 2920 -2 14 2915 2916 1832 1827 -10 0 5384 1830 1833 1834 -2 11 5368 -2 11 5368 -6 11 5369 -2 11 5368 11 -2 5369 5368 -3 11 1835 1836 1831 5385 -9 0 5388 1834 -2 11 5369 11 5368 11 5368 -7 11 5369 11 5369 -2 11 5369 -4 11 -2 5368 11 1835 5389 -9 0 5372 2926 5369 -2 5368 5369 -2 5368 5369 -2 5368 11 5369 -4 5368 -5 5369 5368 -2 5369 5368 5369 -2 5368 2929 5373 -10 0 2928 -2 3991 2925 2926 -2 5369 -3 5368 2929 2930 -4 17 3991 2925 2926 11 5368 11 5369 2929 2930 -3 17 2931 -15 0 2928 -5 17 2931 -7 0 2928 -4 17 2931 -130 0 -7 8 9 -24 0 7 -7 8 -2 14 3990 -3 14 3990 15 -24 0 13 -7 14 5369 -2 11 -2 5369 11 2929 5373 -24 0 5372 2926 11 5368 11 5369 -2 11 5369 5368 -3 11 2935 2931 -26 0 2928 2933 11 5368 11 5369 11 5368 -3 11 2935 2936 -28 0 2934 2933 -4 11 -2 5369 11 2940 2936 -30 0 2934 2937 11 5368 -4 11 2941 -32 0 2938 -4 11 5368 2940 2942 -32 0 2939 2937 11 5369 -2 11 2941 -5 0 7 -22 8 9 -5 0 2938 5369 5368 5369 2940 2942 -5 0 13 -6 14 3988 3990 14 3989 -5 14 3988 -6 14 15 -5 0 2939 2937 5368 11 2941 -6 0 10 11 5369 5368 -4 11 -2 5368 -3 11 5368 5369 5368 11 -3 5368 11 5369 11 12 -6 0 2938 11 2940 2942 -6 0 10 -5 11 5369 11 5369 -2 11 -2 5368 -4 11 5369 11 5368 -2 5369 5368 12 -6 0 2939 2937 2941 -7 0 10 -2 5368 -2 11 -2 5368 -2 11 5368 11 5369 -8 11 5368 -2 11 12 -7 0 2938 2942 -7 0 10 5369 -11 11 5368 -2 5369 5368 -2 11 1539 -3 11 12 -7 0 2939 -8 0 10 11 -2 5369 11 5368 -5 11 5369 -2 11 5368 -3 11 5368 11 5368 5369 11 12 -16 0 10 5368 11 -2 5369 -2 11 -2 5368 11 -2 5368 -4 11 5369 -4 11 5369 11 12 -8 0)
    )
    (tilemap
      (solid #f)
      (z-pos -100)
      (width 40)
      (height 30)
      (tiles -101 0 106 107 108 -33 0 2622 -3 0 109 110 111 -27 0 2621 -18 0 2621 -249 0 123 -38 0 122 125 -2 0 122 123 -30 0 122 123 -2 0 124 125 -2 0 124 125 -30 0 124 125 -2 0 124 1344 -2 0 1345 1344 0 24 -27 0 24 1345 1344 -2 0 1345 -258 0 106 107 108 -29 0 2621 -2 0 2625 2626 -3 0 109 110 111 -2 0 5203 5204 -4 0 2622 -290 0)
    )
    (tilemap
      (solid #f)
      (z-pos -110)
      (width 40)
      (height 30)
      (tiles -285 0 2052 -2 2053 2054 -5 0 2052 -2 2053 2054 -5 0 2052 -2 2053 2054 -5 0 2052 -2 2053 2054 -9 0 2057 2058 2070 2055 -5 2053 2056 2066 2058 2059 -5 0 2057 2070 2058 2055 -5 2053 2056 2061 2060 2059 -9 0 2062 2051 -2 2061 2066 -3 2058 2065 2060 2066 2050 2064 -5 0 2062 2051 2058 2060 2058 2070 -3 2058 2065 2058 2050 2064 -10 0 2062 2051 2060 2066 2060 2058 2065 -2 2058 2050 2064 -7 0 2062 2051 -3 2058 2065 -3 2058 2050 2064 -12 0 2057 2060 2058 2066 2070 2058 2050 2063 2064 -9 0 2062 2051 2060 2061 2060 2058 2061 2070 2059 -12 0 2052 2056 2060 -2 2058 2050 2063 2064 -12 0 2062 2063 2051 2060 -2 2058 2066 2055 2054 -10 0 2052 2056 2058 2061 2050 2063 2064 -16 0 2062 2063 2051 -2 2058 2066 2055 2054 -8 0 2052 2056 2065 2058 2050 2064 -20 0 2062 2051 2060 2061 2065 2055 2054 -7 0 2057 2058 2050 2063 2064 -22 0 2062 2063 2051 -2 2058 2059 -7 0 2062 2063 2064 -26 0 2062 -2 2063 2064 -523 0)
    )
    (tilemap
      (solid #t)
      (z-pos -1)
      (width 40)
      (height 30)
      (tiles -1200 0)
    )
    (tilemap
      (solid #f)
      (z-pos 100)
      (width 40)
      (height 30)
      (tiles -1132 0 5538 -2 5539 5540 -8 0 5538 5539 5540 -23 0 5538 5539 5548 -2 5549 5547 -2 5539 5540 -4 0 5538 5548 5549 5547 5539 5540 -11 0)
    )
    (tilemap
      (solid #f)
      (z-pos -120)
      (width 40)
      (height 30)
      (tiles -643 0 2185 -2 2199 2186 -26 0 2185 -2 2199 2186 -5 0 2185 2200 2180 2182 2194 -26 0 2193 2184 2187 2198 2186 -3 0 2185 2200 2189 2197 2190 -28 0 2192 2181 2195 2198 2186 0 2185 2200 2196 2179 2187 2198 2186 -27 0 2192 2180 -2 2179 2190 0 2192 2197 2180 2187 -2 2181 2190 -26 0 2185 2200 2188 2195 2179 2198 2186 2200 2179 2187 2180 2179 2181 2198 2186 -24 0 2185 2200 2179 2197 2187 2188 2180 2190 2179 2188 2179 -2 2197 2181 2197 2198 2186 -22 0 2185 2200 2179 2182 2184 2196 2179 2181 2198 2179 2187 -2 2189 2182 2184 2180 2188 2198 2186 -20 0 2185 2200 2189 2181 2198 2202 2184 2179 2195 2187 2179 -2 2197 2182 2201 2200 2189 2197 2195 2190 -20 0 2192 2181 2189 2195 2196 2190 2192 2180 2188 2187 -2 2180 2188 2198 2200 2187 2197 -2 2187 2190 -20 0 2192 2179 2195 2181 2197 2198 2202 2184 2188 2187 2181 2189 2197 2187 2189 2196 2181 2180 2189 2190 -20 0 2192 2179 -2 2180 -2 2181 2198 2200 2195 2187 2188 2196 2188 2181 2189 2179 2196 2179 2189 2190 -20 0 2192 2181 2197 2188 2197 2188 2179 2187 2181 2179 2188 2179 2197 2179 2189 2180 2181 2195 2189 2190 -20 0 2192 -5 2196 2197 2179 2180 -2 2189 2188 2189 2197 -2 2189 2197 2187 2195 2190 -20 0 2192 2189 2179 2189 2179 2189 2179 2187 2181 2180)
    )
    (yeti
      (name "boss")
      (z-pos 50)
      (dead-script "Tux.trigger_sequence(\"fireworks\");")
      (direction "auto")
      (sprite "/images/creatures/yeti/yeti.sprite")
      (x 96)
      (y 384)
    )
    (yeti_stalactite
      (z-pos -1)
      (x 256)
      (y 288)
    )
    (yeti_stalactite
      (z-pos -1)
      (x 288)
      (y 296)
    )
    (yeti_stalactite
      (z-pos -1)
      (x 320)
      (y 312)
    )
    (yeti_stalactite
      (z-pos -1)
      (x 352)
      (y 320)
    )
    (yeti_stalactite
      (z-pos -1)
      (x 384)
      (y 320)
    )
    (yeti_stalactite
      (z-pos -1)
      (x 416)
      (y 320)
    )
    (yeti_stalactite
      (z-pos -1)
      (x 448)
      (y 320)
    )
    (yeti_stalactite
      (z-pos -1)
      (x 480)
      (y 320)
    )
    (yeti_stalactite
      (z-pos -1)
      (x 512)
      (y 312)
    )
    (yeti_stalactite
      (z-pos -1)
      (x 544)
      (y 296)
    )
    (yeti_stalactite
      (z-pos -1)
      (x 576)
      (y 288)
    )
    (yeti_stalactite
      (z-pos -1)
      (x 608)
      (y 288)
    )
    (yeti_stalactite
      (z-pos -1)
      (x 640)
      (y 288)
    )
    (yeti_stalactite
      (z-pos -1)
      (x 672)
      (y 288)
    )
    (yeti_stalactite
      (z-pos -1)
      (x 704)
      (y 288)
    )
    (yeti_stalactite
      (z-pos -1)
      (x 736)
      (y 296)
    )
    (yeti_stalactite
      (z-pos -1)
      (x 768)
      (y 312)
    )
    (yeti_stalactite
      (z-pos -1)
      (x 800)
      (y 320)
    )
    (yeti_stalactite
      (z-pos -1)
      (x 832)
      (y 320)
    )
    (yeti_stalactite
      (z-pos -1)
      (x 864)
      (y 320)
    )
    (yeti_stalactite
      (z-pos -1)
      (x 896)
      (y 320)
    )
    (yeti_stalactite
      (z-pos -1)
      (x 928)
      (y 312)
    )
    (yeti_stalactite
      (z-pos -1)
      (x 960)
      (y 296)
    )
    (yeti_stalactite
      (z-pos -1)
      (x 992)
      (y 288)
    )
  )
)
