;; Generated with Flexlay Editor
(supertux-worldmap
  (properties 
    (name  "Bonus Island I")
    (start_pos_x 35)
    (start_pos_y 2))
  (tilemap 
    (width  70)
    (height 50)
    (data
       9  9  9  9  9  9  9  9  9  9  9  9  9  9  9  9  9  9  9  9  9  9  9  9  9  9  9  9  9  9  9  11 16 16 16 16 16 16 16 12 9  9  9  9  9  9  9  9  9  9  9  9  9  9  9  9  9  9  9  9  9  9  9  9  9  9  9  9  9  9  
       9  9  9  9  9  9  9  9  9  9  9  9  9  9  9  9  9  9  9  9  9  9  9  9  9  9  9  9  9  9  9  15 24 25 26 58 24 26 19 17 9  9  9  9  9  9  9  9  9  9  9  9  9  9  9  9  9  9  9  9  9  9  9  9  9  9  9  9  9  9  
       9  9  9  9  9  9  9  9  9  9  9  9  9  9  9  9  9  9  9  9  9  9  9  9  9  9  9  9  9  9  9  15 30 29 28 59 31 27 19 17 9  9  9  9  9  9  9  9  9  9  9  9  9  9  9  9  9  9  9  9  9  9  9  9  9  9  9  9  9  9  
       9  9  9  9  9  9  9  9  9  9  9  9  9  9  9  9  9  9  9  9  9  9  9  9  9  9  9  9  9  11 16 22 19 19 19 47 30 28 19 23 16 12 9  9  9  9  9  9  9  9  9  9  9  9  9  9  9  9  9  9  9  9  9  9  9  9  9  9  9  9  
       9  9  9  9  9  9  9  9  9  9  9  9  9  9  9  9  9  9  9  9  9  9  9  9  9  9  9  9  9  15 19 19 19 19 60 47 60 19 19 19 19 17 9  9  9  9  9  9  9  9  9  9  9  9  9  9  9  9  9  9  9  9  9  9  9  9  9  9  9  9  
       9  9  9  9  9  9  9  9  9  9  9  9  9  9  9  9  9  9  9  9  9  9  9  9  9  9  9  9  9  15 19 48 40 43 40 45 40 43 40 39 19 17 9  9  9  9  9  9  9  9  9  9  9  9  9  9  9  9  9  9  9  9  9  9  9  9  9  9  9  9  
       9  9  9  9  9  9  9  9  9  9  9  9  9  9  9  9  9  9  9  9  9  9  9  9  9  9  9  9  9  15 19 47 19 47 19 47 19 47 19 47 19 17 9  9  9  9  9  9  9  9  9  9  9  9  9  9  9  9  9  9  9  9  9  9  9  9  9  9  9  9  
       9  9  9  9  9  9  9  9  9  9  9  9  9  9  9  9  9  9  9  9  9  9  9  9  9  9  9  9  9  15 19 47 19 47 19 47 19 47 19 47 19 17 9  9  9  9  9  9  9  9  9  9  9  9  9  9  9  9  9  9  9  9  9  9  9  9  9  9  9  9  
       9  9  9  9  9  9  9  9  9  9  9  9  9  9  9  9  9  9  9  9  9  9  9  9  9  9  9  9  9  15 19 68 19 68 19 68 19 68 19 68 19 17 9  9  9  9  9  9  9  9  11 16 12 9  9  9  9  9  9  9  9  9  9  9  9  9  9  9  9  9  
       9  9  9  9  9  9  9  9  9  9  9  9  9  9  9  9  9  9  9  9  9  9  9  9  9  9  9  9  9  14 18 18 18 18 18 18 18 18 18 18 18 13 9  9  9  9  9  9  9  9  15 58 17 9  9  9  9  9  9  9  9  9  9  9  9  9  9  9  9  9  
       9  9  9  9  9  9  9  9  9  9  9  9  9  9  9  11 16 12 9  9  9  9  9  9  11 12 9  9  9  9  9  9  9  9  9  9  9  9  9  9  9  9  9  9  9  9  9  9  9  11 22 59 23 12 9  9  9  9  9  9  9  9  9  9  9  9  9  9  9  9  
       9  9  9  9  9  9  9  9  9  9  9  9  9  9  9  14 18 13 9  9  9  9  9  9  15 23 12 9  9  9  9  9  9  9  9  9  9  9  9  9  9  9  11 16 12 9  9  9  9  15 60 47 60 17 9  9  9  9  11 12 9  9  9  9  9  9  9  9  9  9  
       9  9  9  9  9  9  9  9  9  9  9  9  9  9  9  9  9  9  9  11 16 12 9  9  15 19 17 9  9  9  9  9  9  9  9  9  9  9  9  9  9  9  15 19 17 9  9  9  9  14 21 47 20 13 9  9  11 16 22 23 12 9  9  9  9  9  9  9  9  9  
       9  9  9  9  9  9  9  9  9  9  9  9  9  9  9  9  9  9  9  15 58 17 9  9  14 18 13 9  9  9  9  9  9  9  9  9  9  9  9  9  9  9  15 19 23 12 9  9  11 16 22 47 23 16 12 9  14 21 20 18 13 9  9  9  9  9  9  9  9  9  
       9  9  9  9  9  9  9  9  9  9  9  9  9  9  9  9  11 16 16 22 59 23 16 16 16 16 12 9  9  9  9  9  9  9  9  9  9  9  9  9  9  9  14 18 18 13 9  9  15 19 19 47 19 19 17 9  9  14 13 9  9  9  9  9  9  9  9  9  9  9  
       9  9  9  9  9  9  9  9  9  9  9  9  9  9  9  9  15 19 19 19 47 19 19 48 40 39 17 9  9  9  11 12 9  9  9  9  9  9  9  9  9  9  9  9  9  9  9  9  14 21 19 37 40 39 23 16 12 9  9  9  9  9  9  9  9  9  9  9  9  9  
       9  9  9  9  9  9  9  9  9  9  9  9  9  9  9  9  14 18 21 19 47 19 19 47 19 47 17 9  9  9  14 13 9  11 16 12 9  9  9  9  9  9  9  9  9  9  9  9  9  15 19 19 19 47 19 20 13 9  9  9  9  9  9  9  9  9  9  9  9  9  
       9  9  9  9  9  9  9  9  9  9  9  9  9  9  9  9  9  9  14 21 37 40 40 42 19 47 17 9  9  9  9  9  9  15 58 17 9  9  9  9  9  9  9  9  9  11 16 16 16 22 19 19 19 47 19 23 12 9  9  9  9  9  9  9  9  9  9  9  9  9  
       9  9  9  9  9  9  9  9  9  9  9  9  9  9  9  9  9  11 16 22 19 60 19 19 19 47 17 9  9  9  9  11 16 22 59 23 16 12 9  9  9  9  9  9  9  15 48 40 40 40 40 39 19 37 40 39 23 12 9  9  9  9  9  9  9  9  9  9  9  9  
       9  9  9  9  9  9  9  9  9  9  9  9  9  9  9  9  11 22 19 19 19 19 19 19 19 47 17 9  9  9  9  15 19 19 47 19 19 23 12 9  9  9  9  9  9  15 47 19 19 19 19 47 19 19 19 47 19 17 9  9  9  9  9  9  9  9  9  9  9  9  
       9  9  9  9  9  9  9  9  9  9  9  9  11 16 12 9  15 48 40 40 40 40 40 40 40 42 17 9  9  9  9  14 21 19 37 40 40 39 17 9  9  9  9  9  9  15 47 19 19 19 19 37 40 40 40 42 19 17 9  9  9  9  9  9  9  9  9  9  9  9  
       9  9  9  9  9  9  9  9  9  9  9  9  15 19 17 9  15 47 19 19 19 19 20 21 19 20 13 9  9  9  9  9  14 21 19 19 19 47 17 9  9  9  9  9  9  15 37 40 39 19 19 19 19 19 19 19 19 17 9  9  9  9  9  9  9  9  9  9  9  9  
       9  9  9  9  9  9  9  9  9  9  9  9  14 18 13 9  15 37 40 39 19 20 13 14 18 13 9  9  9  9  9  9  9  15 19 19 19 47 17 9  9  9  9  9  9  15 19 19 37 40 40 40 40 40 39 19 20 13 9  9  9  9  9  9  9  9  9  9  9  9  
       9  9  9  9  9  9  9  9  9  9  9  9  9  9  9  9  14 18 21 47 20 13 9  9  9  9  9  9  9  9  9  9  9  15 19 48 40 42 23 12 9  9  9  9  9  14 21 19 19 19 20 18 18 21 47 20 13 9  9  9  9  9  9  9  9  9  9  9  9  9  
       9  9  9  9  9  9  9  9  9  9  9  9  9  9  9  9  9  9  15 68 17 9  9  9  9  9  9  9  9  9  9  9  9  14 21 47 19 19 19 17 9  9  9  9  9  9  14 18 18 18 13 9  9  15 47 17 9  9  9  9  9  9  9  9  9  9  9  9  9  9  
       9  9  9  9  9  9  9  9  9  9  9  9  9  9  9  9  9  9  14 18 13 9  9  9  9  9  9  9  9  9  9  9  9  9  15 47 20 18 18 13 9  9  9  9  9  9  9  9  9  9  9  9  9  15 68 17 9  9  9  9  9  9  9  9  9  9  9  9  9  9  
       9  9  9  9  9  9  9  9  9  11 16 12 9  9  9  9  9  9  9  9  9  9  9  9  11 16 16 12 9  9  9  9  9  9  15 68 17 9  9  9  9  9  9  9  9  9  9  9  9  9  9  9  9  14 18 13 9  9  9  9  9  9  9  9  9  9  9  9  9  9  
       9  9  9  9  9  9  9  9  9  14 21 17 9  9  9  9  9  9  9  9  9  9  9  9  14 21 20 13 9  9  9  9  9  9  14 18 13 9  9  9  9  9  9  9  9  9  9  9  9  9  9  9  9  9  9  9  9  9  11 16 16 12 9  9  9  9  9  9  9  9  
       9  9  9  9  9  9  9  9  9  9  14 13 9  9  9  9  9  9  9  9  9  9  9  9  9  14 13 9  9  9  9  9  9  9  9  9  9  9  9  9  11 16 16 12 9  9  9  9  9  9  9  9  9  9  9  9  9  9  15 19 19 17 9  9  9  9  9  9  9  9  
       9  9  9  9  9  9  9  9  9  9  9  9  9  9  11 16 12 9  9  9  9  9  9  9  9  9  9  9  9  9  11 16 12 9  9  9  9  9  9  9  15 19 19 23 12 9  9  9  9  9  9  9  9  9  9  9  9  9  15 19 20 13 9  9  9  9  9  9  9  9  
       9  9  9  9  9  9  9  9  9  9  11 16 12 9  15 58 17 9  9  9  9  9  9  9  9  9  9  9  9  9  15 19 17 9  9  9  9  9  9  9  15 19 19 19 17 9  9  9  9  9  9  9  9  9  9  9  9  9  14 18 13 9  9  9  9  9  9  9  9  9  
       9  9  9  9  9  9  9  9  9  11 22 19 23 12 15 59 23 16 16 12 9  9  9  9  9  9  9  9  9  9  14 18 13 9  9  9  9  9  9  9  14 21 19 20 13 9  9  9  9  9  9  9  9  9  9  11 16 12 9  9  9  9  9  9  9  9  9  9  9  9  
       9  9  9  9  9  9  9  9  9  15 19 19 19 23 22 47 48 40 39 17 9  9  9  9  9  9  9  9  9  9  9  9  9  9  9  9  9  9  9  9  9  15 19 17 9  9  9  9  9  9  9  9  9  9  9  15 58 17 9  9  9  9  9  9  9  9  9  9  9  9  
       9  9  9  9  9  9  9  9  9  15 19 48 40 40 40 42 47 19 47 17 9  9  9  11 16 12 9  9  9  9  9  9  9  9  9  9  9  9  9  9  9  14 18 13 9  9  9  9  9  9  9  9  9  9  11 22 59 23 16 16 16 16 16 12 9  9  9  9  9  9  
       9  9  9  9  9  9  9  9  9  14 21 47 19 19 60 19 47 19 47 23 12 9  9  14 18 13 9  9  9  9  9  9  9  9  9  9  9  9  9  9  9  9  9  9  9  9  9  9  9  9  9  9  11 16 22 19 37 40 40 40 39 19 19 17 9  9  9  9  9  9  
       9  9  9  9  9  9  9  9  9  9  15 37 40 40 40 40 42 19 47 19 17 9  9  9  9  9  9  9  9  9  9  11 16 12 9  9  9  9  9  9  9  9  9  9  9  9  9  9  9  9  9  9  15 24 25 25 26 19 19 19 47 19 19 17 9  9  9  9  9  9  
       9  9  9  9  9  9  9  9  9  9  15 19 19 19 19 24 25 26 47 19 17 9  9  9  9  9  9  9  9  9  9  15 58 17 9  9  9  9  9  9  9  9  9  9  9  9  9  9  9  9  9  9  15 31 32 32 27 48 40 40 42 19 20 13 9  9  9  9  9  9  
       9  9  9  9  9  9  9  9  9  9  15 19 19 19 19 30 29 28 47 20 13 9  9  9  9  9  9  9  9  9  9  15 59 17 9  9  9  9  9  9  9  9  9  9  9  9  9  9  9  9  9  9  15 30 29 29 28 47 19 19 20 18 13 9  9  9  9  9  9  9  
       9  9  9  9  9  9  9  9  9  9  14 21 48 40 40 40 40 40 42 17 9  9  9  9  9  9  11 16 16 16 16 22 47 17 9  9  9  9  9  9  9  9  9  11 16 16 12 9  9  9  9  9  14 18 21 19 19 47 19 19 23 12 9  9  9  9  9  9  9  9  
       9  9  9  9  9  9  9  9  9  11 16 22 47 19 19 19 19 19 19 17 9  9  9  9  9  9  15 69 40 40 40 40 61 64 63 63 63 63 63 63 63 63 63 62 67 19 23 12 9  9  9  9  9  9  14 21 19 47 19 19 19 23 12 9  9  9  9  9  9  9  
       9  9  9  9  9  9  9  9  9  15 19 19 37 40 40 40 40 40 39 17 9  9  9  9  9  9  14 18 18 18 18 21 47 17 9  9  9  9  9  9  9  9  9  15 19 19 19 17 9  9  9  9  9  9  9  15 19 37 40 40 39 19 17 9  9  9  9  9  9  9  
       9  9  9  9  9  9  9  9  9  14 21 19 19 19 19 19 19 19 47 23 12 9  9  9  9  9  9  9  9  9  9  15 47 17 9  9  9  9  9  9  9  9  9  14 18 18 18 13 9  9  9  9  9  9  9  15 19 19 19 19 47 19 17 9  9  9  9  9  9  9  
       9  9  9  9  9  9  9  9  9  9  14 18 18 18 18 18 18 21 47 20 13 9  9  9  9  9  9  9  11 16 16 22 47 23 16 16 12 9  9  9  9  9  9  9  9  9  9  9  9  9  9  9  9  9  9  14 18 18 18 21 47 20 13 9  9  9  9  9  9  9  
       9  9  9  9  9  9  9  9  9  9  9  9  9  9  9  9  9  15 68 17 9  9  9  9  9  9  9  9  15 19 19 19 37 40 39 19 17 9  9  9  9  9  9  9  9  9  9  9  9  9  9  9  9  9  9  9  9  9  9  15 68 17 9  9  9  9  9  9  9  9  
       9  9  9  9  9  9  9  9  9  9  9  9  9  9  9  9  9  14 18 13 9  9  9  9  9  11 16 12 15 19 19 49 50 51 47 19 17 9  9  9  9  9  9  9  9  9  9  9  9  9  9  9  9  9  9  9  9  9  9  14 18 13 9  9  9  9  9  9  9  9  
       9  9  9  9  9  9  9  9  9  9  9  9  9  9  9  9  9  9  9  9  9  9  9  9  11 22 20 13 15 60 19 52 53 54 47 60 17 9  9  9  9  9  9  9  9  9  9  9  9  9  9  9  9  9  9  9  9  9  9  9  9  9  9  9  9  9  9  9  9  9  
       9  9  9  9  9  9  9  9  9  9  9  9  9  9  9  9  9  9  9  9  9  9  9  9  14 21 17 9  15 19 19 55 56 57 42 19 17 9  9  9  9  9  9  9  9  9  9  9  9  9  9  9  9  9  9  9  9  9  9  9  9  9  9  9  9  9  9  9  9  9  
       9  9  9  9  9  9  9  9  9  9  9  9  9  9  9  9  9  9  9  9  9  9  9  9  9  14 13 9  15 19 19 19 19 19 19 19 17 9  9  9  9  9  9  9  9  9  9  9  9  9  9  9  9  9  9  9  9  9  9  9  9  9  9  9  9  9  9  9  9  9  
       9  9  9  9  9  9  9  9  9  9  9  9  9  9  9  9  9  9  9  9  9  9  9  9  9  9  9  9  14 18 18 18 18 18 18 18 13 9  9  9  9  9  9  9  9  9  9  9  9  9  9  9  9  9  9  9  9  9  9  9  9  9  9  9  9  9  9  9  9  9  
       9  9  9  9  9  9  9  9  9  9  9  9  9  9  9  9  9  9  9  9  9  9  9  9  9  9  9  9  9  9  9  9  9  9  9  9  9  9  9  9  9  9  9  9  9  9  9  9  9  9  9  9  9  9  9  9  9  9  9  9  9  9  9  9  9  9  9  9  9  9  
           ))

(levels
	 (level (name "bonus1/bonus-level1.stl")
           (x 35)
	        (y 4))
	 (level (name "bonus1/bonus-level2.stl")
           (x 32)
	        (y 41))	
	 (level (name "bonus1/bonus-level3.stl")
           (x 30)
	        (y 39))
	 (level (name "bonus1/bonus-level4.stl")
			  (extro-filename "extro-bonus.txt")
           (x 32)
	        (y 46))
	 (level (name "bonus1/bonus-level5.stl")
           (x 44)
	        (y 39))
	 (level (name "bonus1/abednego-level1.stl")
           (x 12)
           (y 33))
    (level (name "bonus1/abednego-level2.stl")
           (x 15)
           (y 35))
    (level (name "bonus1/abednego-level3.stl")
           (x 18)
           (y 36))
    (level (name "bonus1/abednego-level4.stl")
           (x 16)
           (y 40))
    (level (name "bonus1/matr1x-level1.stl")        
	        (x 21)
           (y 17))
    (level (name "bonus1/matr1x-level2.stl")
           (x 25)
           (y 18))
    (level (name "bonus1/matr1x-level3.stl")
           (x 20)
           (y 20))
    (level (name "bonus1/thompson-level1.stl")  
	        (x 35)
           (y 20))
    (level (name "bonus1/thompson-level2.stl")
           (x 37)
           (y 22))
    (level (name "bonus1/torfi-level1.stl")
	        (x 58)
           (y 34))
    (level (name "bonus1/torfi-level2.stl")
           (x 57)
           (y 38))
    (level (name "bonus1/torfi-level3.stl")
           (x 59)
           (y 40))
    (level (name "bonus1/wansti-level1.stl")
	        (x 51)
           (y 14))
    (level (name "bonus1/wansti-level2.stl")
           (x 53)
	        (y 16))
    (level (name "bonus1/wansti-level3.stl")
           (x 52)
           (y 20))
	 (level (name "bonus1/wansti-level4.stl")
           (x 47)
           (y 18))
    (level (name "bonus1/wansti-level5.stl")
           (x 50)
           (y 22))
			  
			(level (map-message "You found a secret place!")
           (x 33)
           (y 39) (apply-action-right #f))
			  
			(level (map-message "Hint: Use igloos to get back here.")
           (x 35)
           (y 5) 
			  (apply-action-left #f) (apply-action-right #f) (apply-action-down #f))

			(level 
	        (x 33)
			  (y 8)
			  (teleport-message "Warp to Matr1x' Sector")
			  (dest_x 20)
			  (dest_y 14))
			(level 
	        (x 31)
			  (y 8)
			  (teleport-message "Warp to Thompson's Domain")
			  (dest_x 34)
			  (dest_y 18))
			(level 
	        (x 35)
			  (y 8)
			  (teleport-message "Warp to the SuperTux Team Island")
			  (dest_x 51)
			  (dest_y 10))
			(level 
	        (x 37)
			  (y 8)
			  (teleport-message "Warp to Abednego's Area")
			  (dest_x 15)
			  (dest_y 31))
		   (level 
	        (x 39)
			  (y 8)
			  (teleport-message "Warp to Torfi's Territory")
			  (dest_x 56)
			  (dest_y 33))
    	   (level 
	        (x 19)
			  (y 24)
			  (teleport-message "Leave Matrix' Sector")
			  (dest_x 32)
			  (dest_y 37))
     	   (level 
	        (x 35)
			  (y 26)
			  (teleport-message "Leave Thompson's Domain")
			  (dest_x 35)
			  (dest_y 2))
    	   (level 
	        (x 54)
			  (y 25)
			  (teleport-message "Leave SuperTux Team Island")
			  (dest_x 35)
			  (dest_y 2))
    	   (level 
	        (x 18)
			  (y 43)
			  (teleport-message "Leave Abednego's Area")
			  (dest_x 35)
			  (dest_y 2))
    	   (level 
	        (x 60)
			  (y 43)
			  (teleport-message "Leave Torfi's Territory")
			  (dest_x 35)
			  (dest_y 2))
    	   
			;;Back from Castle
			(level 
	        (x 27)
			  (y 39)
			  (teleport-message "Warp home")
			  (dest_x 35)
			  (dest_y 2))
			  
			;;Back from Abednego
			(level 
	        (x 15)
			  (y 31)
			  (invisible-teleporter #t)
			  (dest_x 35)
			  (dest_y 2))
			
			;; Back from Thompson
			(level 
	        (x 34)
			  (y 18)
			  (invisible-teleporter #t)
			  (dest_x 35)
			  (dest_y 2))
			
			;; Back from Matr1x
			(level 
	        (x 20)
			  (y 14)
			  (invisible-teleporter #t)
			  (dest_x 35)
			  (dest_y 2))
			  
			;; Back from Wansti
			(level 
	        (x 51)
			  (y 10)
			  (invisible-teleporter #t)
			  (dest_x 35)
			  (dest_y 2))
			  
			;; Back from Torfi
			(level 
	        (x 56)
			  (y 33)
			  (invisible-teleporter #t)
			  (dest_x 35)
			  (dest_y 2))

		)
)

