;; Generated with Flexlay Editor
(supertux-worldmap
  (properties 
    (name  "Bonus Island II")
    (start_pos_x 22)
    (start_pos_y 17))  
  (tilemap 
    (width  70)
    (height 40)
    (data
       9  9  9  9  9  9  9  9  9  9  9  9  9  9  9  9  9  9  9  9  9  9  9  9  9  9  9  9  9  9  9  9  9  9  9  9  9  9  9  9  9  9  9  9  9  9  9  9  9  9  9  9  9  9  9  9  9  9  9  9  9  9  9  9  9  9  9  9  9  9  
       9  9  9  9  9  9  9  9  9  9  9  9  9  9  9  9  9  9  9  9  9  9  9  9  9  9  9  9  9  9  9  9  9  9  9  9  9  9  9  9  9  9  9  9  9  9  9  9  9  9  9  9  9  9  9  9  9  9  9  9  9  9  9  9  9  9  9  9  9  9  
       9  9  9  9  9  9  9  9  9  9  9  9  9  9  9  9  9  9  9  9  9  9  9  9  9  9  9  9  9  9  9  9  9  9  9  9  9  9  9  9  9  9  9  9  9  9  9  9  9  9  9  9  9  9  9  9  9  9  9  9  9  9  9  9  9  9  9  9  9  9  
       9  9  9  9  9  9  9  9  9  9  9  9  9  9  9  9  11 16 16 16 16 16 16 16 16 16 12 9  9  9  9  9  9  9  9  9  9  9  9  9  9  9  9  9  9  9  9  9  9  9  9  9  9  9  9  9  9  9  9  9  9  9  9  9  9  9  9  9  9  9  
       9  9  9  9  9  9  9  9  9  9  9  9  9  9  9  9  15 19 24 25 26 19 24 26 19 19 17 9  9  9  9  9  9  9  9  9  9  9  9  9  9  9  9  9  9  9  9  9  9  9  9  9  9  9  9  9  9  9  9  9  9  9  9  9  9  9  9  9  9  9  
       9  9  9  9  9  9  9  9  9  9  9  9  9  9  9  9  15 19 30 29 28 19 30 28 19 19 17 9  9  9  9  9  9  9  9  9  9  9  9  9  9  9  9  9  9  9  9  9  9  9  9  9  9  9  9  9  9  9  9  9  9  9  9  9  9  9  9  9  9  9  
       9  9  9  9  9  9  9  9  9  9  9  9  9  9  9  9  15 19 19 19 49 50 51 19 24 26 17 9  9  9  9  9  9  9  9  9  9  9  9  9  9  9  9  9  9  9  9  9  9  9  9  9  9  9  9  9  9  9  9  9  9  9  9  9  9  9  9  9  9  9  
       9  9  9  9  9  9  9  9  9  9  9  9  9  9  9  9  15 19 24 26 52 53 54 19 30 28 17 9  9  9  9  9  9  9  9  9  9  9  9  9  9  9  9  9  9  9  9  9  9  9  9  9  9  9  9  9  9  9  9  9  9  9  9  9  9  9  9  9  9  9  
       9  9  9  9  9  9  9  9  9  9  9  9  9  9  9  9  15 19 30 28 55 56 57 43 40 71 17 9  9  9  9  9  9  9  9  9  9  9  9  9  9  9  9  9  9  9  9  9  9  9  9  9  9  9  9  9  9  9  9  9  9  9  9  9  9  9  9  9  9  9  
       9  9  9  9  9  9  9  9  9  9  9  9  9  9  9  9  15 19 19 19 24 25 26 47 24 26 17 9  9  9  9  9  9  9  9  9  9  9  9  9  9  9  9  9  9  9  9  9  9  9  9  9  9  9  9  9  9  9  9  9  9  9  9  9  9  9  9  9  9  9  
       9  9  9  9  9  9  9  9  9  9  9  9  9  9  9  9  15 24 26 19 30 29 28 47 30 28 23 16 16 16 12 9  9  9  9  9  9  9  9  9  9  9  9  9  9  9  9  9  9  9  11 16 12 9  9  9  9  9  9  9  9  9  9  9  9  9  9  9  9  9  
       9  9  9  9  9  9  9  9  9  9  9  9  11 16 16 16 22 30 28 19 19 19 60 47 60 24 26 19 19 19 17 9  9  9  9  9  9  9  9  9  9  9  11 16 12 9  9  9  9  9  15 19 17 9  9  9  9  9  9  9  9  9  9  9  9  9  9  9  9  9  
       9  9  9  9  9  9  9  9  9  9  9  9  15 48 40 40 40 40 40 40 40 40 40 42 19 30 28 19 19 19 17 9  9  9  9  9  9  9  9  9  9  9  15 19 17 9  9  9  9  9  15 19 23 12 9  9  9  9  9  9  9  9  9  9  9  9  9  9  9  9  
       9  9  9  9  9  9  9  9  9  9  9  9  15 47 20 18 18 18 18 18 18 18 18 18 18 18 18 18 18 18 13 9  9  11 16 16 16 16 16 12 9  9  15 19 23 12 9  9  11 16 22 24 26 23 12 9  9  9  9  9  9  9  9  9  9  9  9  9  9  9  
       9  9  9  9  9  9  9  9  9  9  9  9  15 47 17 9  11 16 16 16 16 16 16 16 16 16 16 16 16 16 16 16 16 22 48 40 40 40 39 17 9  9  14 18 18 13 9  9  15 19 19 30 28 19 23 16 16 16 16 16 16 12 9  9  9  9  9  9  9  9  
       9  9  9  9  9  9  9  9  9  9  9  9  15 47 17 9  15 19 48 40 40 40 40 40 40 40 39 19 20 18 18 18 21 19 47 20 18 21 47 17 9  9  9  9  9  9  9  9  14 21 24 25 25 25 25 26 24 25 25 25 26 17 9  9  9  9  9  9  9  9  
       9  9  9  9  9  9  9  9  9  9  9  9  15 47 17 9  14 21 47 19 19 19 58 19 19 19 47 19 17 9  9  9  15 19 47 17 9  15 47 17 9  9  9  9  9  9  9  9  9  15 31 32 32 32 32 27 31 32 32 32 27 17 9  9  9  9  9  9  9  9  
       9  9  9  9  9  9  9  9  9  9  9  9  15 47 17 9  9  15 47 19 19 19 59 19 19 19 47 19 23 12 9  9  15 19 47 17 9  15 47 17 9  9  9  9  9  9  9  9  9  15 31 32 32 32 32 27 31 32 32 32 27 23 12 9  9  9  9  9  9  9  
       9  9  9  9  9  9  9  9  9  11 16 16 22 47 23 16 16 22 47 19 19 60 47 60 19 19 47 19 19 17 9  9  15 19 47 17 9  15 47 17 9  9  9  9  9  9  9  9  9  15 30 29 29 29 29 28 30 29 29 29 28 19 23 16 16 12 9  9  9  9  
       9  9  9  9  9  9  9  9  9  15 48 40 40 45 40 40 40 40 45 40 40 40 45 40 40 40 42 19 19 23 16 16 22 19 47 23 16 22 47 17 9  9  9  9  9  9  9  9  9  15 19 19 60 19 19 60 19 19 60 19 19 24 25 25 26 17 9  9  9  9  
       9  9  9  9  9  9  9  9  9  15 47 20 21 47 20 18 21 19 47 24 26 19 47 19 19 19 19 19 48 40 40 40 40 40 45 40 40 40 61 64 63 63 63 63 63 63 63 63 63 62 72 40 40 40 40 40 40 40 40 40 71 31 32 32 27 23 12 9  9  9  
       9  9  9  9  9  9  9  9  9  15 47 17 15 68 17 9  15 19 47 30 28 19 47 20 18 18 21 19 47 19 20 18 18 21 47 19 19 19 47 17 9  9  9  9  9  9  9  9  9  15 24 25 25 25 25 26 24 25 26 24 26 30 29 29 28 19 23 16 16 16 
       9  9  9  9  9  9  9  9  9  15 47 17 14 18 13 9  15 19 37 39 19 19 47 17 9  9  15 19 47 19 17 9  9  15 47 19 48 40 42 17 9  9  11 16 16 12 9  9  9  15 31 32 32 32 32 27 31 32 27 30 28 69 40 40 40 40 40 40 40 40 
       9  9  9  9  9  9  9  9  9  15 47 23 16 16 16 12 14 18 21 47 20 21 47 23 16 16 22 19 47 19 23 16 16 22 47 19 47 19 19 17 9  9  15 19 19 17 9  9  9  15 31 32 32 32 32 27 31 32 27 24 25 25 26 20 18 18 18 18 18 18 
       9  9  9  9  9  9  9  9  9  15 37 40 40 40 39 17 9  9  15 68 17 15 37 40 40 40 40 40 45 40 40 40 40 40 42 19 47 24 26 17 9  9  15 19 20 13 9  9  11 22 31 32 32 32 32 27 31 32 27 31 32 32 27 17 9  9  9  9  9  9  
       9  9  9  9  9  9  9  9  9  14 18 18 18 21 47 17 9  9  14 18 13 14 18 18 18 18 18 21 47 20 18 18 18 18 21 19 47 30 28 23 12 9  14 18 13 9  9  9  15 19 30 29 29 29 29 28 30 29 28 30 29 29 28 17 9  9  9  9  9  9  
       9  9  9  9  9  9  9  9  9  11 16 12 9  15 47 23 16 16 16 16 16 16 16 16 16 16 16 22 47 23 16 16 16 16 22 19 47 19 19 19 17 9  9  9  9  9  9  9  14 21 24 26 24 26 20 21 19 20 18 18 18 18 18 13 9  9  9  9  9  9  
       9  9  9  9  9  9  9  9  9  14 21 17 9  15 37 40 40 40 40 40 40 40 40 40 43 40 40 40 45 40 40 40 40 40 43 40 44 40 39 19 17 9  9  9  9  9  9  9  9  15 30 28 30 28 17 14 18 13 11 16 16 12 9  9  9  9  9  9  9  9  
       9  9  9  9  9  9  9  9  9  9  14 13 9  14 18 18 18 18 18 18 21 24 26 19 47 19 24 26 47 20 18 18 18 21 47 24 25 26 47 20 13 9  9  9  9  9  9  9  9  14 18 18 18 18 13 9  9  9  15 19 19 17 9  9  9  9  9  9  9  9  
       9  9  9  9  9  9  9  9  9  9  9  9  9  9  9  9  11 16 12 9  15 30 28 19 47 19 30 28 47 17 11 16 12 15 47 31 32 27 68 17 9  9  9  9  9  9  9  9  9  9  9  9  9  9  9  9  9  9  15 19 20 13 9  9  9  9  9  9  9  9  
       9  9  9  9  9  9  9  9  9  9  9  9  9  9  9  9  14 18 13 9  14 21 24 26 68 24 26 19 47 17 15 19 17 15 47 31 32 27 60 17 9  9  9  9  9  9  9  9  9  9  9  9  9  9  9  9  9  9  14 18 13 9  9  9  9  9  9  9  9  9  
       9  9  9  9  9  9  9  9  9  9  9  9  9  9  9  9  9  9  9  9  9  15 30 28 19 30 28 19 47 17 14 18 13 15 47 31 32 27 70 17 9  9  9  9  9  9  9  9  9  9  9  9  9  9  9  9  9  9  9  9  9  9  9  9  9  9  9  9  9  9  
       9  9  9  9  9  9  9  9  9  9  9  9  9  9  9  9  9  9  9  9  9  14 18 21 19 19 19 19 47 17 9  9  9  15 47 30 29 28 47 17 9  9  9  9  9  9  9  9  9  11 16 16 12 9  9  9  9  9  9  9  9  9  9  9  9  9  9  9  9  9  
       9  9  9  9  9  9  9  9  9  9  9  9  9  9  9  9  9  9  9  9  9  9  9  14 18 18 18 21 47 23 16 12 9  15 37 40 40 40 61 64 63 63 63 63 63 63 63 63 63 62 67 19 17 9  9  9  9  9  9  9  9  9  9  9  9  9  9  9  9  9  
       9  9  9  9  9  9  9  9  9  9  9  9  9  9  9  9  9  9  9  9  9  9  9  9  9  9  9  15 37 40 39 17 9  14 18 18 18 21 47 17 9  9  9  9  9  9  9  9  9  15 24 26 17 9  9  9  9  9  9  9  9  9  9  9  9  9  9  9  9  9  
       9  9  9  9  9  9  9  9  9  9  9  9  9  9  9  9  9  9  9  9  9  9  9  9  9  9  9  15 20 21 47 23 16 16 16 16 16 22 47 17 9  9  9  9  9  9  9  9  9  15 30 28 17 9  9  9  9  9  9  9  9  9  9  9  9  9  9  9  9  9  
       9  9  9  9  9  9  9  9  9  9  9  9  9  9  9  9  9  9  9  9  9  9  9  9  9  9  9  15 23 22 37 40 40 40 40 40 40 40 42 17 9  9  9  9  9  9  9  9  9  15 19 20 13 9  9  9  9  9  9  9  9  9  9  9  9  9  9  9  9  9  
       9  9  9  9  9  9  9  9  9  9  9  9  9  9  9  9  9  9  9  9  9  9  9  9  9  9  9  15 19 19 19 20 18 18 21 20 18 21 19 17 9  9  9  9  9  9  9  9  9  14 18 13 9  9  9  9  9  9  9  9  9  9  9  9  9  9  9  9  9  9  
       9  9  9  9  9  9  9  9  9  9  9  9  9  9  9  9  9  9  9  9  9  9  9  9  9  9  9  14 18 18 18 13 9  9  14 13 9  14 18 13 9  9  9  9  9  9  9  9  9  9  9  9  9  9  9  9  9  9  9  9  9  9  9  9  9  9  9  9  9  9  
       9  9  9  9  9  9  9  9  9  9  9  9  9  9  9  9  9  9  9  9  9  9  9  9  9  9  9  9  9  9  9  9  9  9  9  9  9  9  9  9  9  9  9  9  9  9  9  9  9  9  9  9  9  9  9  9  9  9  9  9  9  9  9  9  9  9  9  9  9  9  
           ))
(levels
      (level (name "bonus2/level1.stl")
           (x 18)
           (y 15))
      (level (name "bonus2/level2.stl")
           (x 26)
           (y 15))
      (level (name "bonus2/level3.stl")
           (x 13)
           (y 21))
      (level (name "bonus2/level4.stl")
           (x 19)
           (y 24))
      (level (name "bonus2/level5.stl")
           (x 28)
           (y 31))
      (level (name "bonus2/level6.stl")
           (x 34)
           (y 24))
      (level (name "bonus2/level7.stl")
           (x 38)
           (y 22))
      (level (name "bonus2/level8.stl")
           (x 17)
           (y 12))
      (level (name "bonus2/level9.stl")
           (x 34)
           (y 14))
      (level (name "bonus2/level10.stl")
           (x 36)
           (y 27))
      (level (name "bonus2/level11.stl")
           (x 21)
           (y 27))
      (level (name "bonus2/level12.stl")
           (x 34)
           (y 20))
      (level (name "bonus2/level13.stl")
           (x 13)
           (y 16))
      (level (name "bonus2/level14.stl")
           (x 28)
           (y 27))
      (level (name "bonus2/level15.stl")
           (x 14)
           (y 27))
      (level (name "bonus2/level16.stl")
           (x 23)
           (y 12))
      (level (name "bonus2/level17.stl")
           (x 22)
           (y 19))
      (level (name "bonus2/level18.stl")
           (x 24)
           (y 30))
      (level (name "bonus2/level19.stl")
           (x 50)
           (y 20))
      (level (name "bonus2/level20.stl")
           (extro-filename "extro-bonus2.txt")
           (x 21)
           (y 8))
      (level (name "bonus2/level21.stl")
           (x 13)
           (y 12))
      (level (name "bonus2/level22.stl")
           (x 34)
           (y 29))
      (level (name "bonus2/level23.stl")
           (x 10)
           (y 22))
      (level (name "bonus2/level24.stl")
           (x 28)
           (y 20))
      (level (name "bonus2/level25.stl")
           (x 33)
           (y 36))
      (level (name "bonus2/level26.stl")
           (x 34)
           (y 33))
      (level (name "bonus2/level27.stl")
           (x 38)
           (y 14))
      (level (name "bonus2/level28.stl")
           (x 50)
           (y 33))
      (level
           (x 60)
           (y 20)
           (teleport-message "I wonder where that path leads to...")
           (dest_x 25)
           (dest_y 8))
      (level
           (x 25)
           (y 8)
           (teleport-message "Warp home")
           (dest_x 22)
           (dest_y 17))
      (level (map-message "You found a secret place!")
           (x 39)
           (y 20) (apply-action-right #f))
      (level (map-message "You found a secret place!")
           (x 39)
           (y 33) (apply-action-right #f))
   )
)

