;; Generated by Windstille Editor
(supertux-level
  (version 1)
  (name "Hello World")
  (width  500)
  (height 15)
  (background "arctis.png")
  (music  "Mortimers_chipdisko.mod")
  (bkgd_red    150)
  (bkgd_green  200)
  (bkgd_blue   255)
  (time  500)
  (gravity  10)
  (particle_system "snow")
  (theme "antarctica")
  (interactive-tm
   61 61 62 0  0  0  62 61 61 61 61 61 61 61 61 61 61 61 61 61 61 61 61 61 61 61 61 61 61 61 61 61 61 61 61 61 61 61 61 61 61 61 61 61 61 61 61 61 61 61 61 61 61 61 61 61 61 61 61 61 61 61 61 61 61 61 61 61 61 61 61 61 61 61 61 61 61 61 61 61 61 61 61 61 61 61 61 61 61 61 61 61 61 61 61 61 61 61 61 61 61 61 61 61 61 61 61 61 61 61 61 61 61 61 61 61 61 61 61 61 61 61 61 61 61 61 61 61 61 61 61 61 61 61 61 61 61 61 61 61 61 61 61 61 61 61 61 61 61 61 61 61 61 61 61 61 61 61 61 61 61 61 61 61 61 61 61 61 61 61 61 61 61 61 61 61 61 61 61 61 61 61 61 61 61 61 61 61 61 61 61 61 61 61 61 61 61 61 61 61 61 61 61 61 61 61 61 61 61 61 61 61 61 61 61 61 61 61 61 61 61 61 61 61 61 61 61 61 61 61 61 61 61 61 61 61 61 61 61 61 61 61 61 61 61 61 61 61 61 61 61 61 61 61 61 61 61 61 61 61 61 61 61 61 61 61 61 61 61 61 61 61 61 61 61 61 61 61 61 61 61 61 61 61 61 61 61 61 61 61 61 61 61 61 61 61 61 61 61 61 61 61 61 61 61 61 61 61 61 61 61 61 61 61 61 61 61 61 61 61 61 61 61 61 61 61 61 61 61 61 61 61 61 61 61 61 61 61 61 61 61 61 61 61 61 61 61 61 61 61 61 61 61 61 61 61 61 61 61 61 61 61 61 61 61 61 61 61 61 61 61 61 61 61 61 61 61 61 61 61 61 61 61 61 61 61 61 61 61 61 61 61 61 61 61 61 61 61 61 61 61 61 61 61 61 61 61 61 61 61 61 61 61 61 61 61 61 61 61 61 61 61 61 61 61 61 61 61 61 61 61 61 61 61 61 61 61 61 61 61 61 61 61 61 61 61 61 61 61 61 61 61 61 61 61 61 61 61 61 61 61 61 61 61 61 61 61 61 61 61 61 61 61 61 61 61 61 61 61 61 61 61 61 61 61 61 61 61 61 61 61 61 61 61 61 61 61 61 61 61 
   61 61 62 0  0  0  62 61 61 61 61 61 61 61 61 61 61 61 61 61 61 61 61 61 61 61 61 61 61 61 61 61 61 61 61 61 61 61 61 61 61 61 61 61 61 61 61 61 61 61 61 61 61 61 61 61 61 61 61 61 61 61 61 61 61 61 61 61 61 61 61 61 61 61 61 61 61 61 61 61 61 61 61 61 61 61 61 61 61 61 61 61 61 61 61 61 61 61 61 61 61 61 61 61 61 61 61 61 61 61 61 61 61 61 61 61 61 61 61 61 61 61 61 61 61 61 61 61 61 61 61 61 61 61 61 61 61 61 61 61 61 61 61 61 61 61 61 61 61 61 61 61 61 61 61 61 61 61 61 61 61 61 61 61 61 61 61 61 61 61 61 61 61 61 61 61 61 61 61 61 61 61 61 61 61 61 61 61 61 61 62 62 62 62 62 62 62 62 62 62 62 62 62 62 62 62 62 62 62 62 62 62 62 62 62 61 61 61 61 61 61 61 61 61 61 61 61 61 61 61 61 61 61 61 61 61 61 61 61 61 61 61 61 61 61 61 61 62 62 62 62 62 62 62 62 62 62 62 62 62 62 62 62 62 61 61 61 61 61 61 61 61 61 61 61 62 62 62 62 62 62 62 62 62 62 62 62 62 62 62 62 61 61 61 61 61 61 61 61 61 61 61 61 61 61 61 61 61 61 61 61 61 61 61 61 61 61 61 61 61 61 61 61 61 61 61 61 61 61 61 61 61 61 61 61 61 61 61 61 61 61 61 61 61 61 61 61 61 61 61 61 61 61 61 61 61 61 61 61 61 61 61 61 61 61 61 61 61 61 61 61 61 61 61 61 61 61 61 61 61 61 61 61 61 61 61 61 61 61 61 61 61 61 61 61 61 61 61 61 61 61 61 61 61 61 61 61 61 61 61 61 61 61 61 61 61 61 61 61 61 61 61 61 61 61 61 61 61 61 61 61 61 61 61 61 61 61 61 61 61 61 61 61 61 61 61 61 61 61 61 61 61 61 61 61 61 61 61 61 61 61 61 61 61 61 61 61 61 61 61 61 61 61 61 61 61 61 61 61 61 61 61 61 61 61 61 61 61 61 61 61 61 61 61 61 61 61 61 61 61 
   61 61 62 0  0  0  62 62 62 62 62 62 61 61 61 61 61 61 61 62 62 62 62 62 62 62 62 62 62 62 62 62 62 62 62 62 62 62 61 61 61 61 61 61 61 62 62 62 62 62 62 62 62 62 62 62 62 62 61 61 61 61 61 61 61 61 61 61 61 61 61 61 61 61 61 61 61 61 61 61 61 61 61 61 61 61 61 61 61 61 61 61 61 61 61 61 61 61 61 61 61 61 61 61 61 61 61 61 61 61 61 61 61 61 61 61 61 61 61 61 61 61 61 61 61 61 61 61 61 61 61 61 61 61 61 61 61 61 61 61 61 61 61 61 61 61 61 61 61 61 61 61 61 61 61 61 61 61 61 61 61 61 61 61 61 61 61 61 61 61 61 61 61 61 61 61 61 61 61 61 61 61 61 61 61 61 61 61 61 62 62 0  0  0  0  0  0  0  0  0  0  0  0  0  0  0  0  0  0  0  0  0  0  0  62 62 61 61 61 61 61 61 61 61 61 61 61 61 61 61 61 61 61 61 61 61 61 61 61 61 61 61 61 62 62 62 62 62 0  0  0  0  0  0  0  0  0  0  0  0  0  0  0  62 62 61 61 61 61 61 61 61 61 61 61 62 0  0  0  0  0  0  0  0  0  0  0  0  0  0  62 61 61 61 61 61 61 61 61 61 61 61 61 62 62 62 62 62 62 62 62 62 62 62 62 62 62 62 62 62 62 62 62 62 62 62 62 62 62 62 62 62 62 62 62 62 62 62 62 62 62 62 62 62 62 62 62 62 62 62 62 62 62 62 62 62 62 62 62 62 62 62 62 62 62 62 62 62 62 62 62 62 62 62 62 62 62 62 62 62 62 62 62 62 62 62 62 62 62 62 62 62 62 62 62 62 62 62 62 62 62 62 62 62 62 62 62 62 62 62 62 62 62 62 62 62 62 62 62 62 62 62 62 62 62 62 62 62 62 62 62 62 62 62 62 62 62 62 62 62 62 62 62 62 62 62 62 62 62 62 62 62 62 62 62 62 62 62 62 62 62 62 62 62 62 62 62 62 62 62 61 61 61 61 61 61 61 62 62 62 62 62 62 62 62 62 62 62 62 62 62 62 62 62 62 62 62 62 61 61 
   61 61 62 0  0  0  0  0  0  0  0  62 62 62 62 62 62 62 62 62 0  0  0  0  0  0  0  0  0  0  0  0  0  0  0  0  0  62 62 61 61 61 61 61 62 62 0  0  0  0  0  0  0  0  0  0  0  62 61 61 61 61 61 61 61 61 61 61 61 61 61 61 61 61 61 61 61 61 61 61 61 61 61 61 61 61 61 61 61 61 61 61 61 61 61 61 61 61 61 61 61 61 61 61 61 61 62 62 62 62 62 62 62 62 62 62 62 62 61 61 61 61 61 61 61 61 61 61 61 61 61 61 61 61 61 61 61 61 61 61 61 61 61 61 61 61 61 61 61 61 61 61 61 61 61 61 61 61 61 61 61 61 61 61 61 61 61 61 61 61 61 61 61 61 61 61 61 61 61 61 61 61 61 61 61 61 61 61 62 62 0  0  0  0  0  0  0  0  0  0  0  0  0  0  0  0  0  0  0  0  0  0  0  0  0  62 62 62 62 62 62 62 62 62 62 62 62 62 62 62 62 62 62 62 62 62 62 62 62 62 62 62 62 62 0  0  0  0  0  0  0  0  0  0  0  0  0  0  0  0  0  0  0  0  62 62 61 61 61 61 61 61 61 61 61 62 0  0  0  0  0  0  0  0  0  0  0  0  0  0  62 61 61 61 61 61 61 61 61 61 61 62 62 62 0  0  0  0  0  0  0  0  0  0  0  0  0  0  0  0  0  0  0  0  0  0  0  0  0  0  0  0  0  0  0  0  0  0  0  0  0  0  0  0  0  0  0  0  0  0  0  0  0  0  0  0  0  0  0  0  0  0  0  0  0  0  0  0  0  0  0  0  0  0  0  0  0  0  0  0  0  0  0  0  0  0  0  0  0  0  0  0  0  0  0  0  0  0  0  0  0  0  0  0  0  0  0  0  0  0  0  0  0  0  0  0  0  0  0  0  0  0  0  0  0  0  0  0  0  0  0  0  0  0  0  0  0  0  0  0  0  0  0  0  0  0  0  0  0  0  0  0  0  0  0  0  0  0  0  0  0  0  0  0  0  0  0  0  0  62 62 62 62 61 61 61 61 62 0  0  0  0  0  0  0  0  0  0  0  0  0  0  0  0  0  0  0  62 61 61 
   61 61 62 0  0  0  0  0  0  0  0  0  0  0  0  0  0  0  0  0  0  0  0  0  0  0  0  0  0  0  0  0  0  0  0  0  0  0  62 62 61 61 61 62 62 0  0  0  0  0  0  0  0  0  0  0  0  62 61 61 61 61 61 61 61 61 61 61 61 61 61 61 61 61 61 61 61 61 61 61 61 61 61 61 61 61 61 61 61 61 61 61 61 61 61 61 61 61 61 61 61 61 61 61 61 62 62 0  0  0  0  0  0  0  0  0  0  62 62 62 62 62 62 62 62 62 62 62 62 62 62 62 62 62 62 62 62 62 62 62 62 62 62 62 62 62 62 62 62 62 62 62 62 62 62 62 62 62 62 62 62 62 62 62 62 62 62 62 62 62 62 61 61 61 61 61 61 61 61 61 61 61 61 61 61 61 61 62 62 0  0  0  0  0  0  0  0  0  0  0  0  0  62 62 62 62 62 62 0  0  0  0  0  0  0  0  0  0  0  0  0  0  0  0  0  0  0  0  0  0  0  0  0  0  0  0  0  0  0  0  0  0  0  0  0  0  0  0  0  0  0  0  0  0  0  0  0  0  0  0  0  0  0  0  0  62 62 61 61 61 61 61 61 61 61 62 0  0  62 62 62 62 62 62 62 62 62 62 0  0  62 61 61 61 61 61 61 61 61 62 62 62 0  0  0  0  0  0  0  0  0  0  0  0  0  0  0  0  0  0  0  0  0  0  0  0  0  0  0  0  0  0  0  0  0  0  0  0  0  0  0  0  0  0  0  0  0  0  0  0  0  0  0  0  0  0  0  0  0  0  0  0  0  0  0  0  0  0  0  0  0  0  0  0  0  0  0  0  0  0  0  0  0  0  0  0  0  0  0  0  0  0  0  0  0  0  0  0  0  0  0  0  0  0  0  0  0  0  0  0  0  0  0  0  0  0  0  0  0  0  0  0  0  0  0  0  0  0  0  0  0  0  0  0  0  0  0  0  0  0  0  0  0  0  0  0  0  0  0  0  0  0  0  0  0  0  0  0  0  0  0  0  0  0  0  0  0  0  0  0  0  0  62 61 61 61 61 62 0  0  0  0  0  0  0  0  0  0  0  0  0  0  0  0  0  0  0  62 61 61 
   61 61 62 0  0  0  0  0  0  0  0  0  0  0  0  0  0  0  0  0  0  0  0  0  0  0  0  0  0  0  0  0  0  0  0  0  0  0  0  62 62 62 62 62 0  0  0  0  0  0  0  0  0  0  0  0  0  62 62 62 62 62 62 62 62 62 62 62 62 62 62 62 62 62 62 62 62 62 62 62 62 62 62 62 62 62 62 62 62 62 62 62 62 62 62 62 62 62 62 62 62 62 62 62 62 62 0  0  0  0  0  0  0  0  0  0  0  0  0  0  0  0  0  0  0  0  0  0  0  0  0  0  0  0  0  0  0  0  0  0  0  0  0  0  0  0  0  0  0  0  0  0  0  0  0  0  0  0  0  0  0  0  0  0  0  0  0  0  0  0  62 61 61 61 61 61 61 61 61 61 61 61 61 61 61 61 62 62 0  0  0  0  0  0  0  0  0  0  0  0  62 62 62 61 61 61 61 62 0  0  0  0  0  0  0  0  0  0  0  0  0  0  0  0  0  0  0  0  0  0  0  0  0  0  0  0  0  0  0  0  0  0  0  0  0  0  0  0  0  0  0  0  0  0  0  0  62 62 62 62 62 62 0  0  0  0  62 62 61 61 61 61 61 61 61 62 0  0  62 61 61 61 61 61 61 61 61 62 0  0  62 61 61 61 61 61 61 61 62 62 0  0  0  0  0  0  0  0  0  0  0  0  0  0  0  0  0  0  0  0  0  0  0  0  0  0  0  0  0  0  0  0  0  0  0  0  0  0  0  0  0  0  0  0  0  0  0  0  0  0  0  0  0  0  0  0  0  0  0  0  0  0  0  0  0  0  0  0  0  0  0  0  0  0  0  0  0  0  0  0  0  0  0  0  0  0  0  0  0  0  0  0  0  0  0  0  0  0  0  0  0  0  0  0  0  0  0  0  0  0  0  0  0  0  0  0  0  0  0  0  0  0  0  0  0  0  0  0  0  0  0  0  0  0  0  0  0  0  0  0  0  0  0  0  0  0  0  0  0  0  0  0  0  0  0  0  0  0  0  0  0  0  0  0  0  0  0  0  0  0  0  0  62 61 61 61 61 62 0  0  0  0  0  0  0  0  0  0  0  0  0  0  0  0  0  0  0  62 62 62 
   61 61 62 0  0  0  0  0  0  0  0  0  0  0  0  0  0  0  0  0  0  0  0  0  0  0  0  0  0  0  0  0  0  0  0  0  0  0  0  0  0  0  0  0  0  0  0  0  0  0  0  0  0  0  0  0  0  0  0  0  0  0  0  0  0  0  0  0  0  0  0  0  0  0  0  0  0  0  0  0  0  0  0  0  0  0  0  0  0  62 0  0  0  0  0  0  0  0  0  0  0  0  0  0  0  0  0  0  0  0  0  0  0  0  0  0  0  0  0  0  0  0  0  0  0  0  0  0  0  0  0  0  0  0  0  0  0  0  0  0  0  0  0  0  0  0  0  0  0  0  0  0  0  0  0  0  0  0  0  0  0  0  0  0  0  0  0  0  0  0  62 61 61 61 61 61 61 61 61 61 61 61 61 61 61 62 62 0  0  0  0  0  0  0  0  0  0  0  62 62 62 61 61 61 61 61 61 62 0  0  0  0  0  0  0  0  0  0  0  0  0  0  0  0  0  0  0  0  0  0  0  0  0  0  0  0  0  0  0  0  0  0  0  0  0  0  0  0  0  0  0  0  0  0  0  0  62 61 61 61 61 62 62 0  0  0  0  62 62 61 61 61 61 61 61 62 0  62 62 61 61 61 61 61 61 61 61 62 0  0  62 62 61 61 61 61 61 62 62 0  0  0  0  0  0  0  0  0  0  0  0  0  0  0  0  0  0  0  0  0  0  0  0  0  0  0  0  0  0  0  0  0  0  0  0  0  0  0  0  0  0  0  0  0  0  0  0  0  0  0  0  0  0  0  0  0  0  0  0  0  0  0  0  0  0  0  0  0  0  0  0  0  0  0  0  0  0  0  0  0  0  0  0  0  0  0  0  0  0  0  0  0  0  0  0  0  0  0  0  0  0  0  0  0  0  0  0  0  0  0  0  0  0  0  0  0  0  0  0  62 62 62 62 62 62 62 62 62 62 62 62 62 0  62 62 62 62 62 0  62 62 62 62 62 0  62 62 62 62 62 62 0  0  0  0  0  0  0  0  0  0  0  0  0  0  0  0  0  0  0  0  0  62 62 61 61 61 62 0  0  0  0  0  0  0  0  0  0  0  0  0  0  0  0  0  0  0  59 60 0  
   61 61 62 0  0  0  0  0  0  0  0  62 62 62 62 62 62 62 62 62 0  0  0  0  0  0  0  0  0  0  0  0  0  0  0  0  0  0  0  0  0  0  0  0  0  0  0  0  0  0  0  0  0  0  0  0  0  0  0  0  0  0  0  0  0  0  0  0  0  0  0  0  0  0  0  0  0  0  0  0  0  0  0  0  0  0  0  0  0  0  0  0  0  0  0  0  0  0  0  0  0  0  0  0  0  0  0  0  0  0  0  0  0  0  0  0  0  0  0  0  0  0  0  0  0  0  0  0  0  0  0  0  0  0  0  0  0  0  0  0  0  0  0  0  0  0  0  0  62 0  0  0  0  0  0  0  0  0  0  62 0  0  0  0  0  0  0  0  0  0  62 61 61 61 61 61 61 61 61 61 61 61 61 61 62 62 0  0  0  0  0  0  0  0  0  0  62 62 62 61 61 61 61 61 61 61 61 62 0  0  0  0  0  0  0  0  0  0  0  0  0  0  0  0  0  0  0  0  0  0  0  0  0  0  0  0  0  0  0  0  0  0  0  0  0  0  0  0  62 62 62 62 62 0  0  0  62 61 61 61 61 61 62 62 0  0  0  0  62 62 61 61 61 61 61 62 0  0  62 61 61 61 61 61 61 61 61 62 0  0  0  62 62 61 61 61 62 62 0  0  0  0  0  0  0  0  0  0  0  0  0  0  0  0  0  0  0  0  0  0  0  0  0  0  0  0  0  0  0  0  0  0  0  0  0  0  0  0  0  0  0  0  0  0  0  0  0  0  0  0  0  0  0  0  0  0  0  0  0  0  0  0  0  0  0  0  0  0  0  0  0  0  0  0  0  0  0  0  0  0  0  0  0  0  0  0  0  0  0  0  0  0  0  0  0  0  0  0  0  0  0  0  0  0  0  0  0  0  0  0  0  0  0  0  0  0  62 62 62 62 61 61 61 61 61 61 61 61 61 61 61 62 0  62 61 61 61 62 0  62 61 61 61 62 0  62 61 61 61 62 62 62 62 62 62 62 62 62 0  0  0  0  62 62 62 62 62 62 62 62 0  0  0  62 62 61 61 62 0  0  0  0  0  0  0  0  0  0  0  0  0  0  0  0  0  0  0  59 60 0  
   61 61 62 0  0  0  0  0  0  0  0  0  0  0  0  0  0  0  0  0  0  0  0  0  0  0  0  0  0  0  0  0  0  0  0  0  0  0  0  0  0  0  0  0  0  0  0  0  0  0  0  0  0  0  0  0  0  0  0  0  0  0  0  0  0  0  0  0  0  0  0  0  0  0  0  0  0  0  0  0  0  0  62 0  0  0  0  0  0  0  0  0  0  0  0  0  62 0  0  0  0  0  0  0  0  0  0  0  0  0  0  0  0  0  0  0  0  62 62 62 62 62 62 62 62 62 62 62 62 62 62 62 62 62 62 62 62 62 62 62 0  0  0  62 62 62 62 62 62 62 62 62 62 62 62 62 62 62 62 62 62 62 62 62 62 0  0  0  0  0  62 61 61 61 61 62 62 62 61 61 61 61 61 62 62 0  0  0  0  0  0  0  0  0  62 62 62 61 61 61 61 61 61 61 61 61 61 62 0  0  0  0  0  0  0  0  0  0  0  0  0  0  0  0  0  0  0  0  0  0  0  0  0  0  0  0  0  0  0  0  0  0  0  0  0  0  0  0  62 61 61 61 62 0  0  0  62 61 61 61 61 61 61 62 62 0  0  0  0  62 62 61 61 61 61 62 0  0  62 61 61 61 61 61 61 61 61 62 0  0  0  0  62 62 62 62 62 0  0  0  0  0  0  0  0  0  0  0  0  0  0  0  0  0  0  0  0  0  0  0  0  0  0  0  0  0  0  0  0  0  0  0  0  0  0  0  0  0  0  0  0  0  0  0  0  0  0  0  0  0  0  0  0  0  0  0  0  62 62 62 62 62 62 62 62 62 0  0  0  0  0  0  0  0  0  0  0  0  0  26 26 0  0  0  0  0  0  0  0  0  0  0  0  0  0  0  0  0  0  0  62 62 0  0  0  0  62 62 0  0  0  0  62 62 62 62 62 62 62 62 62 62 62 62 62 62 62 62 62 62 62 62 0  62 62 62 62 62 0  62 62 62 62 62 0  62 62 62 62 62 62 62 62 62 62 62 62 62 0  0  0  0  62 61 61 61 61 61 61 62 0  0  0  0  62 62 62 62 0  0  0  0  0  0  0  0  0  0  0  0  0  0  0  0  0  0  45 59 60 0  
   61 61 62 0  0  0  0  0  0  0  0  0  0  0  0  0  0  0  0  0  0  0  0  0  0  0  0  0  0  0  0  0  0  0  0  0  0  0  0  0  0  0  0  0  0  0  0  0  0  0  0  0  0  0  0  0  0  0  0  62 62 62 62 62 62 0  0  0  0  0  0  0  0  0  0  0  62 62 62 62 62 62 62 62 62 62 62 62 62 62 62 62 62 62 62 62 62 62 62 62 62 62 62 0  0  0  0  0  0  0  0  0  0  0  0  0  0  0  62 62 62 62 62 62 62 62 62 62 62 62 62 62 62 62 62 62 62 62 62 62 0  0  0  62 62 62 62 62 62 62 62 62 62 62 62 62 62 62 62 62 62 62 62 62 62 0  0  0  0  0  62 61 61 61 61 62 0  62 61 61 61 61 62 62 0  0  0  0  0  0  0  0  62 62 62 61 61 61 61 61 61 61 61 61 61 61 61 62 0  0  0  0  0  0  0  0  0  0  0  0  0  0  0  0  0  0  0  0  0  0  0  0  0  0  0  0  0  0  0  0  62 62 62 62 62 0  0  0  62 61 61 61 62 0  0  0  62 61 61 61 61 61 61 61 62 62 0  0  0  0  62 62 61 61 61 62 62 0  62 61 61 61 61 61 61 61 61 62 0  0  0  0  0  0  0  0  0  0  0  0  0  0  0  0  0  0  0  0  0  0  0  0  0  0  0  0  0  0  0  0  0  0  0  0  0  0  0  0  0  0  0  0  0  0  0  0  0  0  0  0  0  0  0  0  0  0  0  0  0  0  0  0  0  62 0  0  0  62 61 61 61 61 61 61 61 62 0  0  0  0  0  0  0  0  0  0  0  0  0  0  0  0  0  0  0  0  0  0  0  0  0  0  0  0  0  0  0  0  0  0  62 62 0  0  0  0  62 62 0  0  0  0  62 62 62 62 62 62 62 0  0  0  0  0  0  0  0  0  0  0  0  0  0  0  0  0  0  0  0  0  0  0  0  0  0  0  0  0  0  0  0  0  0  0  0  0  0  0  0  0  0  0  62 61 61 61 61 61 61 62 0  0  0  0  0  0  59 60 0  0  0  0  0  0  0  0  0  0  0  0  0  0  0  0  0  0  62 62 62 62 
   61 61 62 0  0  0  0  0  0  0  0  0  0  0  0  0  0  0  0  0  0  0  0  0  62 62 62 62 62 62 0  0  62 62 62 62 62 62 0  0  0  0  0  0  0  0  0  0  0  0  0  0  62 62 62 62 62 62 0  62 61 61 61 61 62 0  0  0  0  0  0  0  0  0  0  0  62 61 61 61 61 61 61 61 61 61 61 61 61 61 61 61 61 61 61 61 61 61 61 61 61 61 62 0  0  0  0  0  0  0  0  0  0  0  0  0  0  0  0  0  0  0  0  0  0  0  0  0  0  0  0  0  0  0  0  0  0  0  0  0  0  62 0  0  0  0  0  0  62 0  0  0  0  0  0  0  0  0  0  62 0  0  0  0  0  0  0  0  0  0  62 62 62 62 62 62 0  62 62 62 62 62 62 0  0  0  0  0  0  0  62 62 62 61 61 61 61 61 61 61 61 61 61 61 61 61 61 62 0  0  0  0  0  0  0  0  0  0  0  0  0  0  0  0  0  0  0  0  0  0  0  0  0  0  0  0  0  0  0  0  62 61 61 61 62 0  0  0  62 61 61 61 62 0  0  0  62 61 61 61 61 61 61 61 61 62 62 0  0  0  0  62 62 62 62 62 0  0  62 62 62 62 62 62 62 62 62 62 0  0  0  0  0  0  0  0  0  0  0  0  0  0  0  0  0  0  0  0  0  0  0  0  0  0  0  0  0  0  0  0  0  0  0  0  0  0  0  0  0  0  0  0  0  0  0  0  0  0  0  0  0  0  0  0  0  0  0  0  0  62 0  0  0  0  0  0  0  62 61 61 61 61 61 61 61 62 0  0  0  0  0  0  0  0  0  0  0  0  0  0  0  0  0  0  0  0  0  0  0  0  0  0  0  0  0  0  0  0  0  0  0  0  0  0  0  0  0  0  0  0  0  0  0  0  0  0  0  0  0  0  0  0  0  0  0  0  0  0  0  0  0  0  0  0  0  0  0  0  0  0  0  0  0  0  0  0  0  0  0  0  0  0  0  0  0  0  0  0  0  0  0  0  62 62 62 62 62 62 62 62 0  0  0  0  0  0  59 60 0  0  0  0  0  0  0  0  0  0  0  0  0  0  0  0  0  0  62 61 61 61 
   61 61 62 62 62 62 62 62 62 62 62 62 62 62 62 62 0  62 62 62 62 62 62 0  62 61 61 61 61 62 0  0  62 61 61 61 61 62 0  0  0  0  0  0  0  62 62 62 62 62 62 0  62 61 61 61 61 62 0  62 61 61 61 61 62 0  0  0  62 62 62 62 62 62 0  0  62 61 61 61 61 61 61 61 61 61 61 61 61 61 61 61 61 61 61 61 61 61 61 61 61 61 62 0  0  62 62 62 62 62 62 62 62 62 62 62 0  0  0  0  0  0  0  0  0  0  0  0  0  0  0  0  0  0  0  0  0  0  0  0  0  0  0  0  0  0  0  0  0  0  0  0  0  0  0  0  0  0  0  0  0  0  0  0  0  0  0  0  0  0  0  0  0  0  0  0  0  0  0  0  0  0  0  0  0  0  0  0  62 62 62 61 61 61 61 61 61 61 61 61 61 61 61 61 61 61 61 62 0  0  0  0  0  0  0  0  0  0  0  0  0  0  0  0  62 62 62 62 62 0  0  0  62 62 62 62 62 0  0  0  62 61 61 61 62 0  0  0  62 61 61 61 62 0  0  0  62 61 61 61 61 61 61 61 61 61 62 62 0  0  0  0  0  0  0  0  0  0  0  0  0  0  0  0  0  0  0  0  0  0  0  0  0  0  0  0  0  0  0  0  0  0  0  0  0  0  0  0  0  0  0  0  0  0  62 62 62 62 62 62 62 62 62 62 62 0  0  0  0  62 0  0  0  0  62 0  0  0  0  62 62 62 62 62 62 62 0  0  0  0  0  0  0  0  0  0  0  62 61 61 61 61 61 61 61 62 0  0  0  0  0  0  0  0  0  0  0  0  0  0  0  0  0  0  0  0  0  0  0  0  0  0  0  0  0  0  0  0  0  0  0  0  0  0  0  0  0  0  0  0  0  0  0  0  0  0  0  0  0  0  0  0  0  0  0  0  0  0  0  0  0  0  0  0  0  0  0  0  0  0  0  0  0  0  0  0  0  0  0  0  0  0  0  0  0  0  0  0  0  0  0  0  0  0  0  0  0  0  0  0  0  0  0  0  0  0  59 60 0  0  0  0  0  0  0  0  0  0  0  0  0  0  0  0  0  0  62 61 61 61 
   61 61 61 61 61 61 61 61 61 61 61 61 61 61 61 62 0  62 61 61 61 61 62 0  62 61 61 61 61 62 0  0  62 61 61 61 61 62 0  0  0  0  62 62 0  62 61 61 61 61 62 0  62 61 61 61 61 62 0  62 61 61 61 61 62 0  0  0  62 61 61 61 61 62 0  0  62 61 61 61 61 61 61 61 61 61 61 61 61 61 61 61 61 61 61 61 61 61 61 61 61 61 62 0  0  62 61 61 61 61 61 61 61 61 61 62 62 0  0  0  0  0  0  0  0  0  0  0  0  0  0  0  0  0  0  0  0  0  0  0  0  0  0  0  0  0  0  0  0  0  0  0  0  0  0  0  0  0  0  0  0  0  0  0  0  0  0  0  0  0  0  0  0  0  0  0  0  0  0  0  0  0  0  0  0  0  62 62 62 61 61 61 61 61 61 61 61 61 61 61 61 61 61 61 61 61 61 62 0  0  0  0  0  0  0  0  0  62 62 62 62 0  0  0  62 61 61 61 62 0  0  0  62 61 61 61 62 0  0  0  62 61 61 61 62 0  0  0  62 61 61 61 62 0  0  0  62 61 61 61 61 61 61 61 61 61 61 62 62 0  0  0  0  0  0  0  0  0  0  0  0  0  0  0  0  0  0  0  0  0  0  0  0  0  0  0  0  0  0  0  0  0  0  0  0  0  62 62 62 62 62 62 0  0  62 61 61 61 61 61 61 61 61 61 62 0  0  0  0  0  0  0  0  0  0  0  0  0  0  62 61 61 61 61 61 62 0  0  0  0  0  0  0  0  0  0  0  62 61 61 61 61 61 61 61 62 0  0  0  62 62 62 62 62 62 0  0  62 62 62 62 62 62 0  0  62 62 62 62 62 62 0  0  62 62 62 62 62 62 62 62 62 62 62 62 62 62 62 62 62 62 62 62 62 62 62 62 62 62 62 62 62 62 62 62 62 62 62 62 62 62 62 62 62 62 62 62 62 62 62 62 62 62 62 62 62 62 62 62 62 62 62 62 62 62 62 62 62 62 62 0  0  0  0  0  0  0  0  0  0  0  0  62 62 62 62 62 62 62 62 62 62 62 62 62 62 62 62 62 62 62 62 62 62 62 62 62 61 61 61 
   61 61 61 61 61 61 61 61 61 61 61 61 61 61 61 62 0  62 61 61 61 61 62 0  62 61 61 61 61 62 0  0  62 61 61 61 61 62 0  0  0  0  62 62 0  62 61 61 61 61 62 0  62 61 61 61 61 62 0  62 61 61 61 61 62 0  0  0  62 61 61 61 61 62 0  0  62 61 61 61 61 61 61 61 61 61 61 61 61 61 61 61 61 61 61 61 61 61 61 61 61 61 62 0  0  62 61 61 61 61 61 61 61 61 61 61 62 62 62 62 62 62 62 62 62 62 62 62 62 62 62 62 62 62 62 62 62 62 62 62 62 62 62 62 62 62 62 62 62 62 62 62 62 62 62 62 62 62 62 62 62 62 62 62 62 62 62 62 62 62 62 62 62 62 62 62 62 62 62 62 62 62 62 62 62 62 62 61 61 61 61 61 61 61 61 61 61 61 61 61 61 61 61 61 61 61 61 62 0  0  0  0  62 62 0  0  0  62 61 61 62 0  0  0  62 61 61 61 62 0  0  0  62 61 61 61 62 0  0  0  62 61 61 61 62 0  0  0  62 61 61 61 62 0  0  0  62 61 61 61 61 61 61 61 61 61 61 61 62 62 62 62 62 62 62 62 62 62 62 62 62 62 62 62 62 62 62 62 27 28 28 28 28 28 28 28 28 29 62 62 62 62 62 62 0  0  62 61 61 61 61 62 0  0  62 61 61 61 61 61 61 61 61 61 62 0  0  0  0  0  0  0  0  0  0  0  0  0  0  62 61 61 61 61 61 62 0  0  0  0  0  0  0  0  0  0  0  62 61 61 61 61 61 61 61 62 0  0  0  62 61 61 61 61 62 0  0  62 61 61 61 61 62 0  0  62 61 61 61 61 62 0  0  62 61 61 61 61 61 61 61 61 61 61 61 61 61 61 61 61 61 61 61 61 61 61 61 61 61 61 61 61 61 61 61 61 61 61 61 61 61 61 61 61 61 61 61 61 61 61 61 61 61 61 61 61 61 61 61 61 61 61 61 61 61 61 61 61 61 62 62 62 62 62 62 62 62 62 62 62 62 62 62 61 61 61 61 61 61 61 61 61 61 61 61 61 61 61 61 61 61 61 61 61 61 61 61 61 61 61 
   61 61 61 61 61 61 61 61 61 61 61 61 61 61 61 62 0  62 61 61 61 61 62 0  62 61 61 61 61 62 0  0  62 61 61 61 61 62 62 62 62 62 62 62 62 62 61 61 61 61 62 0  62 61 61 61 61 62 0  62 61 61 61 61 62 0  0  0  62 61 61 61 61 62 0  0  62 61 61 61 61 61 61 61 61 61 61 61 61 61 61 61 61 61 61 61 61 61 61 61 61 61 62 0  0  62 61 61 61 61 61 61 61 61 61 61 61 61 61 61 61 61 61 61 61 61 61 61 61 61 61 61 61 61 61 61 61 61 61 61 61 61 61 61 61 61 61 61 61 61 61 61 61 61 61 61 61 61 61 61 61 61 61 61 61 61 61 61 61 61 61 61 61 61 61 61 61 61 61 61 61 61 61 61 61 61 61 61 61 61 61 61 61 61 61 61 61 61 61 61 61 61 61 61 61 61 61 62 0  0  0  0  62 62 0  0  0  62 61 61 62 0  0  0  62 61 61 61 62 0  0  0  62 61 61 61 62 0  0  0  62 61 61 61 62 0  0  0  62 61 61 61 62 0  0  0  62 61 61 61 61 61 61 61 61 61 61 61 61 61 61 61 61 61 61 61 61 61 61 61 61 61 61 61 61 61 61 62 0  0  0  0  0  0  0  0  0  0  62 61 61 61 61 62 0  0  62 61 61 61 61 62 0  0  62 61 61 61 61 61 61 61 61 61 62 0  0  0  0  0  0  0  0  0  0  0  0  0  0  62 61 61 61 61 61 62 0  0  0  0  0  0  0  0  0  0  0  62 61 61 61 61 61 61 61 62 0  0  0  62 61 61 61 61 62 0  0  62 61 61 61 61 62 0  0  62 61 61 61 61 62 0  0  62 61 61 61 61 61 61 61 61 61 61 61 61 61 61 61 61 61 61 61 61 61 61 61 61 61 61 61 61 61 61 61 61 61 61 61 61 61 61 61 61 61 61 61 61 61 61 61 61 61 61 61 61 61 61 61 61 61 61 61 61 61 61 61 61 61 61 61 61 61 61 61 61 61 61 61 61 61 61 61 61 61 61 61 61 61 61 61 61 61 61 61 61 61 61 61 61 61 61 61 61 61 61 61 61 61 61 
      )

  (objects
  )
   )


;; EOF ;;
