;; Generated by Windstille Editor
(supertux-level
  (version 1)
  (name "Hello World")
  (width  500)
  (height 15)
  (background "arctis.png")
  (music  "Mortimers_chipdisko.mod")
  (bkgd_red    150)
  (bkgd_green  200)
  (bkgd_blue   255)
  (time  500)
  (gravity  10)
  (particle_system "snow")
  (theme "antarctica")
  (interactive-tm
   36 43 0  0  0  38 36 36 36 36 36 36 36 36 36 36 36 36 36 36 36 36 36 36 36 36 36 36 36 36 36 36 36 36 36 36 36 36 36 36 36 36 36 36 36 36 36 36 36 36 36 36 36 36 36 36 36 36 36 36 36 36 36 36 36 36 36 36 36 36 36 36 36 36 36 36 36 36 36 36 36 36 36 36 36 36 36 36 36 36 36 36 36 36 36 36 36 36 36 36 36 36 36 36 36 36 36 36 36 36 36 36 36 36 36 36 36 36 36 36 36 36 36 36 36 36 36 36 36 36 36 36 36 36 36 36 36 36 36 36 36 36 36 36 36 36 36 36 36 36 36 36 36 36 36 36 36 36 36 36 36 36 36 36 36 36 36 36 36 36 36 36 36 36 36 36 36 36 36 36 36 36 36 36 36 36 36 36 36 36 36 36 36 36 36 36 36 36 36 36 36 36 36 36 36 36 36 36 36 36 36 36 36 36 36 36 36 36 36 36 36 36 36 36 36 36 36 36 36 36 36 36 36 36 36 36 36 36 36 36 36 36 36 36 36 36 36 36 36 36 36 36 36 36 36 36 36 36 36 36 36 36 36 36 36 36 36 36 36 36 36 36 36 36 36 36 36 36 36 36 36 36 36 36 36 36 36 36 36 36 36 36 36 36 36 36 36 36 36 36 36 36 36 36 36 36 36 36 36 36 36 36 36 36 36 36 36 36 36 36 36 36 36 36 36 36 36 36 36 36 36 36 36 36 36 36 36 36 36 36 36 36 36 36 36 36 36 36 36 36 36 36 36 36 36 36 36 36 36 36 36 36 36 36 36 36 36 36 36 36 36 36 36 36 36 36 36 36 36 36 36 36 36 36 36 36 36 36 36 36 36 36 36 36 36 36 36 36 36 36 36 36 36 36 36 36 36 36 36 36 36 36 36 36 36 36 36 36 36 36 36 36 36 36 36 36 36 36 36 36 36 36 36 36 36 36 36 36 36 36 36 36 36 36 36 36 36 36 36 36 36 36 36 36 36 36 36 36 36 36 36 36 36 36 36 36 36 36 36 36 36 36 36 36 36 36 36 36 36 36 36 36 36 36 36 36 36 36 36 36 36 36 36 36 36 36 36 36 36 36 
   36 43 0  0  0  40 41 41 41 41 41 41 41 41 41 41 41 41 41 41 41 41 41 41 41 41 41 41 41 41 41 41 41 41 41 41 41 41 41 41 41 41 41 41 41 41 41 41 41 41 41 41 41 41 41 41 41 41 41 41 41 41 41 41 41 41 41 41 41 41 41 41 41 41 41 41 41 41 41 41 41 41 41 41 41 41 41 41 41 41 41 41 41 41 41 41 41 41 41 41 41 41 41 41 41 41 41 41 41 41 41 41 41 41 41 41 41 41 41 41 41 41 41 41 41 41 41 41 41 41 41 41 41 41 41 41 41 41 41 41 41 41 41 41 41 41 41 41 41 41 41 41 41 41 41 41 41 41 41 41 41 41 41 41 41 41 41 41 41 41 41 41 36 36 36 41 41 41 41 41 41 41 41 41 41 41 41 41 41 41 41 41 41 41 41 41 41 41 41 41 41 41 41 41 41 41 41 41 41 41 41 41 41 41 41 41 41 41 41 41 41 41 41 41 41 41 41 41 41 41 41 41 41 41 41 41 41 41 41 41 41 41 41 41 41 41 41 41 41 41 41 41 41 41 36 36 36 36 36 36 36 36 36 41 41 41 41 41 41 41 41 41 41 41 41 41 41 41 41 41 41 41 41 41 41 41 41 41 41 41 41 41 41 41 41 41 41 41 41 41 41 41 41 41 41 41 41 41 41 41 41 41 41 41 41 41 41 41 41 41 41 41 41 41 41 41 41 41 41 41 41 41 41 41 41 41 41 41 41 41 41 41 41 41 41 41 41 41 41 36 36 36 36 36 36 41 41 41 41 36 36 36 36 36 36 36 36 36 41 41 41 41 41 41 41 41 41 41 41 41 41 41 41 41 41 41 41 41 41 41 41 41 41 41 41 41 41 41 41 41 41 41 41 41 41 41 41 41 41 41 41 41 41 41 41 41 41 41 41 41 41 41 41 41 41 41 41 41 41 41 41 41 41 41 41 41 41 41 41 41 41 41 41 41 41 41 41 41 41 41 41 41 41 41 41 41 41 41 41 41 41 41 41 41 41 41 41 41 41 41 41 41 41 41 41 41 41 41 41 41 41 41 41 41 41 36 36 36 36 36 36 36 36 36 36 36 36 36 36 36 
   36 43 0  0  0  0  0  0  0  0  0  0  0  0  0  0  0  0  0  0  0  0  0  0  0  0  0  0  0  0  0  0  0  0  0  0  0  0  0  0  0  0  0  0  0  0  0  0  0  0  0  0  0  0  0  0  0  0  0  0  0  0  0  0  0  0  0  0  0  0  0  0  0  0  0  0  0  0  0  0  0  0  0  0  0  0  0  0  0  0  0  0  0  0  0  0  0  0  0  0  0  0  0  0  0  0  0  0  0  0  0  0  0  0  0  0  0  0  0  0  0  0  0  0  0  0  0  0  0  0  0  0  0  0  0  0  0  0  0  0  0  0  0  0  0  0  0  0  0  0  0  0  0  0  0  0  0  0  0  0  0  0  0  0  0  0  0  0  0  0  0  0  38 36 43 0  0  0  0  0  0  0  0  0  0  0  0  0  0  0  0  0  0  0  0  0  0  0  0  0  0  0  0  0  0  0  0  0  0  0  0  0  0  0  0  0  0  0  0  0  0  0  0  0  0  0  0  0  0  0  0  0  0  0  0  0  0  0  0  0  0  0  0  0  0  0  0  0  0  0  0  0  0  0  40 41 41 41 41 41 41 41 42 0  0  0  0  0  0  0  0  0  0  0  0  0  0  0  0  0  0  0  0  0  0  0  0  0  0  0  0  0  0  0  0  0  0  0  0  0  0  0  0  0  0  0  0  0  0  0  0  0  0  0  0  0  0  0  0  0  0  0  0  0  0  0  0  0  0  0  0  0  0  0  0  0  0  0  0  0  0  0  0  0  0  0  0  0  0  38 36 36 36 36 43 0  0  0  0  38 36 36 36 36 36 36 36 42 0  0  0  0  0  0  0  0  0  0  0  0  0  0  0  0  0  0  0  0  0  0  0  0  0  0  0  0  0  0  0  0  0  0  0  0  0  0  0  0  0  0  0  0  0  0  0  0  0  0  0  0  0  0  0  0  0  0  0  0  0  0  0  0  0  0  0  0  0  0  0  0  0  0  0  0  0  0  0  0  0  0  0  0  0  0  0  0  0  0  0  0  0  0  0  0  0  0  0  0  0  0  0  0  0  0  0  0  0  0  0  0  0  0  0  0  0  40 36 36 36 36 36 36 36 36 36 36 36 36 36 36 
   36 43 0  0  0  0  0  0  0  0  0  0  0  0  0  0  0  0  0  0  0  0  0  0  0  0  0  0  0  0  0  0  0  0  0  0  0  0  0  0  0  0  0  0  0  0  0  0  0  0  0  0  0  0  0  0  0  0  0  0  0  0  0  0  0  0  0  0  0  0  0  0  0  0  0  0  0  0  0  0  0  0  0  0  0  0  0  0  0  0  0  0  0  0  0  0  0  0  0  0  0  0  0  0  0  0  0  0  0  0  0  0  0  0  0  0  0  0  0  0  0  0  0  0  0  0  0  0  0  0  0  0  0  0  0  0  0  0  0  0  0  0  0  0  0  0  0  0  26 0  0  0  0  0  0  0  0  0  0  0  0  0  0  0  0  0  0  0  0  0  0  0  38 36 43 0  0  0  26 27 28 28 28 28 28 29 0  0  0  0  0  0  0  0  0  0  0  0  0  0  0  0  0  0  0  0  0  0  0  0  0  0  0  0  0  0  0  0  0  0  0  0  0  0  0  0  0  0  0  0  0  0  0  0  0  0  0  0  0  0  0  0  0  0  0  0  0  0  0  0  0  0  0  0  0  0  0  0  0  0  0  0  0  0  0  0  0  0  0  0  0  0  0  0  0  0  0  0  0  0  0  0  0  0  0  0  0  0  0  0  0  0  0  0  0  0  0  0  0  0  0  0  0  0  0  0  0  0  0  0  0  0  0  0  0  0  0  0  0  0  0  0  0  0  0  0  0  0  0  0  0  0  0  0  0  0  0  0  0  0  0  0  0  0  0  0  0  0  0  40 41 41 41 41 42 0  0  0  0  38 36 36 36 36 36 36 43 0  0  0  0  0  0  0  0  0  0  0  0  0  0  0  0  0  0  0  0  0  0  0  0  0  0  0  0  0  0  0  0  0  0  0  0  0  0  0  0  0  0  0  0  0  0  0  0  0  0  0  0  0  0  0  0  0  0  0  0  0  0  0  0  0  0  0  0  0  0  0  0  0  0  0  0  0  0  0  0  0  0  0  0  0  0  0  0  0  0  0  0  0  0  0  0  0  0  0  0  0  0  0  0  0  0  0  0  0  0  0  0  0  0  0  0  0  0  0  40 41 36 36 36 36 36 36 41 36 36 36 36 36 
   36 43 0  0  0  0  0  0  0  0  0  0  0  0  0  0  0  0  0  0  0  0  0  0  0  0  0  0  0  0  0  0  0  0  0  0  0  0  0  0  0  0  0  0  0  0  0  0  0  0  0  0  0  0  0  0  0  0  0  0  0  0  0  0  0  0  0  0  0  0  0  0  0  0  0  0  0  0  0  0  0  0  0  0  0  0  0  0  0  0  0  0  0  0  0  0  0  0  0  0  0  0  0  0  0  0  0  0  0  0  0  0  0  0  0  0  0  0  0  0  0  0  0  0  0  0  0  0  0  0  0  0  0  0  0  0  0  0  0  0  0  0  0  0  0  0  0  0  0  0  0  0  0  0  0  0  0  0  0  0  0  0  0  0  0  0  0  0  0  0  0  0  38 36 43 0  0  0  0  0  0  0  0  0  0  0  0  0  0  0  0  0  0  0  0  0  0  0  0  0  0  0  0  0  0  0  0  0  0  0  0  0  0  0  0  0  0  0  0  0  0  0  0  0  0  0  0  0  0  0  0  0  0  0  0  0  0  0  0  0  0  0  0  0  0  0  0  0  0  0  0  0  0  33 33 0  33 33 0  33 33 0  0  0  0  0  0  0  0  0  0  0  0  0  0  0  0  0  0  0  0  0  0  0  0  0  0  0  0  0  0  0  0  0  0  0  0  0  0  0  0  0  0  0  0  0  0  0  0  0  0  0  0  0  0  0  0  0  0  0  0  0  0  0  0  0  0  0  0  0  0  0  0  0  0  0  0  0  0  0  0  0  0  0  0  0  0  0  0  0  0  0  0  0  0  0  0  0  0  38 36 36 36 36 36 41 42 0  0  0  0  0  0  0  0  0  0  0  0  0  0  0  0  0  0  0  0  0  0  0  0  0  0  0  0  0  0  0  0  0  0  0  0  0  0  0  0  0  0  0  0  0  0  0  0  0  0  0  0  0  0  0  0  0  0  0  33 33 33 33 33 33 33 33 0  0  0  0  0  0  0  0  0  0  0  0  0  0  0  0  0  0  0  0  0  0  0  0  0  0  0  0  0  0  0  0  0  0  0  0  0  0  0  0  0  0  0  0  0  0  0  0  0  0  0  0  0  0  38 36 36 36 36 42 0  38 36 36 36 36 
   36 43 0  0  0  0  0  0  0  0  0  0  0  0  0  0  0  0  0  0  0  0  0  0  0  0  0  0  0  0  0  0  0  0  0  0  0  0  0  0  0  0  0  0  0  0  0  0  0  0  0  0  0  0  0  0  0  0  0  0  0  0  0  0  0  0  0  0  0  0  0  0  0  0  0  0  0  0  0  0  0  0  0  0  0  0  0  0  0  0  0  0  0  0  0  0  0  0  0  0  0  0  0  0  0  0  0  0  0  0  0  0  0  0  0  0  0  0  0  0  0  0  0  0  0  0  0  0  0  0  0  0  0  0  0  0  0  0  0  0  0  0  0  0  0  0  0  0  0  0  0  0  0  0  0  0  0  0  0  0  0  0  0  0  0  0  0  0  0  0  0  37 36 43 0  0  0  0  0  0  0  0  0  0  0  0  0  0  0  0  0  0  0  0  0  0  0  0  0  0  0  0  0  0  0  0  0  0  0  0  0  0  0  0  0  0  0  0  0  0  0  0  0  0  0  0  0  0  0  0  0  0  0  0  0  0  0  0  0  0  0  0  0  0  0  0  0  0  0  0  0  0  0  35 39 0  35 39 0  35 39 0  0  0  0  0  0  0  0  0  0  0  0  0  0  0  0  0  0  0  0  0  0  0  0  0  0  0  0  0  0  0  0  0  0  0  0  0  0  0  0  0  0  0  0  0  0  0  0  0  0  0  0  0  0  0  0  0  0  0  0  0  0  0  0  0  0  0  0  0  0  0  0  0  0  0  0  0  0  0  0  0  0  0  0  0  0  0  0  0  0  0  0  0  0  0  0  0  0  38 36 36 36 36 42 0  0  0  0  0  0  0  0  0  0  0  0  0  0  0  0  0  26 0  0  0  0  0  0  0  0  0  0  0  0  0  0  0  0  0  0  0  0  0  0  0  0  0  0  0  0  0  0  0  0  0  0  0  0  0  0  0  0  0  0  0  35 37 37 37 37 37 37 39 0  0  0  0  0  0  0  0  0  0  0  0  0  0  0  0  0  0  0  0  0  0  0  0  0  0  0  0  0  0  0  0  0  0  0  0  0  0  0  0  0  0  0  0  0  0  0  0  0  0  0  0  0  0  40 41 41 41 42 0  0  40 36 36 36 43 
   36 43 0  0  0  0  0  0  0  0  0  0  0  0  0  0  0  0  0  0  0  0  0  0  0  0  0  0  0  0  0  0  0  0  0  0  33 33 0  33 33 33 33 33 0  33 33 0  0  0  0  0  0  0  0  0  0  0  0  0  0  0  0  0  48 48 48 48 0  0  0  0  0  0  0  0  0  0  0  0  0  0  0  0  0  0  0  0  0  0  0  0  0  0  0  0  0  0  0  0  0  0  0  0  0  0  0  0  0  0  0  0  0  0  0  0  0  0  0  0  0  0  0  0  0  0  0  0  0  0  0  0  0  0  0  0  0  33 33 33 33 33 33 33 33 33 33 0  0  33 33 33 33 33 33 33 33 33 33 0  0  0  0  0  0  0  0  0  0  0  0  38 36 43 0  0  0  33 33 33 33 33 33 33 33 33 0  0  0  0  0  0  0  0  0  0  0  0  0  0  0  0  0  0  0  0  0  0  57 58 0  57 58 0  0  0  0  0  0  0  0  0  0  0  0  0  0  0  0  0  0  0  0  0  33 33 33 33 33 33 33 33 33 33 0  0  0  0  0  0  0  0  0  38 43 0  38 43 0  40 42 0  0  0  0  0  0  0  0  0  0  0  0  0  0  0  0  0  0  0  0  0  0  0  0  0  0  0  0  0  0  0  0  0  0  0  0  0  0  0  0  0  0  0  0  0  0  0  0  0  0  0  0  0  0  0  0  0  0  0  0  0  0  0  0  0  0  0  0  0  0  0  26 0  0  0  0  33 33 33 33 33 0  0  0  0  0  0  0  33 33 33 33 33 0  0  0  0  0  38 36 36 36 43 0  0  0  0  0  0  0  0  0  0  0  0  0  0  0  0  0  0  0  0  0  0  0  0  0  0  0  0  0  0  0  0  0  0  0  0  0  0  0  0  0  0  0  0  0  0  0  0  0  0  0  0  0  0  0  0  0  0  0  0  0  0  40 41 41 41 41 41 41 42 0  0  0  0  0  0  0  0  0  0  0  0  0  0  0  0  0  0  0  0  0  0  0  0  0  0  0  0  0  0  0  0  0  0  0  0  0  0  0  0  0  0  0  0  0  0  0  0  0  0  0  0  0  0  0  0  0  0  0  0  0  0  38 36 36 43 
   36 43 0  0  0  0  0  0  0  0  0  0  0  0  0  0  0  0  0  0  0  0  0  0  0  0  0  0  0  0  0  0  0  0  0  0  35 39 0  35 37 37 37 39 0  35 39 0  0  0  0  0  0  0  0  0  0  0  0  0  0  0  0  0  0  0  0  0  0  0  0  0  0  0  0  0  0  0  0  0  0  0  0  0  0  0  0  0  0  0  0  0  0  0  0  0  0  0  0  0  33 33 33 33 33 0  0  0  0  0  0  0  0  0  0  0  0  0  0  0  0  0  0  0  0  0  0  0  0  0  0  0  0  0  0  0  0  35 37 37 37 37 37 37 37 37 39 0  0  35 37 37 37 37 37 37 37 37 39 0  0  0  0  0  0  0  0  0  0  0  0  40 36 43 0  0  0  37 37 37 37 37 37 37 37 37 0  0  0  0  0  0  0  0  0  0  0  0  0  0  0  0  0  0  0  57 58 0  59 60 0  59 60 0  57 58 0  0  0  0  0  0  0  0  0  0  0  0  0  0  0  0  0  0  35 37 37 37 37 37 37 37 37 39 0  0  0  0  0  0  0  0  33 38 43 0  40 42 0  0  0  0  0  0  0  0  0  0  0  0  0  0  33 33 33 33 33 0  0  0  33 33 33 33 33 0  0  0  33 33 33 33 33 0  0  0  0  0  0  0  0  0  0  0  0  0  0  0  0  0  0  0  0  0  0  0  0  0  0  0  0  0  0  0  0  0  0  0  0  0  0  0  0  0  0  0  0  35 37 37 37 39 0  0  0  0  0  0  0  35 37 37 37 39 0  0  0  0  0  38 36 36 36 43 0  0  0  0  0  33 33 33 33 33 0  0  0  0  0  0  0  0  0  0  0  0  0  0  0  0  0  0  0  0  0  0  0  0  0  0  0  0  0  0  0  0  0  0  0  0  0  0  0  0  0  0  0  0  0  0  0  0  0  0  0  0  0  0  0  0  0  0  0  0  0  0  0  0  0  0  0  0  0  0  0  0  0  0  0  0  0  0  0  0  0  0  0  0  0  0  0  0  0  0  0  0  0  0  0  0  0  0  0  0  0  0  0  0  0  0  0  0  0  0  0  0  0  0  0  0  0  0  0  0  0  0  40 36 36 43 
   36 43 0  0  0  0  0  0  0  0  0  0  0  0  0  0  0  0  0  0  0  0  0  0  0  0  0  0  0  0  26 0  0  0  0  0  38 43 33 38 41 41 41 43 33 38 43 0  0  0  0  0  0  0  0  0  0  0  0  0  0  0  0  0  0  0  0  0  0  0  0  0  0  0  0  0  0  0  0  0  0  0  0  0  0  0  0  0  0  0  0  0  0  0  0  0  0  0  0  0  35 37 37 37 39 0  0  0  0  0  0  0  0  0  0  0  0  0  0  0  0  0  0  0  0  0  0  0  0  0  0  57 58 0  0  0  0  40 41 41 41 41 41 41 41 41 42 0  0  40 41 41 41 41 41 41 41 41 42 0  0  0  0  0  0  0  0  0  0  0  0  0  38 36 0  0  0  40 41 41 41 41 41 41 41 42 0  0  0  0  0  0  0  0  0  0  0  0  0  0  0  0  0  0  0  59 60 0  59 60 0  59 60 0  59 60 0  0  0  0  0  0  0  0  0  0  0  0  0  0  0  0  0  0  40 41 41 41 41 41 41 41 41 42 0  0  0  0  0  0  0  0  35 36 43 0  0  0  0  0  0  0  33 33 33 33 33 33 33 33 33 0  35 37 37 37 39 0  26 0  35 37 37 37 39 0  26 0  35 37 37 37 39 0  0  0  33 33 33 33 33 0  0  0  33 33 33 33 33 0  0  0  0  0  0  0  0  0  0  0  0  0  0  0  0  0  0  26 0  0  0  0  0  0  0  0  0  38 36 36 36 43 0  0  0  0  0  0  0  38 36 36 36 43 0  0  0  0  0  38 36 36 36 43 0  0  33 33 0  35 37 37 37 39 0  33 33 0  0  0  0  33 33 33 0  0  0  0  0  0  0  0  0  0  0  0  0  0  0  0  0  0  0  0  0  0  0  0  0  0  0  0  0  0  0  0  0  0  0  0  0  0  0  33 33 33 33 33 33 33 33 33 33 33 33 33 0  0  0  0  0  0  0  0  0  0  0  0  0  0  0  0  0  0  0  0  0  0  0  0  0  0  0  0  0  0  0  0  33 33 33 33 33 0  0  0  0  0  0  0  0  0  0  0  0  0  0  0  0  33 33 33 0  0  0  0  0  40 41 42 
   36 43 0  0  0  0  0  0  0  0  0  0  0  0  0  0  0  0  0  0  0  0  0  0  48 0  48 0  0  0  0  0  0  0  0  0  40 41 41 42 0  0  0  40 41 41 42 0  0  0  0  0  0  0  0  0  0  0  0  48 0  0  0  0  0  0  0  0  0  0  0  0  48 0  0  0  0  0  0  0  0  0  0  0  0  0  0  0  0  0  0  0  0  0  0  0  0  0  0  0  38 36 36 36 43 0  0  0  33 33 33 33 33 0  0  0  0  0  0  0  0  0  0  0  0  0  0  0  57 58 0  59 60 0  0  0  0  0  0  0  0  0  0  0  0  0  0  0  0  0  0  0  0  0  0  0  0  0  0  0  0  0  0  0  0  0  0  0  0  0  0  0  38 36 37 0  0  0  0  0  0  0  0  0  0  0  0  0  0  0  0  0  0  0  0  0  0  0  0  0  0  0  0  33 33 59 60 33 59 60 33 59 60 33 59 60 33 0  0  0  0  0  0  0  0  0  0  0  0  0  0  0  0  0  0  0  0  0  0  0  0  0  0  0  0  0  0  0  0  0  0  33 38 36 43 0  0  0  0  0  0  26 35 37 37 37 37 37 37 37 39 0  38 36 36 36 43 0  0  0  38 36 36 36 43 0  0  0  38 36 36 36 43 0  0  0  35 37 37 37 39 0  0  0  35 37 37 37 39 0  0  0  0  0  0  0  0  0  0  0  0  0  0  0  0  0  0  0  0  0  0  0  33 33 33 33 33 38 36 36 36 43 0  0  0  0  0  0  0  40 41 41 41 42 0  0  0  0  0  40 41 41 41 42 0  0  35 39 0  38 36 36 36 43 0  35 39 0  0  0  0  35 37 39 0  0  0  0  0  0  0  0  0  0  0  0  0  0  0  0  0  0  33 33 0  0  0  0  0  0  0  0  0  0  0  0  33 33 0  0  0  0  0  35 37 37 37 37 37 37 37 37 37 37 37 39 0  0  0  0  0  0  0  0  0  0  0  0  0  0  0  0  0  0  0  0  0  0  27 28 28 28 28 29 0  0  0  0  35 37 37 37 39 0  0  0  0  0  0  0  0  0  0  0  0  0  0  0  0  35 37 39 0  0  0  0  0  0  0  0  
   36 43 0  0  0  0  0  0  0  0  0  0  0  0  0  0  0  0  0  0  0  0  48 0  48 0  48 0  48 0  0  0  48 0  0  0  0  0  0  0  0  0  0  0  0  0  0  0  0  0  0  0  0  0  0  0  0  0  48 48 0  0  0  0  0  0  0  0  0  0  0  0  48 0  0  0  0  0  0  0  0  50 49 0  0  0  0  0  0  0  0  33 33 33 33 33 0  0  0  0  40 41 41 41 42 0  0  0  35 37 37 37 39 0  0  0  0  0  0  0  0  0  0  0  0  57 58 0  59 60 0  59 60 0  0  0  0  0  0  0  0  0  0  0  0  0  0  0  0  0  0  0  0  0  0  0  0  0  0  0  0  0  0  0  0  0  0  0  0  0  0  0  40 41 42 0  0  0  0  0  0  0  0  0  0  0  0  0  0  33 33 33 33 33 33 33 33 33 0  0  0  0  0  37 37 37 37 37 37 37 37 37 37 37 37 37 37 0  0  0  0  33 33 33 33 33 33 33 33 33 33 33 0  0  33 33 33 33 33 33 33 33 33 33 0  0  33 33 33 33 33 37 36 36 43 0  0  0  0  0  0  0  38 36 36 36 36 36 36 36 43 0  38 36 36 36 43 0  0  0  38 36 36 36 43 0  0  0  38 36 36 36 43 0  0  0  38 36 36 36 43 0  0  0  38 36 36 36 43 0  0  0  0  0  0  0  0  0  0  0  0  0  0  0  0  0  0  0  0  0  0  0  35 37 37 37 37 36 36 36 36 43 0  0  0  0  0  0  0  0  0  0  0  0  0  0  0  0  0  0  0  0  0  0  0  0  38 36 0  40 41 41 41 42 0  38 36 0  0  0  0  40 41 42 0  0  0  0  0  0  0  0  0  0  0  33 33 0  0  0  0  0  35 39 0  0  0  0  0  48 48 0  0  0  0  0  35 39 0  0  0  0  0  40 36 36 36 36 36 36 36 36 36 36 36 43 0  0  0  0  0  0  0  0  0  0  0  0  27 28 28 28 28 29 0  0  0  0  0  0  0  0  0  0  0  0  0  0  38 36 36 36 43 0  0  0  0  33 33 33 0  0  0  0  0  0  0  0  33 38 36 43 33 0  0  0  0  0  0  0  
   36 43 0  0  0  0  0  0  0  0  0  0  0  0  0  0  0  0  0  0  48 0  48 0  48 0  48 0  48 0  0  0  48 0  0  0  0  0  0  0  0  0  0  0  0  0  0  0  0  0  0  0  0  0  0  0  0  48 48 48 0  0  0  0  0  0  0  0  0  0  0  0  48 48 0  0  0  0  0  0  0  51 52 48 0  0  0  0  0  0  0  35 37 37 37 39 0  0  0  0  0  0  0  0  0  0  0  0  38 36 36 36 43 0  0  0  33 33 33 33 33 33 33 33 33 59 60 33 59 60 33 59 60 0  0  0  33 33 33 33 33 33 33 33 33 33 33 33 33 33 33 33 33 33 33 33 33 0  0  0  0  0  0  0  0  0  0  0  0  0  0  0  0  0  0  0  0  0  0  0  0  0  0  0  0  0  0  0  0  37 37 37 37 37 37 37 37 39 0  0  0  0  0  40 41 41 41 41 41 41 41 41 41 41 41 41 42 0  0  0  0  37 37 37 37 37 37 37 37 37 37 39 57 58 35 37 37 37 37 37 37 37 37 39 57 58 35 37 37 37 37 36 36 36 43 0  0  0  0  0  0  0  38 36 36 36 36 36 36 36 43 0  38 36 36 36 43 33 33 33 38 36 36 36 43 33 33 33 38 36 36 36 43 0  0  0  40 41 41 41 42 0  0  0  40 41 41 41 42 0  0  0  0  0  0  0  0  0  0  0  0  0  0  0  0  0  0  33 33 33 33 33 38 36 36 36 36 36 36 36 36 43 0  0  0  0  0  0  0  0  0  0  0  0  0  0  0  0  0  0  0  0  0  0  0  0  40 42 0  0  0  0  0  0  0  40 42 0  0  0  0  0  0  0  0  0  0  0  0  33 33 0  0  0  0  35 39 0  0  0  0  0  40 42 0  0  0  0  0  0  0  0  0  0  0  0  40 42 0  0  0  0  0  0  40 36 36 36 36 36 36 36 36 36 36 43 0  0  0  0  0  0  0  0  0  0  0  0  0  0  0  0  0  0  0  0  0  0  0  0  0  0  0  0  0  0  0  0  38 36 36 36 43 0  0  0  0  35 37 39 0  0  0  0  33 33 33 33 35 36 36 36 39 33 33 33 33 33 33 33 
   36 43 33 33 33 33 33 33 33 33 33 33 33 33 33 33 33 33 48 33 48 33 48 33 48 33 48 33 48 33 33 33 48 33 33 33 33 33 33 33 33 33 33 33 33 33 33 33 33 33 33 33 33 33 33 33 48 48 48 48 33 33 33 33 33 33 33 33 33 33 33 33 48 48 33 33 33 33 33 33 33 50 49 48 48 33 33 33 33 33 33 38 36 36 36 43 0  0  0  0  0  0  0  0  0  0  0  0  40 41 41 41 42 0  0  0  35 37 37 37 37 37 37 37 39 59 60 35 59 60 35 59 60 0  0  0  35 37 37 37 37 37 37 37 37 37 37 37 37 37 37 37 37 37 37 37 39 0  0  0  0  0  0  0  33 33 33 33 33 33 33 33 33 33 33 33 33 33 33 33 33 33 33 33 48 48 0  0  0  38 36 36 36 36 36 36 36 43 0  0  0  33 33 33 33 33 33 33 33 33 33 33 33 33 33 33 33 33 33 0  0  38 36 36 36 36 36 36 36 36 36 43 59 60 38 36 36 36 36 36 36 36 36 43 59 60 38 36 36 36 36 36 36 36 43 0  0  0  0  0  0  33 36 36 36 36 36 36 36 36 43 0  38 36 36 36 36 37 37 37 36 36 36 36 36 37 37 37 36 36 36 36 43 0  0  0  0  0  0  0  0  0  0  0  0  0  0  0  0  0  0  0  0  0  0  0  0  0  0  0  0  0  33 33 33 33 33 35 37 37 37 37 36 36 36 36 36 36 36 36 36 43 0  0  0  0  0  0  0  33 33 33 33 33 33 33 33 33 33 33 33 33 33 33 33 33 33 33 33 33 0  0  0  33 33 33 33 33 33 33 33 33 33 33 33 33 0  0  0  35 39 0  0  0  0  40 42 0  0  0  0  0  0  0  0  0  0  0  0  0  0  0  0  0  0  0  0  0  0  0  0  0  0  0  0  40 41 36 36 36 36 36 36 36 36 43 0  0  27 28 28 28 28 29 0  0  0  0  0  0  0  0  0  0  0  0  0  0  0  0  0  0  0  0  0  0  0  0  38 36 36 36 43 0  0  0  0  38 36 43 0  0  0  0  35 37 37 37 36 36 36 36 36 37 37 37 37 37 37 37 
   36 36 37 37 37 37 37 37 37 37 37 37 37 37 37 37 37 37 37 37 37 37 37 37 37 37 37 37 37 37 37 37 37 37 37 37 37 37 37 37 37 37 37 37 37 37 37 37 37 37 37 37 37 37 37 37 37 37 37 37 37 37 37 37 37 37 37 37 37 37 37 37 37 37 37 37 37 37 37 37 39 51 52 35 37 37 37 37 37 37 37 36 36 36 36 43 0  0  0  0  0  0  0  0  0  0  0  0  0  0  0  0  0  0  0  0  38 36 36 36 36 36 36 36 43 59 60 38 59 60 38 59 60 0  0  0  40 41 41 41 41 41 41 41 41 41 41 41 41 41 41 41 41 41 41 41 42 0  0  0  0  0  0  0  35 37 37 37 37 37 37 37 37 37 37 37 37 37 37 37 37 37 37 37 37 37 0  0  0  38 36 36 36 36 36 36 36 43 0  0  0  37 37 37 37 37 37 37 37 37 37 37 37 37 37 37 37 37 39 0  0  38 36 36 36 36 36 36 36 36 36 36 37 37 36 36 36 36 36 36 36 36 36 36 37 37 36 36 36 36 36 36 36 36 43 0  0  0  0  0  0  35 36 36 36 36 36 36 36 36 43 0  38 36 36 36 36 36 36 36 36 36 36 36 36 36 36 36 36 36 36 36 43 0  0  0  0  0  0  0  0  0  0  0  0  0  0  0  0  0  0  0  0  0  0  0  0  33 33 33 33 33 35 37 37 37 37 36 36 36 36 36 36 36 36 36 36 36 36 36 36 43 0  0  0  0  0  0  0  35 37 37 37 37 37 37 37 37 37 37 37 37 37 37 37 37 37 37 37 39 0  0  0  35 37 37 37 37 37 37 37 37 37 37 37 37 0  0  0  40 42 0  0  0  0  0  0  0  0  0  0  0  0  0  0  0  0  0  0  0  0  0  0  0  0  0  0  0  0  0  0  0  0  0  0  0  0  40 36 36 36 36 36 36 36 43 0  0  0  0  0  0  0  0  0  0  0  0  0  0  0  0  0  0  0  0  0  0  0  0  0  0  0  0  0  0  0  0  38 36 36 36 43 0  0  0  0  38 36 43 0  0  0  0  38 36 36 36 36 36 36 36 36 36 36 36 36 36 36 36 
   36 36 36 36 36 36 36 36 36 36 36 36 36 36 36 36 36 36 36 36 36 36 36 36 36 36 36 36 36 36 36 36 36 36 36 36 36 36 36 36 36 36 36 36 36 36 36 36 36 36 36 36 36 36 36 36 36 36 36 36 36 36 36 36 36 36 36 36 36 36 36 36 36 36 36 36 36 36 36 36 36 37 37 36 36 36 36 36 36 36 36 36 36 36 36 43 0  0  0  0  0  0  0  0  0  0  0  0  0  0  0  0  0  0  0  0  38 36 36 36 36 36 36 36 43 59 60 38 59 60 38 59 60 0  0  0  0  0  0  0  0  0  0  0  0  0  0  0  0  0  0  0  0  0  0  0  0  0  0  0  0  0  0  0  38 36 36 36 36 36 36 36 36 36 36 36 36 36 36 36 36 36 36 36 36 36 0  0  0  38 36 36 36 36 36 36 36 43 0  0  0  38 36 36 36 36 36 36 36 36 36 36 36 36 36 36 36 36 43 0  0  38 36 36 36 36 36 36 36 36 36 36 36 36 36 36 36 36 36 36 36 36 36 36 36 36 36 36 36 36 36 36 36 36 43 0  0  0  0  0  0  38 36 36 36 36 36 36 36 36 43 0  38 36 36 36 36 36 36 36 36 36 36 36 36 36 36 36 36 36 36 36 43 0  0  0  0  0  0  0  0  0  0  0  0  0  0  0  0  0  0  0  0  0  0  0  0  35 37 37 37 37 36 36 36 36 36 36 36 36 36 36 36 36 36 36 36 36 36 36 36 43 0  0  0  0  0  0  0  38 36 36 36 36 36 36 36 36 36 36 36 36 36 36 36 36 36 36 36 43 0  0  0  38 36 36 36 36 36 36 36 36 36 36 36 36 0  0  0  0  0  0  0  0  0  0  0  0  0  0  0  0  0  0  0  0  0  0  0  0  0  0  0  0  0  0  0  0  0  0  0  0  0  0  0  0  0  0  40 36 36 36 36 36 36 43 0  0  0  0  0  0  0  0  0  0  0  0  0  0  0  0  0  0  0  0  0  0  0  0  0  0  0  0  0  0  0  0  38 36 36 36 43 0  0  0  0  38 36 43 0  0  0  0  36 36 36 36 36 36 36 36 36 36 36 36 36 36 36 36 
      )

  (objects
  )
   )


;; EOF ;;
