;; Generated by Windstille Editor
(supertux-level
  (version 1)
  (name "Hello World")
  (width  500)
  (height 15)
  (background "arctis.png")
  (music  "Mortimers_chipdisko.mod")
  (bkgd_red    150)
  (bkgd_green  200)
  (bkgd_blue   255)
  (time  500)
  (gravity  10)
  (particle_system "snow")
  (theme "antarctica")
  (interactive-tm
   36 36 43 0  0  0  38 36 36 36 36 36 36 36 36 36 36 36 36 36 36 36 36 36 36 36 36 36 36 36 36 36 36 36 36 36 36 36 36 36 36 36 36 36 36 36 36 36 36 36 36 36 36 36 36 36 36 36 36 36 36 36 36 36 36 36 36 36 36 36 36 36 36 36 36 36 36 36 36 36 36 36 36 36 36 36 36 36 36 36 36 36 36 36 36 36 36 36 36 36 36 36 36 36 36 36 36 36 36 36 36 36 36 36 36 36 36 36 36 36 36 36 36 36 36 36 36 36 36 36 36 36 36 36 36 36 36 36 36 36 36 36 36 36 36 36 36 36 36 36 36 36 36 36 36 36 36 36 36 36 36 36 36 36 36 36 36 36 36 36 36 36 36 36 36 36 36 36 36 36 36 36 36 36 36 36 36 36 36 36 36 36 36 36 36 36 36 36 36 36 36 36 36 36 36 36 36 36 36 36 36 36 36 36 36 36 36 36 36 36 36 36 36 36 36 36 36 36 36 36 36 36 36 36 36 36 36 36 36 36 36 36 36 36 36 36 36 36 36 36 36 36 36 36 36 36 36 36 36 36 36 36 36 36 36 36 36 36 36 36 36 36 36 36 36 36 36 36 36 36 36 36 36 36 36 36 36 36 36 36 36 36 36 36 36 36 36 36 36 36 36 36 36 36 36 36 36 36 36 36 36 36 36 36 36 36 36 36 36 36 36 36 36 36 36 36 36 36 36 36 36 36 36 36 36 36 36 36 36 36 36 36 36 36 36 36 36 36 36 36 36 36 36 36 36 36 36 36 36 36 36 36 36 36 36 36 36 36 36 36 36 36 36 36 36 36 36 36 36 36 36 36 36 36 36 36 36 36 36 36 36 36 36 36 36 36 36 36 36 36 36 36 36 36 36 36 36 36 36 36 36 36 36 36 36 36 36 36 36 36 36 36 36 36 36 36 36 36 36 36 36 36 36 36 36 36 36 36 36 36 36 36 36 36 36 36 36 36 36 36 36 36 36 36 36 36 36 36 36 36 36 36 36 36 36 36 36 36 36 36 36 36 36 36 36 36 36 36 36 36 36 36 36 36 36 36 36 36 36 36 36 36 36 36 36 36 36 36 36 36 
   36 36 43 0  0  0  38 36 36 36 36 36 36 36 36 36 36 36 36 36 36 36 36 36 36 36 36 36 36 36 36 36 36 36 36 36 36 36 36 36 36 36 36 36 36 36 36 36 36 36 36 36 36 36 36 36 36 36 36 36 36 36 36 36 36 36 36 36 36 36 36 36 36 36 36 36 36 36 36 36 36 36 36 36 36 36 36 36 36 36 36 36 36 36 36 36 36 36 36 36 36 36 36 36 36 36 36 36 36 36 36 36 36 36 36 36 36 36 41 41 41 41 41 41 41 41 41 41 41 41 41 41 41 41 41 41 41 41 41 41 41 41 41 41 41 41 41 41 41 41 41 41 41 41 41 41 41 41 41 41 41 41 41 41 41 41 41 41 41 41 41 41 41 41 41 41 41 41 41 41 41 41 41 41 41 41 41 41 41 41 41 41 41 41 41 41 41 41 41 41 41 41 41 41 41 41 41 41 41 41 41 41 41 41 41 41 41 41 41 41 41 41 41 41 41 41 41 41 41 41 41 41 41 41 41 41 41 36 36 36 36 36 36 36 36 36 41 41 41 41 41 41 41 41 41 41 41 41 41 41 41 41 41 41 41 41 41 41 41 41 41 41 41 41 41 41 41 41 41 41 41 41 41 41 41 41 41 41 41 41 41 41 41 41 41 41 41 41 41 41 41 41 41 41 41 41 41 41 41 41 41 41 41 41 41 41 41 41 41 41 41 41 41 41 41 41 41 41 41 41 41 41 41 41 41 41 41 41 41 41 41 41 41 41 41 41 41 41 41 41 41 41 41 41 41 41 41 41 41 41 41 41 41 41 41 41 41 41 41 41 41 41 41 41 41 41 41 41 41 41 41 41 41 41 41 41 41 41 41 41 41 41 41 41 41 41 41 41 41 41 41 41 41 41 41 41 41 41 41 41 41 36 36 36 36 36 36 36 36 36 36 36 36 36 36 36 36 36 36 36 36 36 36 36 36 36 36 41 41 41 41 41 41 41 41 41 41 41 41 41 41 41 41 41 41 41 41 41 41 41 41 41 41 41 41 41 41 41 41 41 41 41 41 41 41 41 41 41 41 41 41 41 41 41 41 41 41 41 41 41 41 41 41 41 41 41 41 36 36 36 
   36 36 43 0  0  0  40 41 41 41 41 41 41 41 41 41 41 41 41 41 41 41 41 41 41 41 41 41 41 41 41 41 41 41 41 41 41 41 41 41 41 41 41 41 41 41 41 41 41 41 41 41 41 41 41 41 41 41 41 41 41 41 41 41 41 41 41 41 41 41 41 41 41 41 41 36 36 36 36 36 36 36 36 36 36 36 36 36 36 36 36 36 36 36 36 36 36 36 36 36 36 36 36 36 36 36 36 36 36 36 36 36 36 36 36 36 36 36 0  0  0  0  0  0  0  0  0  0  0  0  0  0  0  0  0  0  0  0  0  0  0  0  0  0  0  0  0  0  0  0  0  0  0  0  0  0  0  0  0  0  0  0  0  0  0  0  0  0  0  0  0  0  0  0  0  0  0  0  0  0  0  0  0  0  0  0  0  0  0  0  0  0  0  0  0  0  0  0  0  0  0  0  0  0  0  0  0  0  0  0  0  0  0  0  0  0  0  0  0  0  0  0  0  0  0  0  0  0  0  0  0  0  0  0  0  0  0  40 36 36 36 36 36 36 36 36 42 0  0  0  0  0  0  0  0  0  0  0  0  0  0  0  0  0  0  0  0  0  0  0  0  0  0  0  0  0  0  0  0  0  0  0  0  0  0  0  0  0  0  0  0  0  0  0  0  0  0  0  0  0  0  0  0  0  0  0  0  0  0  0  0  0  0  0  0  0  0  0  0  0  0  0  0  0  0  0  0  0  0  0  0  0  0  0  0  0  0  0  0  0  0  0  0  0  0  0  0  0  0  0  0  0  0  0  0  0  0  0  0  0  0  0  0  0  0  0  0  0  0  0  0  0  0  0  0  0  0  0  0  0  0  0  0  0  0  0  0  0  0  0  0  0  0  0  0  0  0  0  0  0  0  0  0  0  0  0  0  0  0  0  0  38 36 36 36 36 36 36 36 36 36 36 36 36 36 36 36 36 36 36 36 36 36 36 36 36 43 0  0  0  0  0  0  0  0  0  0  0  0  0  0  0  0  0  0  0  0  0  0  0  0  0  0  0  0  0  0  0  0  0  0  0  0  0  0  0  0  0  0  0  0  0  0  0  0  0  0  0  0  0  0  0  0  0  0  0  0  38 36 36 
   36 36 43 0  0  0  0  0  0  0  0  0  0  0  0  0  0  0  0  0  0  0  0  0  0  0  0  0  0  0  0  0  0  0  0  0  0  0  0  0  0  0  0  0  0  0  0  0  0  0  0  0  0  0  0  0  0  0  0  0  0  0  0  0  0  0  0  0  0  0  0  0  0  0  0  38 36 36 36 36 36 36 36 36 36 36 36 36 36 36 36 36 36 36 41 41 41 41 41 41 41 41 41 41 41 41 41 41 41 41 41 41 41 41 41 41 41 42 0  0  0  0  0  0  0  0  0  0  0  0  0  0  0  0  0  0  0  0  0  0  0  0  0  0  0  0  0  0  0  0  0  0  0  0  0  0  0  0  0  0  0  0  0  0  0  0  0  0  0  0  0  0  0  0  0  0  0  0  0  0  0  0  0  0  0  0  0  0  0  0  0  0  0  0  0  0  0  0  0  0  0  0  0  0  0  0  0  0  0  0  0  0  0  0  0  0  0  0  0  0  0  0  0  0  0  0  0  0  0  0  0  0  0  0  0  0  0  0  40 36 36 36 36 36 36 42 0  0  0  0  0  0  0  0  0  0  0  0  0  0  0  0  0  0  0  0  0  0  0  0  0  0  0  0  0  0  0  0  0  0  0  0  0  0  0  0  0  0  0  0  0  0  0  0  0  0  0  0  0  0  0  0  0  0  0  0  0  0  0  0  0  0  0  0  0  0  0  0  0  0  0  0  0  0  0  0  0  0  0  0  0  0  0  0  0  0  0  0  0  0  0  0  0  0  0  0  0  0  0  0  0  0  0  0  0  0  0  0  0  0  0  0  0  0  0  0  0  0  0  0  0  0  0  0  0  0  0  0  0  0  0  0  0  0  0  0  0  0  0  0  0  0  0  0  0  0  0  0  0  0  0  0  0  0  0  0  0  0  0  0  0  38 36 36 36 36 36 36 36 36 36 36 36 36 36 36 36 36 36 36 36 36 36 36 36 36 43 0  0  0  0  0  0  0  0  0  0  0  0  0  0  0  0  0  0  0  0  0  0  0  0  0  0  0  0  0  0  0  0  0  0  0  0  0  0  0  0  0  0  0  0  0  0  0  0  0  0  0  0  0  0  0  0  0  0  0  0  38 36 36 
   36 36 43 0  0  0  0  0  0  0  0  0  0  0  0  0  0  0  0  0  0  0  0  0  0  0  0  0  0  0  0  0  26 0  0  0  0  0  0  0  0  0  0  0  26 0  0  0  0  0  0  0  0  0  0  0  0  0  0  0  0  0  0  0  0  0  0  0  0  0  0  0  0  0  0  38 36 36 36 36 36 36 36 36 36 36 36 36 36 36 36 36 36 43 0  0  0  0  0  0  0  0  0  0  0  0  0  0  0  0  0  0  0  0  0  0  0  0  0  0  0  0  0  0  0  0  0  0  0  0  0  0  0  0  0  0  0  0  0  0  0  0  0  0  0  0  0  0  0  0  0  0  0  0  0  0  0  0  27 28 29 27 28 28 29 27 28 29 0  0  0  0  0  0  0  0  0  0  0  0  0  0  0  0  0  0  0  0  0  26 26 0  0  0  0  0  0  0  0  0  0  0  0  0  0  0  0  0  0  0  0  0  0  0  0  0  0  0  0  0  0  0  0  0  0  0  0  0  0  0  0  0  0  0  0  0  0  0  0  0  40 41 41 42 0  0  0  0  0  0  0  0  0  0  0  0  0  0  0  0  0  0  0  0  0  0  0  0  0  0  0  0  0  0  0  0  0  0  0  0  0  0  0  0  0  0  0  0  0  0  0  0  0  0  0  0  0  0  0  0  0  0  0  0  0  0  0  0  0  0  0  0  0  0  0  0  0  0  0  0  0  0  0  0  0  0  0  0  0  0  0  0  0  0  0  0  0  0  0  0  0  0  0  0  0  0  0  0  0  0  0  0  0  0  0  0  0  0  0  0  0  0  0  0  0  0  0  0  0  0  0  0  0  0  0  0  0  0  0  0  0  0  0  0  0  0  0  0  32 32 0  32 0  32 0  32 0  32 0  32 0  32 0  32 0  0  0  0  0  0  0  40 41 41 41 41 41 41 41 41 41 41 41 41 41 41 41 41 41 41 41 41 41 41 41 41 42 0  0  0  0  0  0  0  0  0  0  0  0  0  0  0  0  0  0  0  0  0  0  0  0  0  0  0  0  0  0  0  0  0  0  0  0  0  0  0  0  0  0  0  0  0  0  0  0  0  0  0  0  0  0  0  0  0  0  0  0  38 36 36 
   36 36 43 0  0  0  0  0  0  0  0  0  0  0  0  0  0  0  0  0  0  0  0  0  0  0  0  0  0  0  0  0  0  0  0  0  0  0  0  0  0  0  0  0  0  0  0  0  0  0  0  0  0  0  0  0  0  0  0  0  0  0  0  0  0  0  0  0  0  0  0  0  0  0  0  38 36 36 36 36 36 36 36 36 36 36 36 36 36 36 36 36 36 43 0  0  0  0  0  0  0  0  0  0  0  26 0  0  0  0  0  0  0  0  0  0  0  0  0  0  0  0  0  0  0  0  0  0  0  0  0  0  0  0  0  0  0  0  0  0  0  0  0  0  0  0  0  0  0  0  0  0  0  0  0  0  0  27 28 29 0  0  0  0  0  0  27 28 29 0  0  0  0  0  0  0  0  0  0  0  0  0  0  0  0  0  0  0  0  0  0  0  0  0  0  0  0  0  0  0  0  0  0  0  0  0  0  0  0  0  0  0  0  0  0  0  0  0  0  0  0  0  0  0  0  0  0  0  0  0  0  0  0  26 0  0  0  0  0  0  0  0  0  0  0  0  0  0  0  0  0  0  0  0  0  0  0  0  0  0  0  0  0  0  0  0  0  0  0  0  0  0  0  0  0  0  0  0  0  0  0  0  0  0  0  0  0  0  0  0  0  0  0  0  0  0  0  0  0  0  0  0  0  0  0  0  0  0  0  0  0  0  0  0  0  0  0  0  0  0  0  0  0  0  0  0  0  0  0  0  0  0  0  0  0  0  0  0  0  0  0  0  0  0  0  0  0  0  0  0  0  0  0  0  0  0  0  0  0  0  0  0  0  0  0  0  0  0  0  0  0  0  0  0  0  0  0  0  0  0  0  0  0  0  0  0  0  32 35 39 0  35 0  35 0  35 0  35 0  35 0  35 0  35 0  0  0  0  0  0  0  0  0  0  0  0  0  0  0  0  0  0  0  0  0  0  0  0  0  0  0  0  0  0  0  0  0  0  0  0  0  0  0  0  0  0  0  0  0  0  0  0  0  0  0  0  0  0  0  0  0  0  0  0  0  0  0  0  0  0  0  0  0  0  0  0  0  0  33 33 33 33 0  0  0  0  0  0  0  0  0  0  0  0  0  0  0  38 36 36 
   36 36 43 0  0  0  0  0  0  0  0  0  0  32 32 32 32 32 32 32 32 32 32 32 32 32 32 32 0  0  0  0  0  0  0  0  0  32 32 32 0  0  0  0  0  0  0  0  0  32 32 32 32 32 32 32 32 32 32 32 32 32 32 32 0  0  0  0  0  0  0  0  0  0  0  40 41 41 41 41 41 41 41 41 41 41 41 41 41 41 41 41 41 42 0  0  0  0  0  0  0  0  0  0  0  0  0  0  0  0  0  0  0  0  0  0  0  0  0  0  0  0  0  0  0  0  0  0  0  0  0  0  0  0  0  0  0  0  0  0  0  0  0  0  0  0  0  0  0  0  0  0  0  0  0  0  27 28 29 0  0  0  0  0  0  0  0  27 28 29 0  0  0  0  0  0  0  0  0  0  0  0  0  0  0  0  0  0  0  0  0  0  0  0  0  0  0  27 28 29 0  0  0  0  0  0  0  0  0  0  0  0  0  0  0  0  0  0  0  0  0  0  0  0  0  0  0  0  0  0  0  0  0  0  0  0  0  0  0  0  0  0  0  0  0  0  0  0  0  0  0  0  0  0  0  0  0  0  0  0  0  0  0  0  0  0  0  0  0  0  0  0  0  0  0  0  0  0  0  0  0  0  0  0  0  0  0  0  0  0  0  0  0  0  0  0  0  0  0  0  0  0  0  0  0  0  0  0  0  0  0  0  0  0  0  0  0  0  0  0  0  0  0  0  0  0  0  0  0  0  0  0  0  0  0  0  0  0  0  0  0  0  0  0  0  0  0  0  0  0  0  0  0  0  0  0  0  0  0  0  0  0  0  0  0  0  0  0  0  0  0  0  0  0  0  0  0  0  0  0  0  0  0  0  0  0  32 35 36 43 0  0  0  0  0  0  0  0  0  0  0  0  0  0  0  0  0  0  0  0  0  0  0  0  0  0  0  0  0  0  0  0  0  0  0  0  0  0  0  0  0  0  0  0  0  0  0  0  0  0  0  0  0  0  0  0  0  0  0  0  0  0  0  0  0  0  0  0  0  0  0  0  0  0  0  0  0  0  0  0  0  0  0  0  33 33 33 33 35 37 37 39 0  0  0  0  0  0  0  0  0  0  0  0  0  0  0  38 36 36 
   36 36 43 0  0  0  0  0  0  0  0  0  0  35 37 37 37 37 37 37 37 37 37 37 37 37 37 39 0  0  0  0  0  0  0  32 32 35 37 39 32 32 0  0  0  0  0  0  0  35 37 37 37 37 37 37 37 37 37 37 37 37 37 39 0  0  0  0  0  0  0  0  0  0  0  0  0  0  0  0  0  0  0  0  0  0  0  0  0  0  0  0  0  0  0  0  0  0  0  0  0  0  0  0  0  0  0  0  0  0  0  0  0  0  0  0  0  0  0  0  0  0  0  0  0  0  0  0  0  0  0  0  0  0  0  0  0  0  0  0  0  0  0  0  0  0  0  0  0  0  0  0  0  0  0  27 28 29 0  0  0  0  0  0  0  0  0  0  27 28 29 0  0  0  0  0  0  0  0  0  0  0  0  0  0  0  0  0  0  0  0  0  0  0  0  27 28 29 0  27 28 29 0  0  0  0  0  0  0  0  0  0  0  0  0  0  0  0  0  0  0  0  0  0  0  0  32 32 32 0  0  0  0  0  0  0  0  0  0  0  0  0  0  0  0  0  0  0  0  0  0  0  0  0  0  0  0  0  0  0  0  0  0  0  0  0  0  0  0  0  0  0  0  0  0  0  0  0  0  0  0  0  0  0  0  0  0  0  0  0  0  0  0  0  0  0  0  0  0  0  0  0  0  0  0  0  0  0  0  0  0  0  0  0  0  0  0  0  0  0  0  0  0  0  0  0  0  0  0  0  26 0  0  0  0  0  0  0  0  0  26 0  0  0  0  0  0  0  0  0  26 0  0  0  0  0  0  0  0  0  0  0  0  0  0  0  0  0  0  0  0  0  0  0  0  0  0  0  0  0  0  0  0  0  0  32 35 36 36 43 0  0  0  0  0  0  0  0  0  0  0  0  0  0  0  0  0  0  0  0  0  0  0  0  0  0  0  0  0  0  0  0  0  0  0  0  0  0  0  0  0  0  0  0  0  0  0  0  0  0  0  0  0  0  0  0  0  0  0  0  0  0  0  0  0  0  0  0  0  0  0  0  0  0  0  0  0  0  0  0  33 33 33 33 35 37 37 39 38 36 36 43 0  0  0  0  0  0  0  0  0  0  0  0  0  0  0  38 36 36 
   36 36 43 0  0  0  0  0  0  26 0  0  0  40 41 41 41 41 41 41 41 41 41 41 41 41 41 42 0  0  0  32 32 32 32 35 37 36 36 36 37 39 32 32 32 32 0  0  0  40 41 41 41 41 41 41 41 41 41 41 41 41 41 42 0  0  0  0  0  0  0  0  0  0  0  0  32 32 32 32 32 32 32 32 32 32 32 0  0  0  0  0  0  0  0  0  0  0  0  0  0  0  0  0  0  0  0  0  0  0  0  0  0  0  0  0  0  0  0  0  0  0  0  0  0  0  27 28 28 28 28 28 28 28 28 28 28 29 0  0  0  0  0  0  0  27 28 28 28 28 28 28 28 28 28 28 29 0  0  0  26 0  0  0  0  26 0  0  0  27 28 28 28 28 28 28 28 28 29 0  0  0  0  0  0  27 28 28 28 28 28 28 28 28 28 29 0  0  0  0  0  27 28 29 0  0  0  0  0  0  0  0  0  0  0  0  0  0  0  27 28 28 29 0  0  0  37 37 39 0  0  0  0  0  0  0  0  0  0  0  0  0  0  0  0  0  0  0  0  0  0  26 0  0  0  26 0  0  0  0  0  0  0  0  0  0  0  0  0  0  0  0  0  0  0  0  0  0  0  0  0  0  0  0  0  0  0  0  0  0  0  0  0  0  0  0  0  0  0  0  0  0  0  0  0  0  0  0  0  0  0  0  0  0  0  0  0  0  0  0  0  0  0  0  0  0  0  0  0  0  0  0  0  0  0  0  0  0  0  0  0  0  0  0  0  0  0  0  0  0  0  0  0  0  0  0  0  0  0  0  0  0  0  0  0  0  32 32 32 32 32 32 0  0  0  0  0  0  0  0  0  0  0  0  32 35 36 36 36 43 0  0  0  0  0  0  0  0  0  0  0  0  0  0  0  0  0  0  0  0  0  0  0  0  0  0  0  0  0  0  0  0  0  0  0  0  0  0  0  0  0  0  0  0  0  0  0  0  0  0  0  0  0  0  0  0  0  0  0  0  0  0  0  0  0  0  0  0  0  0  0  0  0  0  0  0  33 33 33 33 35 37 37 39 38 36 36 43 38 36 36 43 0  0  0  0  0  0  0  0  0  0  0  0  0  0  0  38 36 36 
   36 36 43 0  0  0  0  0  0  0  0  0  0  0  0  0  0  0  0  0  0  0  0  0  0  0  0  0  0  0  0  35 37 37 37 36 36 36 36 36 36 36 37 37 37 39 0  0  0  0  0  0  0  0  0  0  0  0  0  0  0  0  0  0  0  0  0  0  0  0  0  0  0  32 32 0  35 37 37 37 37 37 37 37 37 37 39 0  0  0  0  0  0  0  0  0  0  0  0  0  0  0  0  32 32 32 0  0  0  32 32 32 0  0  0  0  0  0  0  0  0  0  0  0  0  0  0  0  0  0  0  0  0  0  0  0  0  0  0  0  0  0  0  0  0  0  0  0  0  0  0  0  0  0  0  0  0  0  0  0  0  0  0  0  0  0  0  0  0  0  0  0  0  0  0  0  0  0  0  0  0  0  0  0  0  0  0  0  0  0  0  0  0  0  0  0  0  0  0  0  0  0  0  0  0  0  0  0  0  0  0  0  0  0  0  0  0  0  0  0  0  0  0  0  0  0  38 36 43 0  0  27 28 28 28 29 0  0  0  0  0  26 26 0  0  0  0  0  0  0  0  0  0  0  0  0  0  0  0  0  0  0  0  0  0  0  0  0  0  0  0  0  0  0  0  0  0  0  0  0  0  0  0  0  0  0  0  0  0  0  0  0  0  0  0  0  0  0  32 32 32 0  0  0  32 32 0  0  0  32 32 0  0  0  0  0  0  0  0  0  0  0  0  0  0  0  0  0  0  0  0  0  0  0  0  0  0  0  0  0  0  0  0  0  0  0  0  0  0  0  0  0  0  0  0  0  0  0  0  0  0  0  0  0  0  0  35 37 37 37 37 37 0  0  0  0  0  0  0  0  0  0  0  32 35 36 36 36 36 43 0  0  0  0  0  0  0  0  0  0  0  0  0  0  0  0  0  0  0  0  0  0  0  0  0  0  0  0  0  33 33 33 33 0  0  33 33 33 33 0  0  33 33 33 33 0  0  0  0  0  0  0  0  0  0  0  0  0  0  0  0  0  0  0  0  0  0  0  0  0  0  0  33 33 33 33 35 37 37 39 38 36 36 43 38 36 36 43 38 36 36 43 0  0  0  0  0  0  0  0  0  0  0  0  0  0  0  38 36 36 
   36 36 43 0  0  0  0  0  0  0  0  0  0  0  0  0  0  0  0  0  0  0  0  0  0  0  0  0  0  0  0  40 41 41 41 41 41 41 41 41 41 41 41 41 41 42 0  0  0  0  0  0  0  0  0  0  0  0  0  0  0  0  0  0  0  0  0  0  0  0  0  0  32 35 39 0  40 41 41 41 41 41 41 41 41 41 42 0  0  0  0  0  0  0  0  0  0  32 32 32 0  0  0  35 37 39 0  0  0  35 37 39 0  0  0  32 32 32 0  0  0  0  0  0  0  0  0  0  0  0  0  0  0  0  0  0  0  0  0  0  0  0  0  0  0  0  0  0  0  0  0  0  0  0  0  0  0  0  0  0  0  0  0  0  0  0  0  0  0  0  0  0  0  0  0  0  0  0  0  0  0  0  0  0  0  0  0  0  0  0  0  0  0  0  0  0  0  0  0  0  0  0  0  0  0  0  0  0  0  0  0  0  0  32 32 32 0  0  0  0  0  0  0  0  32 32 38 36 43 0  0  0  0  0  0  0  0  0  0  0  0  0  0  0  0  0  0  0  0  0  0  0  0  0  0  0  0  0  0  0  0  0  0  0  0  0  0  0  0  0  0  0  0  0  0  0  0  0  0  0  0  0  0  0  0  0  0  0  0  0  0  0  0  32 32 32 0  0  35 37 39 0  0  0  35 39 0  0  0  35 39 0  0  0  32 32 32 32 32 32 32 32 32 32 32 32 32 32 32 32 0  32 32 32 32 32 32 32 32 32 0  32 32 32 32 32 32 32 32 32 0  32 32 32 32 32 32 32 32 32 0  0  0  0  0  0  40 41 36 36 36 43 32 32 32 32 32 0  0  0  0  0  32 35 36 36 36 36 36 43 0  0  0  0  0  0  0  0  0  0  0  0  0  0  0  0  0  33 33 33 33 33 0  33 33 33 33 0  0  35 37 37 39 0  0  35 37 37 39 0  0  35 37 37 39 0  0  0  0  0  0  0  0  0  0  0  0  0  0  0  0  0  0  0  0  0  0  0  33 33 33 33 35 37 37 39 38 36 36 43 38 36 36 43 38 36 36 43 38 36 36 43 0  0  0  0  0  0  0  0  0  0  0  0  0  0  0  38 36 36 
   36 36 43 32 32 32 32 32 32 32 32 32 32 32 32 32 32 32 32 32 32 32 32 32 32 32 32 32 32 32 32 32 32 32 32 32 32 32 32 32 32 32 32 32 32 32 32 32 32 32 32 32 32 32 32 32 32 32 32 32 32 32 32 32 32 32 32 32 32 32 32 32 35 36 43 32 32 32 32 32 32 32 32 32 32 32 32 32 32 32 32 32 32 32 0  0  0  35 37 39 0  0  0  38 36 43 0  0  0  38 36 43 0  0  0  35 37 39 0  0  0  32 32 32 32 32 32 32 32 32 32 32 32 32 32 32 32 32 0  32 0  32 0  32 0  32 32 32 32 32 32 32 32 32 32 32 32 0  0  0  0  0  0  0  0  0  0  0  0  32 32 32 32 32 32 32 32 32 32 32 32 0  0  32 32 32 32 32 32 32 32 32 32 32 32 0  0  0  0  0  0  0  0  0  0  0  0  0  0  0  0  0  0  37 37 39 0  0  0  0  0  0  32 32 37 37 36 36 43 32 32 0  0  0  0  0  32 32 0  0  0  0  0  0  0  32 32 32 0  32 0  32 0  32 0  32 0  32 0  32 32 32 32 32 32 32 32 32 32 32 32 32 32 32 32 32 26 0  0  32 32 32 32 32 0  0  32 32 32 32 32 0  0  35 37 39 0  0  40 41 42 0  0  0  40 42 0  0  0  40 42 0  0  0  35 37 37 37 37 37 37 37 37 37 37 37 37 37 37 39 0  35 37 37 37 37 37 37 37 39 0  35 37 37 37 37 37 37 37 39 0  35 37 37 37 37 37 37 37 39 0  0  0  0  0  0  0  0  36 36 36 36 37 37 37 37 39 0  0  0  0  32 35 36 36 36 36 36 36 43 0  0  0  0  0  0  0  0  0  0  0  0  0  0  0  0  0  35 37 37 37 39 0  35 37 37 39 0  0  38 36 36 43 0  0  38 36 36 43 0  0  38 36 36 43 0  0  0  0  0  0  0  0  0  0  0  0  0  0  0  0  0  0  0  33 33 33 33 35 37 37 39 38 36 36 43 38 36 36 43 38 36 36 43 38 36 36 43 38 36 36 43 0  0  0  0  0  0  0  0  0  0  0  0  0  0  0  38 36 36 
   36 36 36 37 37 37 37 37 37 37 37 37 37 37 37 37 37 37 37 37 37 37 37 37 37 37 37 37 37 37 37 37 37 37 37 37 37 37 37 37 37 37 37 37 37 37 37 37 37 37 37 37 37 37 37 37 37 37 37 37 37 37 37 37 37 37 37 37 37 37 37 37 36 36 36 37 37 37 37 37 37 37 37 37 37 37 37 37 37 37 37 37 37 39 0  0  0  38 36 43 0  0  0  38 36 43 0  0  0  38 36 43 0  0  0  38 36 43 0  0  0  37 37 37 37 37 37 37 37 37 37 37 37 37 37 37 37 37 0  37 0  37 0  37 0  37 37 37 37 37 37 37 37 37 37 37 39 32 32 32 32 32 32 32 32 32 32 32 32 37 37 37 37 37 37 37 37 37 37 37 39 0  0  37 37 37 37 37 37 37 37 37 37 37 39 0  0  32 32 32 32 32 32 0  0  0  0  0  0  0  0  0  0  36 36 43 0  0  0  32 32 32 37 37 36 36 36 36 36 37 39 0  0  0  0  0  37 39 32 32 32 32 32 32 32 35 37 39 32 37 32 37 32 37 32 37 32 37 32 37 37 37 37 37 37 37 37 37 37 37 37 37 37 37 37 37 39 0  0  35 37 37 37 39 0  0  35 37 37 37 39 0  0  40 41 42 0  0  0  0  0  0  0  0  0  0  0  0  0  0  0  0  0  0  38 36 36 36 36 36 36 36 36 36 36 36 36 36 36 43 0  38 36 36 36 36 36 36 36 43 0  38 36 36 36 36 36 36 36 43 0  38 36 36 36 36 36 36 36 43 0  32 32 32 0  0  0  0  38 36 36 36 36 36 36 36 43 0  0  0  32 35 36 36 36 36 36 36 36 43 0  0  0  0  0  0  0  0  0  0  0  0  0  0  0  0  0  38 36 36 36 43 0  38 36 36 43 33 33 38 36 36 43 33 33 38 36 36 43 33 33 38 36 36 43 33 33 33 33 33 33 33 33 33 33 33 33 33 33 33 33 33 33 33 35 37 37 39 38 36 36 43 38 36 36 43 38 36 36 43 38 36 36 43 38 36 36 43 38 36 36 43 33 33 33 33 33 33 33 33 33 33 33 33 33 33 33 38 36 36 
   36 36 36 36 36 36 36 36 36 36 36 36 36 36 36 36 36 36 36 36 36 36 36 36 36 36 36 36 36 36 36 36 36 36 36 36 36 36 36 36 36 36 36 36 36 36 36 36 36 36 36 36 36 36 36 36 36 36 36 36 36 36 36 36 36 36 36 36 36 36 36 36 36 36 36 36 36 36 36 36 36 36 36 36 36 36 36 36 36 36 36 36 36 43 0  0  0  38 36 43 0  0  0  40 41 42 0  0  0  40 41 42 0  0  0  38 36 43 0  0  0  36 36 36 36 36 36 36 36 36 36 36 36 36 36 36 36 36 0  36 0  36 0  36 0  38 36 36 36 36 36 36 36 36 36 36 36 37 37 37 37 37 37 37 37 37 37 37 37 36 36 36 36 36 36 36 36 36 36 36 43 0  0  36 36 36 36 36 36 36 36 36 36 36 43 0  0  37 37 37 37 37 39 32 32 32 32 32 32 32 32 32 32 36 36 43 32 32 32 37 37 37 36 36 36 36 36 36 36 36 43 0  0  0  0  0  38 36 37 37 37 37 37 37 37 36 36 36 37 36 37 36 37 36 37 36 37 36 37 36 36 36 36 36 36 36 36 36 36 36 36 36 36 36 36 36 43 0  0  38 36 36 36 43 0  0  38 36 36 36 43 0  0  0  0  0  0  0  0  0  0  0  0  0  0  0  0  0  0  0  0  0  0  0  38 36 36 36 36 36 36 36 36 36 36 36 36 36 36 43 0  38 36 36 36 36 36 36 36 43 0  38 36 36 36 36 36 36 36 43 0  38 36 36 36 36 36 36 36 43 0  35 37 39 32 32 32 32 38 36 36 36 36 36 36 36 43 0  0  0  35 36 36 36 36 36 36 36 36 43 0  0  0  0  0  0  0  0  0  0  0  0  0  0  0  0  0  38 36 36 36 43 0  38 36 36 36 37 37 36 36 36 36 37 37 36 36 36 36 37 37 36 36 36 36 37 37 37 37 37 37 37 37 37 37 37 37 37 37 37 37 37 37 39 38 36 36 43 38 36 36 43 38 36 36 43 38 36 36 43 38 36 36 43 38 36 36 43 38 36 36 36 37 37 37 37 37 37 37 37 37 37 37 37 37 37 37 36 36 36 
   36 36 36 36 36 36 36 36 36 36 36 36 36 36 36 36 36 36 36 36 36 36 36 36 36 36 36 36 36 36 36 36 36 36 36 36 36 36 36 36 36 36 36 36 36 36 36 36 36 36 36 36 36 36 36 36 36 36 36 36 36 36 36 36 36 36 36 36 36 36 36 36 36 36 36 36 36 36 36 36 36 36 36 36 36 36 36 36 36 36 36 36 41 42 0  0  0  40 41 42 0  0  0  0  0  0  0  0  0  0  0  0  0  0  0  40 41 42 0  0  0  40 41 41 41 41 41 41 41 41 41 41 41 41 41 41 41 42 0  36 0  36 0  36 0  38 36 36 36 36 36 36 36 36 36 36 36 36 36 36 36 36 36 36 36 36 36 36 36 36 36 36 36 36 36 36 36 36 36 36 43 0  0  36 36 36 36 36 36 36 36 36 36 36 43 0  0  36 36 36 36 36 36 37 37 37 37 37 37 37 37 37 37 36 36 36 37 37 37 36 36 36 36 36 36 36 36 36 36 36 43 0  0  0  0  0  38 36 36 36 36 36 36 36 36 36 36 36 36 36 36 36 36 36 36 36 36 36 36 36 36 36 36 36 36 36 36 36 36 36 36 36 36 36 36 36 43 0  0  38 36 36 36 43 0  0  38 36 36 36 43 0  0  0  0  0  0  0  0  0  0  0  0  0  0  0  0  0  0  0  0  0  0  0  38 36 36 36 36 36 36 36 36 36 36 36 36 36 36 43 0  38 36 36 36 36 36 36 36 43 0  38 36 36 36 36 36 36 36 43 0  38 36 36 36 36 36 36 36 43 0  38 36 36 37 37 37 37 36 36 36 36 36 36 36 36 43 0  0  0  38 36 36 36 36 36 36 36 36 43 0  0  0  0  0  0  0  0  0  0  0  0  0  0  0  0  0  38 36 36 36 43 0  36 36 36 36 36 36 36 36 36 36 36 36 36 36 36 36 36 36 36 36 36 36 36 36 36 36 36 36 36 36 36 36 36 36 36 36 36 36 36 36 43 38 36 36 43 38 36 36 43 38 36 36 43 38 36 36 43 38 36 36 43 38 36 36 43 36 36 36 36 36 36 36 36 36 36 36 36 36 36 36 36 36 36 36 36 36 36 
      )

  (objects
  )
   )


;; EOF ;;
