;; Converting: data/levels/default/level4.dat
(supertux-level
  (name "Sky - take 1")
  (theme "antarctica")
  (music "Mortimers_chipdisko.mod")
  (background "")
  (bkgd_red   100)
  (bkgd_green 230)
  (bkgd_blue  140)
  (time 190)
  (width 270)
  (gravity 10.0)
  (tilemap 
 46  46  46  46  46  46  46  46  46  46  46  46  46  46  46  46  46  46  46  46  46  46  46  46  46  46  46  46  46  46  46  46  46  46  46  46  46  46  46  46  46  46  46 120  88  65  66 120  70  46  46  46  46  46  46  46  46  46  46  46  46  46  46  46  46  46  46  46  46  46  46  46  46  46  46  46  46  46  46  46  46  46  46  46  46  46  46  46  46  46  46  46  46  46  46  46  46  46  46  46  46  46  46  46  46  46  46  46  46  46  46  46  46  46  46  46  46  46  46  46  46  46  46  46  46  46  46  46  46  46  46  46  46  46  46  46  46  46  46  46  46  46  46  46  46  46  46  46  46  46  46  46  46  46  46  46  46  46  46  46  46  46  46  46  46  46  46  46  46  46  46  46  46  46  46  46  46  46  46  46  46  46  46  46  46  46  46  46  46  46  46  46  46  46  46  46  46  46  46  46  46  46  46  46  46  46  46  46  46  46  46  46  46  46  46  46  46  46  46  46  35  35  35  35  35  35  35  35  35  35  35  35  35  35  35  35  35  35  35  35  35  35  35  35  35  35  46  46  46  46  46  46  46  46  46  46  46  46  46  46  46  46  46  46  46  46  46  46  46  46 
 46  46  46  46  46  46  46  46  46  46  46  46  46  46  46  46  46  46  46  46  46  46  46  46  46  46  46  46  46  46  46  46  46  46  46  46  46  46  46  46  46  46  46  46  46  46  46  99 102  46  46  46  46  46  46  46  46  46  46  46  46  50  46  33  69  70  46  46  46  46  46  46  46  46  46  46  46  46  46  46  46  46  46  46  46  46  46  46  46  46  46  46  46  46  46  46  46  46  46  46  46  46  46  46  46  46  46  46  46  46  46  46  46  46  46  46  46  46  46  46  46  46  46  46  50  46  46  46  46  46  46  46  46  46  50  46  46  46  46  46  46  46  46  46  46  50  46  46  46  46  46  46  46  46  46  46  46  46  46  46  46  46  46  46  46  46  46  46  46  46  46  46  46  46  46  46  46  46  46  46  46  46  46  46  46  46  46  46  46  46  46  46  46  46  46  46  46  46  46  46  46  46  46  46  46  46  46  46  46  46  67  68  69  70  46  46  46  46  33  46  35  35  35  35  35  35  35  35  35  35  35  35  35  35  35  35  35  35  35  35  35  35  35  35  35  35  46  46  46  46  46  46  46  46  46  46  46  46  46  46  46  46  46  46  46  42  46  46  46  46 
 46  46  46  46  46  46  46  46  46  46  46  46  46  46  46  46  46  46  46  46  46  46  46  46  46  46  46  46  46  46  46  46  46  46  46  46  46  46  46  46  46  46  46  46  46  46  46  46  46  46  46  46  46  46  46  46  46  46  46  46  46  46  46  99 101 102  46  46  46  46  46  46  46  46  46  46  46  46  46  46  46  46  46  46  46  46  46  46  46  46  46  46  46  46  46  46  46  46  46  46  46  46  46  67  68  69  70  50  46  46  46  46  46  46  46  50  46  46  46  46  46  46  46  50  46  46  46  46  46  46  46  46  46  50  46  46  46  46  46  67  68  69  70  46  50  46  46  46  46  46  46  46  46  46  46  46  46  46  46  46  46  46  46  46  46  46  46  46  46  46  46  46  46  46  46  46  46  46  46  46  46  46  46  46  46  46  46  46  46  46  46  46  46  46  46  46  46  46  46  46  46  46  46  46  46  46  46  46  46  46  99 100 101 102  46  46  46  46  46  46  35  35  35  35  35  35  35  35  35  35  35  35  35  35  35  35  35  35  35  35  35  35  35  35  35  35  46  46  46  46  46  46  46  46  46  46  46  46  46  46  46  46  46  46  46 124  46  46  46  46 
 46  46  46  46  46  46  46  46  46  46  46  46  46  46  46  46  46  46  46  46  46  46  46  46  46  46  46  46  46  46  46  46  46  46  46  46  46  46  46  46  46  46  35  35  35  35  35  35  35  46  46  46  46  46  46  67  68  69  70  46  46  46  46  46  46  46  46  46  46  46  46  46  46  46  46  46  46  46  46  46  46  46  46  46  46  46  46  46  46  46  46  67  68  69  70  46  46  46  46  46  46  46  46  99 100 101 102  46  46  46  46  46  46  46  50  46  67  68  69  70  46  46  50  46  46  46  46  46  46  46  46  46  50  46  46  46  46  46  46  99 100 101 102  50  46  46  46  46  46  46  46  46  46  46  46  46  46  46  46  46  46  50  46  46  46  46  46  46  46  46  46  46  46  46  46  46  46  46  46  46  46  46  46  46  46  46  46  46  46  46  46  46  46  46  46  46  46  46  46  46  46  46  46  46  46  48  48  46  46  46  46  46  46  46  46  46  46  46  46  46  35  35  35  35  35  35  35  35  35  35  35  35  35  35  35  35  35  35  35  35  35  35  35  35  35  35  46  46  46  46  46  46  46  46  46  46  46  46  46  46  46  46  46  46  46 124  46  46  46  46 
 46  46  46  46  46  46  46  46  46  46  46  46  46  46  46  46  46  46  46  46  46  46  46  46  46  46  46  46  46  46  46  46  46  46  46  46  46  46  46  46  67  68  69  70 124  46 124  46  46  46  46  46  46  46  46  99 100 101 102  46  46  46  46  46  46  46  46  46  46  46  46  46  46  46  46  46  46  46  46  46  46  46  46  46  46  46  46  46  46  46  46  99 101 101 102  46  46  46  46  46  46  46  46  46  46  46  46  46  46  46  46  46  46  46  46  46  99 100 101 102  46  46  46  46  46  46  46  46  46  46  46  50  46  67  68  69  70  46  46  46  46  46  50  46  46  46  46  46  46  67  68  69  70  46  46  46  67  68  69  70  46  46  46  46  46  46  46  46  46  46  46  46  46  46  46  46  46  46  46  46  46  46  46  46  46  46  46  67  68  69  70  46  46  46  46  46  46  46  46  46  46  46  35  35  35  35  35  46  46  46  46  46  35  46  46  46  35  46  46  46  35  35  35  35  35  35  35  35  35  35  35  35  35  35  35  35  35  35  35  35  35  35  35  35  35  35  46  46  46  46  46  46  46  46  46  46  46  46  46  46  46  46  46  46  46 124  46  46  46  46 
 46  46  46  46  67  68  69  70  46  46  46  46  46  46  46  46  46  46  46  46  46  46  46  67  68  69  70  46  46  46  46  46  46  46  46  46  46  46  46  46  99 100 101 102 124  46 124  46  46  46  46  46  46  46  46  46  46  46  46  46  35  35  35  35  35  35  46  46  67  68  69  70  48  46  46  46  67  68  69  70  46  46  46  46  46  46  46  46  46  46  46  46  46  46  46  46  46  46  46  46  46  46  35  35  35  35  46  46  46  35  35  35  35  46  46  46  46  35  35  35  35  46  46  46  46  46  35  35  35  35  46  46  46  99 100 101  35  35  35  35  46  50  46  46  46  46  46  35  35  35  35 101 102  46  46  46  99 100 101 102  46  46  46  46  46  46  46  46  46  46  46  46  46  46  46  46  46  46  46  46  46  46  46  46  46  46  46  99 100 101 102  46  46  46  46  46  46  46  67  68  69  35  46 124  46 124  46  46  46  46  46  46  35  46  46  46  35  35  35  35  35  35  35  35  35  35  35  35  35  35  35  35  35  35  35  35  35  35  35  35  35  35  35  35  35  35  46  46  46  67  68  69  70  46  46  46  46  46  46  46  46  46  46  46  46 124  46  46  46  46 
 46  46  46  46  99 101 101 102  46  46  46  46  46  46  46  46  46  46  46  46  46  46  46  99 101 101 102  46  46  46  46  46  46  46  46  46  46  46  46  46  46  46  46  46 124  46 124  46  46  46  46  48  48  48  48  48  48  46  46  46  46 124  46  46 124 124  46  46  35  35  35  35  35  35  46  46  99 100 101 102  46  46  46  46  46  46  46  46  46  46  46  46  46  46  46  46  46  46  48  48  46  46 124  46  46 124  46  46  46 124  46  46 124  46  46  46  46 124  46  46 124  46  46  46  46  46 124  46  46 124  46  46  46  46  46  46 124  46  46 124  46  46  46  46  46  46  46 124  46  46 124  46  46  46  46  46  46  46  46  46  46  46  46  46  46  67  68  69  70  46  46  46  46  46  46  46  46  46  46  46  46  46  46  46  46  46  46  46  46  46  46  46  46  46  46  46  46  46  99 100  35 102  46 124  46 124  46  46  46  67  70  46  35  46  46  46  35  35  35  35  35  35  35  35  35  35  35  35  35  35  35  35  35  35  35  35  35  35  35  35  35  35  35  35  35  35  46  46  46  99 100 101 102  46  46  46  46  46  50  46  46  46  46  46  46 124  46  46  46  46 
 46  46  46  46  46  46  46  46  46  46  50  46  46  46  46  46  46  46  46  46  46  46  46  46  46  46  46  46  46  46  46  46  46  46  46  46  46  46  46  46  46  46  46  46 124  46 124  46  46  46  46  35  35  35  35  35  35  70  46  46  46 124  46  46 124 124  46  46  46 124  46  46 124  46  46  46  46  46  46  46  46  46  46  46  46  46  46  46  46  46  46  46  46  46  46  35  35  35  35  35  46  46 124  46  46 124  46  35  46 124  46  46 124  46  35  35  46 124  46  46 124  46  35  35  35  46 124  46  46 124  46  35  35  35  35  46 124  46  46 124  46  35  35  35  35  35  46 124  46  46 124  46  35  46  48  46  46  48  46  48  46  49  46  35  46  99 100 101 102  46  46  46  46  46  46  46  46  46  46  46  46  48  46  46  46  46  46  46  46  46  46  46  46  46  48  48  48  48  46  35  46  46  46 124  46 124  46  46  46  35 102  46  35  46  46  46  35  35  35  35  35  46  46  46  46  46  46  46  46  46  46  46  46  46  46  46  46  46  46  46  46  46  46  35  35  35  46  46  46  50  46  46  46  46  46  46  46  46  46  46  46  46  46  46  46 124  46  46  46  46 
 46  46  46  46  46  46  46  46  46  46  46  46  46  46  46  46  46  46  46  50  46  46  46  46  46  48  46  46  46  46  48  46  46  67  68  69  70  46  46  46  46  46  46  46 124  46 124  46  46  46  46  46 124  46 124  99 101 102  46  46  46 124  46  46 124 124  46  46  46 124  46  65 124  66  46  46  46  46  46  46  46  46  46  46  46  46  46  46  46  46  48  48  48  46  46  46  46 124  46  46  46  46 124  46  46 124  46 124  46 124  46  46 124  46 124 124  46 124  46  46 124  46  46 124  46  46 124  46  46 124  46 124  46  46 124  46 124  46  46 124  46 124  46  46  46 124  46 124  46  46 124  46  35  35  35  35  35  35  35  35  35  35  35  35  46  46  46  46  46  46  46  46  46  46  46  67  35  35  35  35  35  35  69  70  46  46  46  46  46  46  46  35  35  35  35  35  35  35  35  46  46  46  46 124  46 124  46  46  46 124  46  46  35  46  46  46  35  35  35  35  35  46  46  46  46  46  46  48  46  46  48  46  46  46  46  46  46  46  46  46  46  46  46  46  46  46  46  46  46  46  46  46  46  67  68  69  70  46  46  46  46  46  46  46  46 124  46  46  46  46 
 46  46  46  46  46  46  46  46  46  46  46  46  46  46  46  46  46  46  46  46  46  46  46  46  46  35  35  35  35  35  35  46  46  99 100  35  35  35  35  35  35  46  46  46 124  46 124  46  46  46  46  46 124  46 124  46  46  46  46  46  46 124  46  46 124 124  46  46  46 124  46  46 124  46  46  46  46  46  46  46  46  46  46  46  67  68  69  35  35  35  35  35  35  46  46  46  46 124  46  46  46  46 124  46  46 124  46 124  46 124  46  46 124  46 124 124  46 124  46  46 124  46  46 124  46  46 124  46  46 124  46 124  46  46 124  46 124  46  46 124  46 124  46  46  46 124  46 124  46  46 124  46  46  46 124  46  46  46  99 101 102 124  46  46  46  46  46  46  46  46  46  46  46  46  46  99 102 124  46  46 124  99 101 102  46  46  46  46  46  46  46  46 124  46  46  46  46 124  46  46  46  46  46 124  46 124  46  46  46 124  46  46  35  46  46  46  35  35  35  35  35  46  46  46  46  35  35  35  35  35  35  46  46  46  48  46  48  46  46  46  46  46  46  46  46  46  46  46  46  46  46  46  46  35  35  35  35  46  46  46  46  46  46  46  46 124  46  46  46  46 
 46  46  46  46  46  46  46  46  46  46  46  46  46  46  46  46  46  46  46  46  46  46  46  46  35  46 124  46  46 124  46  46  46  46  46  46 124  46  46 124  46  46  46  46 124  46 124  46  46  46  46  46 124  46 124  46  46  46  46  46  35  35  35  35  35 124  46  46  35 124  48  48 124  46  49  46  35  46  46  46  46  46  46  46  99 100 101 102 124  46  46 124  46  46  46  46  46 124  46  46  46  46 124  46  46 124  46 124  46 124  46  46 124  46 124 124  46 124  46  46 124  46  46 124  46  46 124  46  46 124  46 124  46  46 124  46 124  46  46 124  46 124  46  46  46 124  46 124  46  46 124  46  46  46 124  46  46  46  46  46  46 124  46  46  46  46  46  46  46  46  46  46  46  46  46  46  46 124  46  46 124  46  46  46  46  46  46  46  46  46  46  46 124  46  46  46  46 124  46  65  66  65  65 124  46 124  46  35  46 124  46  46  35  46  46  46  35  35  35  35  35  46  50  46  46  46  46  46  46  46  46  46  46  35  35  35  35  46  46  46  46  46  46  46  35  35  46  46  46  46  46  46  46 124  46  46 124  67  70  46  46  46  46  46  46 124  46  46  46  46 
 46  46  46  46  46  46  46  46  46  46  46  46  46  46  46  46  46  46  46  46  46  46  46  46  46  46 124  46  46 124  46  46  46  46  46  46 124  46  46 124  46  46  46  35  35  35  35  35  46  46  35  35  35  35  35  35  35  46  46  46 124  99 101 102  46 124  46  46  35  35  35  35  35  35  35  35  35  46  46  46  46  46  46  46  46  46  46  46 124  46  46 124  46  46  46  46  46 124  46  46  46  46 124  46  46 124  46 124  46 124  46  46 124  46 124 124  46 124  46  46 124  46  46 124  46  46 124  46  46 124  46 124  46  46 124  46 124  46  46 124  46 124  46  46  46 124  46 124  46  46 124  46  46  46 124  46  46  46  46  46  46 124  46  46  46  46  46  35  46  49  48  46  35  46  46  46  46 124  46  46 124  46  46  46  35  35  35  35  35  35  46  46 124  46  46  46  46 124  46  46  46  46  46 124  46 124  46 124  46 124  46  46  35  46  46  46  35  35  35  35  35  46  46  46  35  46  46  46  46  46  46  46  46  46  46  46  46  46  46  46  46  46  48  46  35  35  35  35  35  35  46  46  46 124  46  46 124  99  35  35  35  35  35  35  35  35  35  35  46  46 
 46  46  46  46  46  71  72  74  46  46  46  46  46  46  46  46  46  46  46  46  46  48  46  46  46  46 124  46  46 124  67  68  69  70  46  46 124  46  46 124  46  46  46 124  46  46  46 124  46  46  46 124  46  46  46 124  46  46  46  46 124  46  46  46  46 124  46  46  46 124  46  46  46  46  46 124  46  46  46  46  35  35  35  35  35  35  46  46 124  46  46 124  46  46  46  46  46 124  46  46  46  46 124  46  46 124  46 124  46 124  46  46 124  46 124 124  46 124  46  46 124  46  46 124  46  46 124  46  46 124  46 124  46  46 124  46 124  46  46 124  46 124  46  46  46 124  46 124  46  46 124  46  46  46 124  46  46  46  46  46  46 124  46  46  46  46  46  35  35  35  35  35  35  46  46  46  46 124  46  46 124  46  46  46  46 124  46  46 124  46  46  46 124  46  46  46  46 124  46  46  46  46  46 124  46  35  46 124  46 124  46  46  35  46  46  46  46  46  46  46  46  46  46  46  46  46  46  46  46  46  46  46  46  46  46  46  46  46  46  46  46  35  35  35  35  35  46  46  46  46  46  46  46 124  46  46 124  46  46  46 124  46  46  46  46 124  46  46  46  46 
 46  46  46  46  46 103 104 106  48  48  46  46  46  46  46  35  35  35  35  35  35  35  73  74  46  46 124  46  46 124  99 100 100 102  46  46 124  46  46 124  46  46  46 124  46  46  46 124  46  46  46 124  46  46  46 124  71  72  73  74 124  46  46  46  46 124  46  46  46 124  46  46  71  74  46 124  46  71  73  74  46 124  46  46 124  46  46  46 124  46  46 124  46  71  72  73  74 124  46  46  46  46 124  46  46 124  46 124  46 124  71  74 124  46 124 124  46 124  46  46 124  46  46 124  46  46 124  46  46 124  46 124  46  46 124  46 124  46  46 124  46 124  71  73  74 124  46 124  46  46 124  46  46  46 124  46  71  72  73  74  46 124  46  46  46  46  46  46 124  46  46 124  71  72  73  74  46 124  46  46 124  46  46  46  46 124  46  46 124  46  46  46 124  35  46  46  46 124  46  46  46  46  46 124  46 124  46 124  46 124  71  72  35  46  46  48  46  46  49  46  48  46  46  46  46  49  46  46  46  48  46  46  46  46  46  48  46  46  46  48  46  35  35  35  35  35  74  46  46  46  46  46  46 124  46  46 124  71  72  74 124  46  46  46  46 124  46  46  46  46 
 35  35  35  35  35  35  35  35  35  35  35  46  46  46  46  35  35  35  35  35  35  35 105 106  46  46 124  46  46 124  46  46  46  46  46  46 124  46  46 124  71  73  74 124  46  46  46 124  46  46  46 124  46  46  46 124 103 104 104 106 124  46  46  46  46 124  46  46  46 124  46  46 103 106  46 124  46 103 104 106  46 124  46  46 124  46  46  46 124  46  46 124  46 103 105 105 106 124  46  46  46  46 124  71  74 124  46 124  46 124 103 106 124  46 124 124  46 124  46  46 124  46  46 124  71  74 124  46  46 124  46 124 103 106 124  46 124  46  46 124  46 124 103 104 106 124  46 124  46  46 124  46  46  46 124  46 103 104 104 106  46 124  46  46  46  46  46  46 124  46  46 124 103 104 104 106  46 124  46  46 124  46  46  46  46 124  46  46 124  46  46  46 124  35  35  35  35  35  35  35  35  35  35  35  35 124  46 124  46 124 103 104  35  35  35  35  35  35  35  35  35  35  35  35  35  35  35  35  35  35  35  35  35  35  35  35  35  35  35  35  35  35  35  35  35  35 106  46  46  46  46  46  46 124  46  46 124 103 104 106 124  46  46  46  46 124  46  46  46  46 
   )
)
