;; Converting: data/levels/default/level3.dat
(supertux-level
  (name "mondo")
  (theme "antarctica")
  (music "Mortimers_chipdisko.mod")
  (background "arctis.png")
  (bkgd_red   0)
  (bkgd_green 0)
  (bkgd_blue  0)
  (time 180)
  (width 350)
  (gravity 10.0)
  (tilemap 
 46  46  46  46  46  46  46  46  46  46  46  46  46  46  46  46  46  46  46  46  46  46  46  46  46  46  46  46  46  46  46  46  46  46  46  46  46  46  46  46  46  46  46  46  46  46  46  46  46  46  46  46  46  46  46  46  46  46  46  46  46  46  46  46  46  46  46  46  46  46  46  46  46  46  46  46  46  46  46  46  46  46  46  46  46  46  46  46  46  46  46  46  46  46  46  46  46  46  46  46  46  46  46  46  46  46  46  46  46  46  46  46  46  46  46  46  46  46  46  46  46  46  46  46  46  46  46  46  46  46  46  46  46  46  46  46  46  46  46  46  46  46  46  46  46  46  46  46  46  46  46  46  46  46  46  46  46  46  46  46  46  46  46  46  46  46  46  46  46  46  46  46  46  46  46  46  46  46  46  46  46  46  46  46  46  46  46  46  46  46  46  46  46  46  46  46  46  46  46  46  46  46  46  46  46  46  46  46  46  46  46  46  46  46  46  46  46  46  46  46  46  46  46  46  46  46  46  46  46  46  46  46  46  46  46  46  46  46  46  46  46  46  46  46  46  46  46  46  46  46  46  46  46  46  46  46  46  46  46  46  46  46  46  46  46  46  46  46  46  46  46  46  46  46  46  46  46  46  46  46  46  46  46  46  46  46  46  46  46  46  46  46  46  46  46  46  46  46  46  46  46  46  46  46  46  46  46  46  46  46  46  46  46  46  46  46  46  46  46  46  46  46  46  46  46  46  46  46  46  46  46  46  46  46  46  46  46  46  46  46  46  46  46  46  46  46  46  46  46  46 
 46  46  46  46  46  46  46  46  46  46  46  46  46  46  46  46  46  65  65  65  66  46  46  67  68  69  68  69  70  46  46  46  46  46  46  46  46  46  46  46  46  46  46  46  46  46  46  46  46  46  46  46  46  46  46  46  46  46  46  46  46  46  46  46  46  46  46  46  46  46  46  46  46  46  46  46  46  46  46  46  46  46  46  46  46  46  46  46  46  46  46  46  46  46  46  46  46  46  46  46  46  46  46  46  46  46  46  46  46  46  46  46  46  46  46  46  46  46  46  46  67  68  69  70  46  46  46  46  46  46  46  46  46  46  46  46  46  46  46  46  46  46  46  46  46  46  46  46  46  46  46  46  46  46  46  46  46  46  46  46  46  46  46  46  46  46  46  46  46  46  46  46  46  46  46  46  46  46  46  46  46  46  46  46  46  46  46  46  46  46  46  46  46  46  46  46  46  46  46  46  46  46  36  36  36  36  36  46  46  46  46  46  46  46  46  46  46  46  46  46  46  46  46  46  46  46  46  46  46  46  46  46  46  46  46  46  46  46  46  46  46  46  46  46  46  46  46  46  46  46  46  46  46  46  46  46  46  46  46  46  46  46  46  46  46  46  46  46  46  46  46  46  46  46  46  36  36  36  36  46  46  46  36  36  36  36  46  46  46  36  36  36  36  36  46  46  46  46  46  46  46  46  46  46  46  46  46  46  46  46  46  46  46  46  46  46  46  46  46  46  46  46  46  46  46  46  46  46  46  46  46  46  46  46  46  46  46  46  46  46  46  46  71  74  46  46  46  46  46  46 
 46  46  46  46  46  46  46  46  46  46  46  46  46  46  46  46  46  46  46  46  46  46  46  99 100 100 100 101 102  46  46  46  46  46  46  46  46  46  46  46  46  46  46  46  46  46  46  46  46  46  46  46  46  46  46  46  46  46  46  46  46  46  46  46  46  46  46  46  46  46  46  46  46  46  46  46  46  46  46  46  46  46  46  46  46  46  46  46  46  46  88  88  88  88  88  88  88  88  88  46  46  46  46  46  46  46  46  46  46  46  46  46  46  46  46  46  46  46  46  46  99 100 101 102  46  46  46  46  46  46  46  46  46  46  46  46  46  46  46  46  46  46  46  46  46  46  89  89  89 121  89  46  46  46  46  46  46  46  46  46  46  46  46  46  46  46  46  46  46  46  46  46  46  46  46  46  46  46  46  46  46  46  46  46  46  46  46  46  46  46  46  46  46  46  46  46  46  46  46  46  46  46  46  46  46  46  46  46  46  46  46  46  46  46  46  46  46  46  46  46  46  46  46  46  46  46  46  46  46  46  46  46  46  46  46  46  46  46  46  46  46  46  46  46  46  46  46  46  46  46  46  46  46  46  46  46  46  46  46  46  46  46  46  46  46  46  46  46  46  46  46  46  46  46  46  46  46  46  46  46  46  46  46  46  46  46  46  46  46  46  46  46  46  46  46  46  46  46  46  46  46  46  46  46  46  46  46  46  46  46  46  46  46  46  46  46  46  46  46  46  46  46  46  46  46  46  46  46  46  46  46  46  46  46  46  46  46  46  46  46  46  71 105 106  46  46  42  46  46  46 
 46  46  46  46  46  46  46  46  46  46  46  46  46  46  46  46  46  46  46  46  46  46  46  46  46  46  46  46  46  46  46  46  46  46  46  46  46  46  46  46  46  46  46  46  46  46  46  46  46  46  46  46  46  46  46  46  46  46  46  46  46  46  46  46  46  46  46  46  46  46  46  46  46  46  46  46  46  46  46  46  46  46  46  46  46  46  46  46  46  46  97  36  36  36  36  36  36  36  97  46  46  46  46  46  46  46  46  46  46  46  46  46  46  46  46  46  46  46  46  46  46  46  46  46  46  46  89  89  89  89  89  89  46  46  46  46  46  46  46  46  46  46  65  46  46  46  46  46  46  46  46  46  46  46  46  46  46  46  46  46  46  46  46  46  46  46  46  46  46  46  46  46  46  46  46  46  46  46  46  46  46  46  46  46  46  46  46  46  46  46  46  46  46  46  46  46  46  46  46  46  46  46  46  46  46  46  46  46  46  46  46  46  46  46  46  46  46  46  46  46  46  46  46  46  46  46  46  46  46  46  46  46  46  46  46  46  46  46  46  46  46  46  46  46  46  46  46  46  46  46  46  46  46  46  46  46  46  46  46  46  46  46  46  46  46  46  46  46  46  46  46  46  46  46  46  46  46  46  46  46  46  46  46  46  46  46  46  46  46  46  46  46  46  46  46  46  46  46  46  46  46  46  46  46  46  46  46  46  46  46  46  46  46  46  46  46  46  46  46  46  46  46  46  46  46  46  46  46  46  46  46  46  46  46  46  46  46  46  46  46  71 105 105 105  46  92 124  46  46  46 
 46  46  46  46  46  46  46  46  46  46  46  46  46  46  46  46  46  46  46  46  46  46  46  46  46  46  46  46  46  46  46  46  46  46  46  46  46  46  46  46  46  46  46  46  46  46  46  46  46  46  46  46  46  46  46  46  46  46  46  46  46  46  46  46  46  46  46  46  46  46  46  46  46  46  46  46  46  46  46  46  46  46  46  46  46  46  46  46  46  46  97  36  36  36  36  36  36  36  97  46  46  46  46  46  46  46  46  46  46  46  71  72  74  46  46  46  46  46  46  46  46  46  46  46  46  46  46  35  35  35  35  46  46  46  46  46  46  46  46  46  46  46  46  46  46  46  46  46  46  46  46  46  46  46  46  46  46  46  46  46  46  46  46  46  46  46  46  46  46  46  46  46  46  46  46  46  46  46  46  46  46  46  46  46  46  46  46  46  46  46  46  46  46  46  46  46  46  46  46  46  46  89  89  89  89  89  89  89  46  46  46  46  46  46  46  46  46  46  46  46  46  46  46  46  46  46  46  46  46  46  46  46  46  46  46  46  46  46  46  46  46  46  46  46  46  46  46  46  46  46  46  46  46  46  46  46  46  46  46  46  46  46  46  46  46  46  46  71  72  73  74  46  46  46  46  46  46  46  46  46  46  46  46  46  46  46  46  46  46  46  46  46  46  46  46  46  46  46  46  46  46  46  46  46  46  46  46  46  46  46  46  46  46  46  46  46  46  46  46  46  46  46  46  46  46  46  46  46  46  46  46  46  46  46  46  46  46  46  46  46 103 105 105 105  74  46 124  46  46  46 
 46  46  46  46  46  46  46  46  46  46  46  46  46  46  46  46  46  46  46  46  46  46  46  46  46  46  46  46  46  46  46  46  46  46  46  46  46  46  46  46  46  46  46  46  46  46  46  46  46  46  46  46  46  46  46  46  46  46  46  46  46  46  46  46  46  46  46  46  46  46  46  46  46  46  46  46  46  46  46  46  46  46  46  46  46  46  46  46  46  46  97  36  36  36  36  36  36  36  97  46  46  46  46  46  46  46  46  46  71  72  61  93 106  46  46  46  46  46  46  46  46  46  46  46  46  46  46  35  35  35  35  46  46  46  46  46  46  46  46  46  46  46  46  46  46  46  46  46  46  46  48  46  46  46  46  46  46  46  46  46  46  46  46  46  46  46  46  46  46  46  46  46  46  46  46  46  46  46  46  46  46  46  46  46  46  46 121  46  46  46  46  46  46  46  46  46  46  46  46  46  46  46  46  46  46  46  46  46  46  46  46  46  46  46  46  46  46  46  46  46  46  46  46  46  46  46  46  46  46  46  46  46  46  46  46  46  46  46  46  46  46  46  46  46  46  46  46  46  46  46  46  97  46  48  46  46  46  97  46  46  46  46  46  46  46  46  46 103  91  93 106  46  97  97  97  46  46  46  46  97  97  97  46  46  46  46  97  97  97  46  46  46  46  46  46  46  46  46  46  46  46  46  46  46  46  46  46  46  46  46  46  46  46  46  46  46  46  89  89  89  89 121  46  46  46  46  46  46  46  46  46  46  46  46  46  46  46  46  46  71 105 105 105 104 106  46 124  46  46  46 
 46  46  46  46  46  46  46  46  46  46  46  46  46  46  46  46  89  89  89  89 121  89  46  46  46  46  46  46  46  46  46  46  46  46  46  46  46  46  46  46  46  46  46  46  46  46  46  46  46  46  46  46  46  46  46  46  46  46  46  46  46  46  46  46  46  46  46  89  89 121  46  46  46  46  46  46  46  46  46  46  36  36  36  46  46  46  46  46  46  46  88  88  88  88  88  88  88  88  88  46  46  46  46  46  46  46  46  46 103  91  35  35 105  74  46  65  65  65  33  46  46  46  46  46  46  46  46  35  35  35  35  46  46  46  46  46  46  46  46  46  46  46  46  46  46  46  88  88  88  88  88  46  46  46  46  46  46  46  46  46  46  46  46  46  89  89  65  89  89  65  89  89  66  89  89  46  46  46  46  46  46  46  46  71  74  46  46  46  71  74  46  46  46  46  46  46  46  46  46  46  46  46  46  46  46  46  46  46  46  46  46  46  46  46  46  46  46  46  46  46  46  46  46  46  46  46  46  46  46  46  46  46  46  46  46  46  46  46  46  46  46  46  46  46  46  46  46  46  46  46  46  89  89  89  89 121  66  89  46  46  46  46  46  46  71  72  73 105 105 105 105  74  46  46  46  46  46  46  46  46  46  46  46  50  46  46  46  46  46  46  46  46  46  46  46  46  46  46  46  46  46  46  46  46  46  46  46  46  46  46  46  46  46  46  46  46  46  46  46  46  46  46  46  46  46  46  46  46  46  46  46  46  46  46  46  46  46  46  46 103 105 105 105 104 104  74 124  46  46  46 
 46  46  46  46  46  46  46  46  46  46  46  46  46  46  46  46  46  46  46  46  46  46  46  46  46  46  46  46  46  46  46  46  46  46  46  46  46 120  88  88  88  46  46  46  46  46  46  46  46  46  46  46  46  46  46  46  46  46  46  46  46  46  46  46  46  46  46  46  46  46  46  46  46  46  46  46  46  46  46  46  46  46  46  46  46  46  46  46  46  46  46  46  46  46  46  46  46  46  46  46  46  46  46  46  46  46  71  72  91  35  35  35 105 106  46  46  46  46  46  46  46  46  46  46  46  46  46  35  35  35  35  46  46  46  46  46  46  46  46  89  89  89  89  46  46  46  46  46  46  46  46  46  46  46  46  46  46  46  46  46  46  46  46  46  46  46  46  46  46  46  46  46  46  46  46  46  46  46  46  46  46  46  71 105  93  46  46  46  91 106  46  46  46  46  46  89  89  89  89  46  46  46  46  46  46  46  46  46  46  46  46  46  46  46  46  46  46  46  46  46  46  46  46  46  46  46  46  46  46  46  46  46  46  46  46  46  97  46  46  46  48  97  46  46  46  46  46  46  46  46  46  46  46  46  46  46  46  46  46  46  46  46  46  46 103  91  93 105 105 105 105 106  46  46  46  46  46  46  46  46  46  46  46  97  46  46  46  46  46  46  46  46  46  46  46  46  46  46  46  46  46  46  46  46  46  46  46  46  46  71  72  73  72  73  74  46  46  46  46  46  46  46  46  71  72  73  72  74  46  46  46  46  46  46  46  46  46  46 103 105 105 105 105 104 104 106 124  46  46  46 
 46  46  46  46  46  46  46  46  46  71  74  46  46  46  46  46  46  46  46  46  46  46  46  46  46  46  91  93  46  46  46  46  46  46  46  46  46  46  46  46  46  46  46  46  46  46  46  46  46  46  46  46  46  46  46  46  46  46  46  46  71  72  74  46  46  46  46  46  46  46  46  46  46  46  46  46  46  46  46  46  46  46  46  46  46  46  46  46  46  46  46  46  46  46  46  46  46  46  46  46  46  46  46  46  46  46 103  91  35  35  35  35 105 105  74  46  46  46  46  46  46  46  46  46  46  46  46  35  35  35  35  46  46  46  46  46  46  46  46  46  46  46  46  46  46  46  46  46  46  46  46  46  46  46  46  46  46  46  46  46  46  46  46  46  46  46  46  46  46  46  46  46  46  46  46  46  46  46  46  46  46  46 103  91  35  46  46  46  35  93  74  46  46  46  46  46  46  46  46  46  46  46  46  46  46  46  46  46  46  46  46  46  46  46  46  46  46  46  46  46  46  46  46  46  46  46  46  46  46  46  46  46  46  46  46  46  88  89  89  89  89  88  46  46  46  46  46  46  46  46  46  46  46  46  46  46  46  46  46  46  46  46  71  72 105 105 105 105 105 105 105 105  74  46  46  46  46  46  46  46  46  46  46  46  46  46  46  46  46  46  46  46  46  46  46  46  46  46  46  46  46  46  46  46  46  46  46  46  46 103 105 105  61  93 106  46  46  46  46  46  46  97  46 103  91  93 105 106  46  46  46  46  46  46  46  46  46  46 105 105 105 105 105 104 104 104 124  46  46  46 
 46  46  46  46  46  46  46  46  46 103 106  46  46  46  46  88  46  46  46  46  48  46  46  46  46  46  35  46  46  46  46  46  46  46  46  46  46  46  46  46  46  46  50  46  46  46  46  46  46  71  65  65  65  46  65  65  46  46  46  46 103  61 106  46  46  46  46  46  46  71  72  74  46  46  46  46  46  46  46  46  46  46  46  46  46  46  46  46  71  72  74  46  46  46  46  71  72  74  46  46  46  46  46  46  71  72  91  35  35  35  35  35 105 105 106  46  46  46  46  46  46  46  46  46  46  46  46  35  35  35  35  46  49  46  71  72  74  46  46  46  46  46  46  46  46  46  46  46  46  46  46  46  46  46  46  71  72  73  74  46  46  46  46  46  46  46  46  46  46  46  46  46  46  46  46  46  46  46  46  46  71  72  93  35  35  46  46  46  35  35  61  72  74  46  46  46  46  46  46  46  46  46  46  46  46  46  46  46  46  46  46  46  46  46  46  46  46  46  71  72  73  74  46  46  46  46  46  46  46  46  46  46  46  46  46  46  46  46  46  46  46  46  46  46  46  46  46  46  46  46  46  46  46  46  46  46  46  46  46  46  46  71  91  93 105 105 105 105 105 105 105 105 106  46  46  46  46  46  46  46  46  46  46  46  46  46  46  46  46  46  46  46  46  46  46  46  46  46  46  46  46  46  46  46  46  46  46  71  72 105  61  93  35  35 105  74  46  46  46  46  46  46  71 105  35  35  91  93  73  74  46  46  46  46  46  46  46  71 105  91  61  61  61  35  35  35  35  35  46  46 
 46  46  46  46  46  46  46  46 103 105  61  61  61  46  46  88  88  88  88  88  88  61  61  61  61  61  35  46  46  46  46  46  46  71  72  73  74  46  46  46  46  71  91  74  46  46  46  46  46 103 104 106  46  46  46  46  46  46  46  71  91  35  93  74  46  46  46  46  48 103  91 106  46  46  46  46  46  46  46  50  46  46  46  46  46  46  46  46 103  91 106  46  46  46  48 103  91 106  46  46  46  46  46  46 103  93  35  35  35  35  35  35 105 105 105  46  46  46  46  46  46  48  46  46  97  94  94  35  35  35  35  94  94  97 103  91 106  46  46  46  48  46  46  46  46  46  46  46  46  46  46  46  46  50  46 103  91  93 106  46  46  46  46  46  46  46  46  46  46  49  46  46  46  46  46  46  46  46  46  46 103  91  35  35  46  46  46  49  46  35  35  91 106  46  46  46  46  46  48  46  46  46  46  46  46  46  46  48  46  46  46  46  46  46  46  46  46  46 103  91  93 106  46  46  46  46  46  46  46  46  46  46  46  46  46  46  46  46  46  46  46  46  49  46  46  46  46  46  46  46  46  46  46  46  46  46  46  46  46  46  46 103 105 105 105 105 105 105 105 105 105 105 105 106  46  46  46  46  46  46  46  46  46  46  46  46  46  46  46  46  46  46  46  46  46  46  46  46  46  46  46  46  46  46  46  46  46 103  91  61  35  35  35  35 105 106  46  46  46  48  46  46 103 105  35  35  35  35  91  93  74  46  46  46  46  46  46 103  93  35  35  35  35  35  35  35  35  35  46  46 
 46  46  46  46  46  46  46  46 105  61  35  35  35  94  94  94  94  94  94  94  94  35  36  36  36  36  35  46  46  46  50  46  46 103  91  93 106  46  49  46  46 103  35 106  46  46  46  46  46 105 104 104  49  50  46  46  46  46  35  35  35  35  35  35  35  35  35  35  35  35  35  35  35  46  46  35  35  35  35  35  35  35  35  35  35  35  35  35  35  35  35  35  35  35  35  35  35 104  74  46  46  46  46  35  61  35  35  35  35  35  35  35  35  35  35  35  35  35  35  35  35  35  35  35  35  38  38  38  35  35  38  38  38  35  35  35  35  35  35  35  35  35  35  35  35  35  35  35  35  35  35  35  35  35  35  35  35  35  35  35  35  35  35  35  35  35  35  35  35  35  35  35  35  35  35  35  35  35  35  35  35  35  35  35  35  35  35  35  35  35  35  35  35  35  35  35  35  35  35  35  35  35  35  35  35  35  35  35  35  35  35  35  35  35  35  35  35  35  35  35  35  35  35  35  35  94  94  94  94  94  94  35  35  35  94  94  94  94  94  94  94  94  94  94  35  35  35  35  35  35  35  35  35  35  35  35  35  35  35  35  35  35  35  35  46  46  46  46  46  35  35  35  35  35  35  35  35  35  35  35  35  35  35  35  35  35  35  35  35  35  35  35  35  35  35  35  35  35  35  35  35  35  35  35  35  35  35  35  35  35  35  35  35  35  35  35  35  35  35  35  35  35  35  35  35  35  35  35  35  35  35  35  35  35  35  35  35  35  35  35  35  35  35  35  35  35  35  35  35  35 
 61  61  61  61  61  61  61  61  93  35  35  35  35  38  38  38  38  38  38  38  38  38  94  94  94  94  94  94  94  35  35  35  35  35  35  35  35  35  35  35  35  35  35  35  35  35  35  35  94  94  94  94  94  35  94  94  94  35  35  35  35  35  35  35  35  35  35  35  35  35  35  94  94  94  94  94  35  35  35  35  35  35  35  35  35  35  35  35  35  35  35  35  35  35  35  35  35  91  61  94  94  94  35  35  35  35  35  35  35  35  35  35  35  35  35  35  35  35  35  35  35  35  35  35  35  38  38  38  38  38  38  38  38  35  35  35  35  35  35  35  35  35  35  35  35  35  35  35  35  35  35  35  35  35  35  35  35  35  35  35  35  35  35  35  35  35  35  35  35  35  35  35  35  35  35  35  35  35  35  35  35  35  35  35  35  35  35  35  35  35  35  35  35  35  35  35  35  35  35  35  35  35  35  35  35  35  35  35  35  35  35  35  35  35  35  35  35  35  35  35  35  35  35  35  35  35  38  38  38  38  35  35  35  35  35  38  38  38  38  38  38  38  38  35  35  35  35  35  35  35  35  35  35  35  35  35  35  35  35  35  35  35  35  35  94  94  94  94  94  35  35  35  35  35  35  35  35  35  35  35  35  35  35  35  35  35  35  35  35  35  35  35  35  35  35  35  35  35  35  35  35  35  35  35  35  35  35  35  35  35  35  35  35  35  35  35  35  35  35  35  35  35  35  35  35  35  35  35  35  35  35  35  35  35  35  35  35  35  35  35  35  35  35  35  35  35  35  35  35  35 
 35  35  35  35  35  35  35  35  35  35  35  35  35  38  38  38  38  38  38  38  38  38  38  38  38  38  38  38  35  35  35  35  35  35  35  35  35  35  35  35  35  35  35  35  35  35  35  35  35  38  38  38  38  35  38  38  38  38  38  38  35  35  35  35  35  35  35  35  35  35  38  38  38  38  38  38  38  38  35  35  35  35  35  35  35  35  35  35  38  38  38  38  38  38  38  38  38  38  38  38  38  38  38  35  35  35  35  35  35  35  35  35  35  35  35  35  35  35  35  35  35  35  35  35  35  35  38  38  38  38  38  38  35  35  35  38  38  38  38  38  38  38  38  38  38  35  35  35  35  35  35  35  35  35  35  38  38  38  38  38  38  38  38  38  38  38  38  38  38  38  38  38  38  38  38  38  38  38  35  35  35  35  35  35  35  35  35  35  35  35  35  35  35  38  38  38  38  38  38  38  38  38  35  35  35  35  35  38  38  38  38  38  38  38  35  35  35  35  35  35  35  35  35  35  38  38  38  38  38  38  38  35  35  35  35  35  35  35  35  35  35  35  35  35  35  35  35  35  35  35  35  35  35  35  35  35  35  38  38  38  38  38  38  38  38  38  38  38  38  38  35  35  35  35  35  35  35  35  35  35  35  35  35  35  35  35  35  38  38  35  35  35  35  35  35  35  35  35  38  38  38  38  38  38  38  38  38  38  38  38  38  38  38  38  38  38  38  38  38  38  38  38  38  38  38  38  38  38  38  38  38  38  38  38  38  38  38  35  35  35  35  35  35  35  35  35  35  35  38  38 
 35  35  35  35  35  35  35  35  35  35  35  35  35  35  35  35  35  35  35  35  35  35  35  35  35  35  35  35  35  35  35  35  35  35  35  35  35  35  35  35  35  35  35  35  35  35  35  35  35  35  35  35  35  35  35  35  38  38  38  38  38  35  35  35  35  35  35  35  38  38  38  38  38  38  38  38  38  38  38  35  35  35  35  35  35  35  35  38  38  38  38  38  38  38  38  38  38  38  38  38  38  38  38  38  35  35  35  35  35  35  35  35  35  35  35  35  35  35  35  35  35  35  35  35  35  35  35  35  35  35  35  35  35  35  38  38  38  38  38  38  38  38  38  38  38  38  38  38  38  38  38  38  38  38  38  38  38  38  38  38  38  38  38  38  38  38  38  38  38  38  38  38  38  38  38  38  38  38  38  35  35  35  35  35  35  35  35  35  35  35  35  35  38  38  38  38  38  38  38  38  38  38  38  35  35  35  38  38  38  38  38  38  38  38  38  35  35  35  35  35  35  35  35  35  38  38  38  38  38  38  38  38  38  35  35  35  35  35  35  35  35  35  35  35  35  35  35  35  35  35  35  35  35  35  35  35  35  35  38  38  38  38  38  38  38  38  38  38  38  38  38  38  38  38  35  35  35  35  35  35  35  35  35  35  35  35  38  38  38  38  38  35  35  35  35  35  38  38  38  38  38  38  38  38  38  38  38  38  38  38  38  38  38  38  38  38  38  38  38  38  38  38  38  38  38  38  38  38  38  38  38  38  38  38  38  38  38  38  38  35  35  35  35  35  35  35  35  35  38  38 
   )
)
