;; Generated by Windstille Editor
(supertux-level
  (version 1)
  (name "Hello World")
  (width  500)
  (height 15)
  (background "arctis.png")
  (music  "Mortimers_chipdisko.mod")
  (bkgd_red    150)
  (bkgd_green  200)
  (bkgd_blue   255)
  (time  500)
  (gravity  10)
  (particle_system "snow")
  (theme "antarctica")
  (interactive-tm
   0  0  0  0  0  0  0  0  0  0  0  0  0  0  0  0  0  0  0  0  0  0  0  0  0  0  0  0  0  0  0  0  0  0  0  0  0  0  0  0  0  0  0  0  0  0  0  0  0  0  0  0  0  0  0  0  0  0  0  0  0  0  0  0  0  0  0  0  0  0  0  0  0  0  0  0  0  0  0  0  0  0  0  0  0  0  0  0  0  0  0  0  0  0  7  8  8  8  9  0  0  0  0  0  0  0  0  0  0  0  0  0  0  0  0  0  0  0  0  0  0  0  0  0  0  0  0  0  0  0  0  0  0  0  0  0  0  0  0  0  0  0  0  0  0  0  0  0  0  0  0  0  0  0  0  0  0  0  0  0  0  0  0  0  0  0  0  0  0  0  0  0  0  0  0  0  0  0  0  0  0  0  0  0  0  0  0  0  0  0  0  0  0  0  0  0  0  0  0  0  0  0  0  0  0  0  0  0  0  0  0  0  0  0  0  0  0  0  0  0  0  0  0  0  0  0  0  0  0  0  0  0  0  0  0  0  0  0  0  0  0  0  0  0  0  0  0  0  0  0  0  0  0  0  0  0  0  0  0  0  0  0  0  0  0  0  0  0  0  0  0  0  0  0  0  0  0  0  0  0  0  0  0  0  0  0  0  0  0  0  0  0  0  0  0  0  0  0  0  0  0  0  0  0  0  0  0  0  0  0  0  0  0  0  0  0  0  0  0  0  0  0  0  0  0  0  0  0  0  0  0  0  0  0  0  0  0  0  0  0  0  0  0  0  0  0  0  0  0  0  0  0  0  0  0  0  0  0  0  0  0  0  0  0  0  0  0  0  0  0  0  0  0  0  0  0  0  0  0  0  0  0  0  0  0  0  0  0  0  0  0  0  0  0  0  0  0  0  0  0  0  0  0  0  0  0  0  0  0  0  0  0  0  0  0  0  0  0  0  0  0  0  0  0  0  0  0  0  0  0  0  0  0  0  0  0  0  0  0  0  0  0  0  0  0  0  0  0  0  0  0  0  0  0  0  0  0  0  0  0  0  0  0  0  0  0  0  0  0  0  0  0  0  0  0  0  0  50 49 0  0  0  0  0  0  50 49 0  0  0  0  0  0  0  0  0  0  0  0  0  
   0  0  0  0  0  0  0  0  0  0  0  0  0  0  0  0  0  0  0  0  0  0  0  0  0  0  0  0  0  0  0  0  0  0  0  0  0  0  0  0  0  0  0  0  0  0  0  0  0  0  0  0  0  0  0  0  0  0  0  0  0  0  0  0  0  0  0  0  0  0  0  0  0  0  0  0  0  0  0  0  0  0  0  0  0  0  0  0  0  0  0  0  0  0  13 14 14 14 15 0  0  0  0  0  0  0  0  0  0  0  0  0  0  0  0  0  0  0  0  0  0  0  0  0  0  0  0  0  0  0  0  0  0  0  0  0  0  0  0  0  0  0  0  0  0  0  0  0  0  0  0  0  0  0  0  0  0  0  0  0  0  0  0  0  0  0  0  0  0  0  0  0  0  0  0  0  0  0  0  0  0  0  0  0  0  0  0  0  0  0  0  0  0  0  0  0  0  0  0  0  0  0  0  0  0  0  0  0  0  0  0  0  0  0  0  0  0  0  0  0  0  0  0  0  0  0  0  0  0  0  0  0  0  0  0  0  0  0  0  0  0  0  0  0  0  0  0  0  0  0  0  0  0  0  0  0  0  0  0  0  0  0  0  0  0  0  0  0  0  0  0  0  0  0  0  0  0  0  0  0  0  0  0  0  0  0  0  0  0  0  0  0  0  0  0  0  0  0  0  0  0  0  0  0  0  0  0  0  0  0  0  0  0  0  0  0  0  0  0  0  0  0  0  0  0  0  0  0  0  0  0  0  0  0  0  0  0  0  0  0  0  0  0  0  0  0  0  0  0  0  0  0  0  0  0  0  0  0  0  0  0  0  26 0  0  0  0  0  0  0  0  0  0  0  0  0  0  0  0  0  0  0  0  0  0  0  0  0  0  0  0  0  0  0  0  0  0  0  0  0  0  0  0  0  0  0  0  0  0  0  0  0  0  0  0  0  0  0  0  0  0  0  0  0  0  0  0  0  0  0  0  0  0  0  0  0  0  0  0  0  0  0  0  0  0  0  0  0  0  0  0  0  0  0  0  0  0  0  0  0  0  0  0  0  0  0  0  0  0  0  0  0  0  0  0  0  0  51 52 0  0  0  0  0  0  51 52 0  0  0  0  0  0  0  0  0  0  0  0  0  
   0  0  0  0  0  0  0  0  0  0  0  0  0  0  0  0  0  0  0  0  0  0  0  0  0  0  0  0  0  0  0  0  0  0  0  0  0  0  0  0  0  0  0  0  0  0  0  0  0  0  0  0  0  0  0  0  0  0  0  0  0  0  0  0  0  0  0  0  0  0  0  0  0  0  0  0  0  0  0  0  0  0  0  0  0  0  0  0  0  0  0  0  0  0  10 11 11 11 12 0  0  0  0  0  0  0  0  0  0  0  0  0  0  0  0  0  0  0  0  0  0  0  0  0  0  0  0  0  0  0  0  0  0  0  0  0  0  0  0  0  0  0  0  0  0  0  0  0  0  0  0  0  0  0  0  0  0  0  0  0  0  0  0  0  0  0  0  0  0  0  0  0  0  0  0  0  0  0  0  0  0  0  0  0  0  0  0  0  0  0  0  0  0  0  0  0  0  0  0  0  0  0  0  0  0  0  0  0  0  0  0  0  0  0  0  0  0  0  0  0  0  0  0  0  0  0  0  0  0  0  0  0  0  0  0  0  0  0  0  0  0  0  0  0  0  0  0  0  0  0  0  0  0  0  0  0  0  0  0  0  0  0  0  0  0  0  0  0  0  0  0  0  0  0  0  0  0  0  0  0  0  0  0  0  0  0  0  0  0  0  0  0  0  0  0  0  0  0  0  0  0  0  0  0  0  0  0  0  0  0  0  0  0  0  0  0  0  0  0  0  0  0  0  0  0  0  0  0  0  0  0  0  0  0  0  0  0  0  0  0  0  0  0  0  0  0  0  7  8  9  0  0  0  0  0  0  0  0  0  0  0  0  0  0  0  0  0  0  0  0  0  0  0  0  0  26 0  0  0  0  0  0  0  0  0  0  26 0  0  0  0  0  0  0  0  0  0  0  0  0  0  0  0  0  0  0  0  0  0  0  0  0  0  0  0  0  0  0  0  0  0  0  0  0  0  0  0  0  0  0  0  0  0  0  0  0  0  0  0  0  0  0  0  0  0  0  0  0  0  0  0  0  0  0  0  0  0  0  0  0  0  0  0  0  0  0  0  0  0  0  0  0  0  0  0  0  0  50 49 0  0  48 48 0  0  50 49 0  0  0  0  0  0  0  0  0  0  0  0  0  
   8  8  8  9  0  0  0  0  0  0  0  0  0  0  0  0  0  0  0  0  0  0  0  0  0  0  0  0  0  0  0  0  0  0  0  0  0  0  0  0  0  0  0  0  0  0  0  0  0  0  0  0  0  0  0  0  0  0  0  0  0  0  0  0  0  0  0  0  0  0  0  0  0  0  0  0  0  0  0  0  0  0  0  0  0  0  0  0  0  0  0  0  0  0  16 31 11 30 18 0  0  0  0  0  0  0  0  0  0  0  0  0  0  0  0  0  0  0  0  0  0  0  0  0  0  0  0  0  0  0  0  0  0  0  0  0  0  0  0  0  0  0  0  0  0  0  0  0  0  0  0  0  0  0  0  0  0  0  0  0  0  0  0  0  0  0  0  0  0  0  0  0  0  0  0  0  0  0  0  0  0  0  0  0  0  0  0  0  0  0  0  0  0  0  0  0  0  0  0  0  0  0  0  0  0  0  0  0  0  0  0  0  0  0  0  0  0  0  0  0  0  57 58 0  0  0  0  0  0  0  0  0  0  0  0  0  0  0  0  0  0  0  0  0  0  0  0  0  0  0  0  0  0  0  0  0  0  0  0  0  0  0  0  0  0  0  0  0  0  0  0  0  0  0  0  0  0  0  0  0  0  0  0  0  0  0  0  0  0  0  0  0  0  0  0  0  0  0  0  0  0  0  0  0  0  0  0  0  0  0  0  0  0  0  0  0  0  0  0  0  0  0  0  0  0  0  0  0  0  0  0  0  0  0  0  0  0  0  0  0  0  0  0  0  0  0  0  13 14 15 0  0  0  0  0  0  0  0  0  0  0  0  0  0  0  0  0  0  0  0  0  0  0  0  0  0  0  0  0  0  0  0  0  0  0  0  0  0  0  0  0  0  0  0  0  0  0  0  0  0  0  0  0  0  0  0  0  0  0  0  0  0  0  0  0  0  0  0  0  0  0  0  0  0  0  0  0  0  0  0  0  0  0  0  0  0  0  0  0  0  0  0  0  0  0  0  0  0  0  0  0  0  0  0  0  0  0  0  0  0  0  0  0  0  0  0  0  0  0  0  0  0  0  48 48 0  0  51 52 0  0  51 52 0  0  51 52 0  0  0  0  0  0  0  0  0  0  0  0  0  
   14 14 14 15 0  0  0  0  0  0  0  0  0  0  0  0  0  0  0  0  0  0  0  0  0  0  0  0  0  0  0  0  0  0  0  0  0  0  0  0  0  0  0  0  0  0  0  0  0  0  0  0  0  0  0  0  0  0  0  0  0  0  0  0  0  0  0  0  0  0  0  0  0  0  0  0  0  0  0  0  0  0  0  0  0  0  0  0  0  0  0  0  0  0  0  16 17 18 0  0  0  0  0  0  0  0  0  0  0  0  0  0  0  0  0  0  0  0  0  0  0  0  0  0  0  0  0  0  0  0  27 28 29 0  0  26 0  0  0  0  0  0  0  0  0  0  0  0  0  0  0  0  0  0  0  0  0  0  0  0  0  0  0  0  0  0  0  0  0  0  0  0  0  0  0  0  0  0  0  0  0  0  0  0  0  0  0  0  0  0  0  0  0  0  0  0  0  0  0  0  0  0  0  0  0  0  0  0  0  0  0  0  0  0  0  0  0  0  0  48 48 59 60 0  0  48 48 0  0  0  0  0  0  0  0  0  0  0  0  0  0  0  0  0  0  0  0  0  0  0  0  0  0  0  0  0  0  0  0  0  0  0  0  0  0  0  0  0  0  0  0  0  0  0  0  0  0  0  0  0  0  0  0  0  0  0  0  0  0  0  0  0  0  0  0  0  0  0  0  0  27 28 28 28 28 28 28 28 28 28 28 28 29 0  0  0  0  0  0  0  0  0  0  0  0  0  0  0  0  0  0  0  0  0  0  0  0  0  0  0  0  0  0  0  0  7  8  22 11 21 8  9  0  0  0  0  0  0  0  0  0  0  0  0  0  0  0  0  0  0  0  0  0  0  0  0  0  0  0  0  0  0  0  0  0  0  0  0  0  0  0  0  0  0  0  0  0  0  0  0  0  0  0  0  0  0  0  0  0  0  0  0  0  0  0  0  0  0  0  0  0  0  0  0  0  0  0  0  0  0  0  0  0  0  0  0  0  0  0  0  0  0  0  0  0  0  0  0  0  0  0  0  0  0  0  0  0  0  0  0  0  0  0  0  0  0  0  0  48 48 0  0  0  50 49 0  0  50 49 0  0  50 49 0  0  50 49 0  0  0  0  0  0  0  0  0  0  0  0  0  
   11 11 11 12 0  0  0  0  0  0  0  0  0  0  0  0  0  0  0  0  0  0  0  0  0  0  0  0  0  0  0  0  0  0  0  0  0  0  0  0  0  0  0  0  0  0  0  0  0  0  0  0  0  0  0  0  0  0  0  0  0  0  0  0  0  0  0  0  0  0  0  0  0  0  0  0  0  0  0  0  0  0  0  0  0  0  0  0  0  0  0  0  0  0  0  0  0  0  0  0  0  27 28 28 26 26 28 28 29 0  0  0  0  0  0  0  27 28 28 26 26 28 28 29 0  0  0  0  0  0  0  0  0  0  0  0  0  0  0  0  0  0  0  0  0  0  0  0  0  0  0  0  0  0  0  0  0  0  0  0  0  0  0  0  0  0  0  0  0  0  0  0  0  0  0  0  0  0  0  0  0  0  0  0  0  0  0  0  0  0  0  0  0  0  0  0  0  0  0  0  0  0  0  0  0  0  0  0  0  0  0  0  0  0  0  0  0  0  0  0  0  59 60 0  0  0  0  0  0  48 48 0  0  0  0  0  0  0  0  0  0  0  0  0  0  0  0  0  0  0  0  0  0  0  0  0  0  0  0  0  0  0  0  0  0  0  0  0  0  0  0  0  0  0  0  0  0  0  0  0  0  0  0  0  0  0  0  0  0  0  0  0  0  0  0  0  0  0  0  0  0  0  0  0  0  0  0  0  0  0  0  0  0  0  0  0  0  0  0  0  0  0  0  0  0  0  0  0  0  0  0  0  0  0  0  0  0  0  0  0  0  0  0  0  0  13 14 23 11 20 14 15 0  0  0  0  0  0  0  48 48 48 48 26 48 48 48 0  0  0  0  0  0  0  0  0  0  0  0  0  0  0  0  0  0  0  0  0  0  0  0  0  0  0  0  0  0  0  0  0  0  0  0  0  0  0  0  0  0  0  0  0  0  0  0  0  0  0  0  0  0  0  0  0  0  0  0  0  0  0  0  0  0  0  0  0  0  0  0  0  0  0  0  0  0  0  0  0  0  0  0  0  0  0  0  0  0  0  0  0  0  0  0  0  0  0  0  0  0  0  0  0  0  51 52 0  48 51 52 48 0  51 52 48 0  51 52 0  0  0  0  0  0  0  0  0  0  0  0  0  
   11 11 11 12 0  0  0  0  0  0  0  0  0  0  0  0  0  0  0  0  0  0  0  0  0  0  0  0  0  0  0  0  0  0  0  0  0  0  0  0  0  0  0  0  0  0  0  0  0  0  0  0  0  0  0  0  0  0  0  0  0  0  0  0  0  0  0  0  0  0  0  7  8  8  8  8  8  8  8  8  8  8  8  8  8  8  8  8  8  8  8  8  8  8  8  9  0  0  0  0  0  0  0  0  0  0  0  0  0  0  0  0  0  0  0  0  0  0  0  0  0  0  0  0  0  0  0  0  0  0  0  0  0  0  0  0  0  0  0  0  0  0  0  0  0  0  0  0  0  0  0  0  0  0  0  0  0  0  0  0  0  0  0  0  0  0  0  0  0  0  0  0  0  0  0  0  0  0  0  0  0  0  0  0  0  0  0  0  0  0  0  0  0  0  0  0  0  0  0  0  0  0  0  0  0  0  0  0  0  0  0  0  0  0  48 48 0  0  0  0  0  59 60 0  0  0  0  0  0  0  0  0  0  48 48 0  0  0  0  0  0  0  0  0  0  0  0  0  0  0  0  0  0  0  0  0  0  0  0  0  0  0  0  0  0  0  0  0  0  0  0  0  0  0  0  0  0  0  0  0  0  0  0  0  0  0  0  0  0  27 26 26 29 0  0  0  0  0  0  0  0  0  0  0  0  0  0  0  0  0  0  0  0  0  0  0  0  0  0  0  0  0  0  0  0  0  0  0  0  0  0  0  0  0  0  0  0  0  0  0  0  0  0  7  8  22 11 11 11 11 11 21 8  9  0  0  0  0  0  0  0  0  0  0  0  0  0  0  0  0  0  48 48 48 48 26 48 48 48 48 0  0  48 48 48 26 48 48 48 48 0  0  0  0  0  0  0  0  0  0  0  0  0  0  0  0  0  0  0  0  0  0  0  0  0  0  0  0  0  0  0  0  0  0  0  0  0  0  0  0  0  0  0  0  0  0  0  0  0  26 26 0  0  0  0  0  0  0  0  0  0  0  0  0  0  0  0  0  0  0  0  0  0  0  0  0  0  0  0  0  0  0  0  50 49 0  0  50 49 0  0  50 49 0  0  50 49 0  0  0  0  0  0  0  0  0  0  0  0  0  
   11 11 30 18 0  0  0  0  0  0  0  0  0  0  0  0  0  0  0  0  0  0  0  0  0  0  0  0  0  0  0  0  0  0  0  0  0  0  0  0  0  0  0  0  0  0  0  0  0  0  0  0  0  0  0  0  0  0  0  0  0  0  0  0  0  0  0  0  0  0  0  13 14 14 14 14 14 14 14 14 14 14 14 14 14 14 14 14 14 14 14 14 14 14 14 15 0  0  0  0  0  0  0  0  0  0  0  0  0  0  0  0  0  0  0  0  0  0  0  0  0  0  0  0  0  0  0  0  0  7  8  8  8  9  0  0  0  0  0  0  0  0  0  0  0  0  0  0  0  0  0  0  0  0  0  0  0  0  0  0  0  0  0  0  0  0  0  0  57 58 0  0  0  0  0  0  0  0  0  0  0  0  0  0  0  0  0  0  0  0  0  0  0  0  0  0  0  0  0  0  0  0  0  0  0  0  0  0  0  0  0  0  0  0  0  0  0  0  0  0  0  59 60 0  0  0  0  0  0  0  0  0  0  0  0  0  0  48 48 0  0  0  0  0  0  0  0  0  0  0  0  0  0  0  0  0  0  0  0  0  0  0  0  0  0  0  0  0  0  0  0  0  0  0  0  0  0  0  0  0  0  0  0  0  0  0  0  0  0  0  0  0  0  0  0  0  0  0  0  0  0  0  0  0  0  0  0  0  0  0  0  0  0  0  0  0  0  0  0  0  0  0  0  0  0  0  0  0  0  0  0  0  0  0  0  0  0  0  0  0  0  0  0  13 14 23 11 11 11 11 11 20 14 15 0  0  0  0  0  0  0  0  0  0  0  0  0  0  0  0  0  0  0  0  0  0  0  0  0  0  0  0  0  0  0  0  0  0  0  0  0  0  0  0  0  0  0  0  0  0  0  0  0  0  0  0  0  0  0  0  0  0  0  0  0  0  0  0  0  0  0  0  0  0  0  0  0  0  0  0  0  0  0  0  0  0  0  0  0  0  0  0  0  0  0  0  0  0  0  0  0  0  0  0  0  0  0  0  0  0  0  0  0  0  48 48 0  0  0  0  0  0  0  51 52 0  0  51 52 0  0  51 52 0  0  51 52 0  0  0  0  0  0  0  0  0  0  0  0  0  
   11 30 18 0  0  0  0  0  0  0  0  0  0  0  0  0  0  0  0  0  0  0  0  0  0  0  0  0  0  0  0  0  0  0  0  0  0  0  0  0  0  0  0  0  0  0  0  0  0  0  0  0  0  0  0  0  0  0  0  0  0  0  0  0  0  0  0  0  0  0  0  10 11 11 11 11 11 11 11 11 11 11 11 11 11 11 11 11 11 11 11 11 11 11 11 12 0  0  0  7  8  8  8  8  8  8  8  8  8  8  9  0  0  0  7  8  8  8  9  0  0  7  8  8  8  9  0  0  0  13 14 14 14 15 0  0  0  0  0  0  0  0  0  0  0  0  0  0  0  0  0  0  0  0  0  0  0  0  0  0  0  0  0  0  0  0  0  0  59 60 0  0  0  0  0  0  0  0  0  0  0  0  0  0  0  0  0  0  0  0  0  0  0  0  0  0  0  0  0  0  0  0  0  0  0  0  0  0  0  0  0  0  0  0  0  0  0  0  0  0  0  59 60 0  0  0  0  0  0  0  0  0  0  0  0  0  0  0  0  0  0  48 48 0  0  0  0  0  0  0  0  0  0  0  0  0  0  0  0  0  0  0  0  0  0  0  0  0  0  0  0  0  0  0  0  0  0  0  0  0  0  0  0  0  0  0  0  0  0  0  0  0  0  0  0  0  0  0  0  0  0  0  0  0  0  0  0  0  0  0  0  0  0  0  0  0  0  0  0  0  0  0  0  7  8  8  8  9  0  0  0  0  0  0  0  0  0  0  0  0  0  7  8  22 11 11 11 11 11 11 11 11 11 21 8  9  0  0  0  0  0  0  0  0  0  0  0  0  0  0  0  0  0  0  0  0  0  0  0  0  0  0  0  0  0  0  0  0  0  0  0  0  0  0  0  7  8  8  8  8  8  8  8  8  8  8  8  8  8  8  9  0  0  0  0  0  0  0  0  0  0  0  0  0  0  0  0  0  0  0  0  0  0  0  0  0  0  0  0  0  0  0  0  0  0  0  0  0  0  0  0  0  0  0  0  0  0  0  0  0  0  0  0  0  0  0  0  0  0  0  0  0  0  50 49 0  0  50 49 0  0  50 49 0  0  50 49 0  0  0  0  0  0  0  0  0  0  0  0  0  
   11 12 0  0  0  0  0  0  0  0  0  0  0  0  0  0  0  0  0  0  0  0  0  0  0  0  0  0  0  0  0  0  0  0  0  0  0  0  0  0  0  0  0  0  0  0  0  0  0  0  0  0  0  0  0  0  0  0  0  0  0  0  0  0  7  8  8  8  9  0  0  16 31 11 11 11 11 11 11 11 11 11 11 11 11 11 11 11 11 11 11 11 11 11 30 18 0  0  0  13 14 14 14 14 14 14 14 14 14 14 15 0  0  0  13 14 14 14 15 0  0  13 14 14 14 15 0  0  0  10 11 11 11 12 0  0  0  0  0  0  0  0  0  0  57 58 0  0  0  0  0  0  0  0  0  0  7  8  8  8  8  8  8  8  8  8  8  8  59 60 9  0  0  0  7  8  8  9  0  0  0  0  0  0  0  0  0  0  0  0  0  0  0  0  0  0  0  0  0  0  0  0  0  0  0  0  0  0  0  0  0  0  0  0  0  0  0  0  48 48 0  59 60 0  0  0  0  0  0  0  0  0  0  0  0  0  0  0  0  0  0  0  0  0  0  48 48 0  0  0  0  0  0  0  0  0  0  0  0  0  0  0  0  0  0  0  0  0  0  0  0  0  0  0  0  0  0  0  0  0  0  0  0  0  0  0  0  0  0  0  0  0  0  0  0  0  0  0  0  0  0  0  0  0  0  0  0  0  0  0  0  0  0  0  0  0  0  0  0  0  0  0  0  13 14 14 14 15 0  0  0  0  0  0  0  0  0  0  0  0  0  13 14 23 11 11 11 11 11 19 11 11 11 20 14 15 0  0  0  0  0  0  0  0  0  0  0  0  0  0  0  0  0  0  0  0  0  0  0  0  0  0  0  0  0  0  0  0  0  0  0  0  0  0  0  13 14 14 14 14 14 14 14 14 14 14 14 14 14 14 15 0  0  0  0  0  0  0  0  0  0  0  0  0  0  0  0  0  0  0  0  0  0  0  0  0  0  0  0  0  0  0  0  0  0  0  0  0  0  0  0  0  0  0  0  0  0  0  0  0  57 58 0  0  0  0  0  0  0  0  0  0  0  51 52 48 0  51 52 0  48 51 52 0  48 51 52 0  0  0  0  0  0  0  0  0  0  0  0  0  
   11 12 0  0  0  0  0  0  0  0  0  0  0  0  0  0  0  0  0  0  0  0  0  0  0  0  0  0  0  0  0  0  0  0  0  0  0  0  0  0  0  0  7  8  8  8  9  0  0  0  0  0  0  7  8  8  8  9  0  0  0  0  0  0  13 14 14 14 15 0  0  0  10 11 11 11 11 19 11 11 11 11 11 11 11 11 11 11 11 11 11 11 11 30 18 0  0  0  0  10 11 11 11 11 11 11 11 11 11 11 12 0  0  0  10 11 11 11 12 0  0  10 11 11 11 12 0  0  0  16 17 17 17 18 0  0  0  0  0  0  57 58 0  0  59 60 0  0  0  0  0  0  0  0  0  0  13 14 14 14 14 14 14 14 14 14 14 14 14 14 15 0  0  0  13 14 14 15 0  0  0  0  0  0  0  0  0  0  0  0  0  0  0  0  0  0  0  0  0  0  0  0  0  0  0  0  48 48 48 48 48 0  0  0  0  0  0  0  0  0  0  59 60 0  0  0  0  0  0  0  0  0  0  0  0  0  0  0  0  0  0  0  0  0  0  0  0  0  0  48 48 0  0  0  0  0  0  0  7  8  8  8  8  8  8  8  8  8  9  0  0  0  0  0  0  0  0  0  0  0  0  0  0  0  0  0  0  0  57 58 48 48 57 58 0  0  0  0  0  0  0  0  0  0  0  0  0  0  0  0  0  0  0  0  0  0  7  8  8  8  8  8  8  22 11 11 11 21 9  0  0  0  0  0  0  0  0  0  0  7  8  22 11 11 11 11 11 11 11 11 11 11 11 11 11 21 8  9  0  0  0  0  0  48 48 48 48 48 48 48 48 0  0  48 48 48 48 48 48 48 48 48 0  0  48 48 48 48 48 48 48 0  0  0  0  10 11 11 11 11 11 11 11 11 11 11 11 11 11 11 21 8  9  0  0  0  0  0  0  0  0  0  0  0  0  0  0  0  0  0  0  0  0  0  0  0  0  0  0  57 58 0  0  0  0  0  0  0  0  0  0  0  0  0  0  0  0  0  0  0  59 60 0  0  0  0  0  0  0  0  0  0  0  50 49 0  0  0  0  0  0  50 49 0  0  0  0  0  0  0  0  0  0  0  0  0  0  0  0  0  
   11 21 8  8  8  8  8  8  8  8  8  9  0  0  0  0  0  0  0  7  8  8  8  9  0  0  0  0  0  0  0  7  8  8  8  9  0  0  0  0  0  0  13 14 14 14 15 0  0  0  0  0  0  13 14 14 14 15 0  0  0  0  0  0  10 11 11 19 12 0  0  0  10 11 11 11 11 11 11 11 11 11 11 11 11 11 11 11 11 11 11 11 11 12 0  0  0  0  0  16 31 11 11 11 11 11 11 11 11 30 18 0  0  0  16 31 11 11 12 0  0  10 11 11 30 18 0  0  0  0  0  0  0  0  0  0  7  8  8  8  59 60 8  8  59 60 8  8  8  8  8  9  0  0  0  0  10 11 11 11 11 11 11 11 11 11 11 11 11 11 12 0  0  0  10 11 11 12 0  0  0  0  0  0  0  0  0  0  0  0  0  0  0  0  0  0  0  0  0  0  0  57 58 0  0  0  0  0  0  0  0  0  0  0  57 58 0  0  0  0  0  59 60 0  0  0  0  0  0  0  0  0  0  0  0  0  0  0  0  0  0  0  0  0  0  0  0  0  0  0  0  0  0  48 48 0  0  0  13 14 14 14 14 14 14 14 14 14 15 0  0  0  0  0  0  0  0  0  0  0  0  0  0  0  57 58 48 48 59 60 0  0  59 60 48 48 57 58 0  0  0  0  0  0  0  0  0  0  0  0  0  0  0  0  0  0  13 14 14 14 14 14 14 23 11 11 11 20 15 0  0  0  0  0  0  0  0  0  0  13 14 23 11 11 11 11 11 11 11 11 11 11 11 11 11 20 14 15 0  0  0  0  0  0  0  0  0  0  0  0  0  0  0  0  0  0  0  0  0  0  0  0  0  0  0  0  0  0  0  0  0  0  0  0  0  16 31 11 11 11 11 11 11 11 11 11 11 11 11 11 20 14 15 0  0  0  0  0  0  0  0  0  0  0  0  0  0  57 58 0  0  0  0  0  0  0  0  0  0  59 60 0  0  0  0  0  0  0  0  0  57 58 0  0  0  0  0  0  0  0  59 60 0  0  0  0  0  0  0  0  0  0  7  51 52 8  8  8  8  8  8  51 52 8  8  8  8  8  8  8  8  8  8  8  8  8  8  8  8  8  
   11 20 14 14 14 14 14 14 14 14 14 15 0  0  0  0  0  0  0  13 14 14 14 15 0  0  0  0  0  0  0  13 14 14 14 15 0  0  0  0  0  0  10 19 11 11 12 0  0  0  0  0  0  10 11 11 11 12 0  0  0  0  0  0  16 31 11 30 18 0  0  0  10 11 11 11 11 11 11 11 11 11 11 11 11 11 11 11 11 11 11 11 30 18 0  0  0  0  0  0  16 17 17 17 17 17 17 17 17 18 0  0  0  0  0  16 17 17 18 0  0  16 17 17 18 0  0  0  0  0  0  0  0  0  0  0  13 14 14 14 14 14 14 14 14 14 14 14 14 14 14 15 0  0  0  0  16 31 11 11 11 11 11 11 11 11 11 11 11 30 18 0  0  0  16 17 17 18 0  0  0  0  0  0  0  0  0  0  0  0  57 58 0  0  0  0  48 48 0  0  0  59 60 0  0  0  0  0  0  0  0  0  0  0  59 60 0  0  0  0  0  59 60 0  0  0  0  0  0  0  0  0  0  0  0  0  0  0  0  0  0  0  0  0  0  0  0  0  0  0  0  0  0  0  0  0  0  0  10 11 11 11 11 11 11 11 11 11 12 0  0  7  8  8  8  8  8  8  8  8  8  9  0  0  59 60 0  0  59 60 0  0  59 60 0  0  59 60 0  0  7  8  8  8  8  8  8  8  8  8  8  8  9  0  0  0  10 11 11 11 11 11 11 11 11 11 11 11 12 0  0  0  0  0  0  0  0  7  8  22 11 11 11 11 11 11 11 11 11 11 11 11 11 11 11 11 11 21 8  9  0  0  0  0  0  0  0  0  0  0  0  0  0  0  0  0  0  0  0  0  0  0  0  0  0  0  0  0  0  0  0  0  0  0  0  0  16 17 31 11 11 11 11 11 11 11 11 11 11 11 11 11 12 0  0  0  0  0  7  8  8  8  8  8  8  8  8  59 60 8  8  8  8  8  8  8  8  8  8  59 60 8  8  8  8  8  8  8  8  8  59 60 8  8  8  8  8  8  8  8  59 60 9  0  0  0  0  0  0  0  0  0  13 14 14 14 14 14 14 14 14 14 14 14 14 14 14 14 14 14 14 14 14 14 14 14 14 14 14 14 
   11 11 11 11 11 11 11 11 11 11 11 12 0  0  0  0  0  0  0  10 11 11 11 12 0  0  0  0  0  0  0  10 19 11 11 12 0  0  0  0  0  0  16 31 11 30 18 0  0  0  0  0  0  16 31 11 30 18 0  0  0  0  0  0  0  16 17 18 0  0  0  0  10 11 11 11 11 11 11 11 11 11 11 11 11 11 11 11 19 11 11 30 18 0  0  0  0  0  0  0  0  0  0  0  0  0  0  0  0  0  0  0  0  0  0  0  0  7  8  8  8  8  8  8  8  8  8  8  8  8  8  8  8  8  8  8  22 11 11 11 11 11 11 11 11 11 11 11 11 11 11 12 0  0  0  0  0  10 11 11 11 11 11 11 11 11 11 11 30 18 0  0  0  0  0  0  0  0  0  0  0  0  7  57 58 9  0  0  0  7  59 60 9  0  0  0  0  0  0  0  7  59 60 9  0  0  0  0  0  0  0  0  0  7  59 60 9  0  0  0  7  59 60 9  0  0  0  0  0  0  0  0  0  0  0  0  0  0  0  0  0  0  0  0  0  0  0  0  0  0  0  0  0  0  0  0  0  0  16 17 31 11 11 11 11 11 11 30 18 0  0  13 14 14 14 14 14 14 14 14 14 15 48 48 59 60 0  0  59 60 0  0  59 60 0  0  59 60 48 48 13 14 14 14 14 14 14 14 14 14 14 14 15 0  0  0  10 11 11 11 11 11 11 11 11 11 11 11 12 0  0  0  0  0  0  0  0  13 14 23 11 11 11 11 19 11 11 11 11 11 11 11 11 19 11 11 11 20 14 15 0  0  0  0  0  0  0  0  0  0  0  0  0  0  0  0  0  0  0  0  0  0  0  0  0  0  0  0  0  0  0  0  0  0  0  0  0  0  16 31 11 11 11 11 11 11 11 11 11 11 11 11 12 0  0  0  0  0  13 14 14 14 14 14 14 14 14 14 14 14 14 14 14 14 14 14 14 14 14 14 14 14 14 14 14 14 14 14 14 14 14 14 14 14 14 14 14 14 14 14 14 14 15 0  0  0  0  0  0  0  0  0  10 11 11 11 11 11 11 11 11 11 11 11 11 11 11 11 11 11 11 11 11 11 11 11 11 11 11 11 
   11 11 11 19 11 11 11 11 11 11 11 12 0  0  0  0  0  0  0  10 11 11 19 12 0  0  0  0  0  0  0  16 31 11 30 18 0  0  0  0  0  0  0  16 17 18 0  0  0  0  0  0  0  0  16 17 18 0  0  0  0  0  0  0  0  0  0  0  0  0  0  0  16 17 31 11 11 11 11 11 11 11 11 11 11 11 11 11 11 11 11 12 0  0  0  0  0  0  0  0  0  0  0  0  0  0  0  0  0  0  0  0  0  0  0  0  0  13 14 14 14 14 14 14 14 14 14 14 14 14 14 14 14 14 14 14 23 11 11 11 11 11 11 11 11 11 11 11 11 11 30 18 0  0  0  0  0  16 31 11 11 11 11 11 11 11 11 11 12 0  0  0  0  0  0  0  0  0  0  0  0  0  13 14 14 15 0  0  0  13 14 14 15 0  0  0  0  0  0  0  13 14 14 15 0  0  0  0  0  0  0  0  0  13 14 14 15 0  0  0  13 14 14 15 0  0  0  0  0  0  0  0  0  0  0  0  0  0  0  0  0  0  0  0  0  0  0  0  0  0  0  0  0  0  0  0  0  0  0  0  10 11 11 11 11 11 11 12 0  0  0  10 11 11 11 11 11 11 11 11 11 12 0  0  59 60 0  0  59 60 0  0  59 60 0  0  59 60 0  0  10 11 11 11 11 11 11 11 11 11 11 11 12 0  0  0  10 11 11 11 11 11 11 11 11 11 11 11 12 0  0  0  0  0  0  0  0  10 11 11 11 11 11 11 11 11 11 11 11 11 11 11 11 11 11 11 11 11 11 12 0  0  0  0  0  0  0  0  0  0  0  0  0  0  0  0  0  0  0  0  0  0  0  0  0  0  0  0  0  0  0  0  0  0  0  0  0  0  0  16 31 11 11 11 11 11 11 11 11 11 11 11 12 0  0  0  0  0  10 11 11 11 11 11 11 11 11 11 11 11 11 11 11 11 11 11 11 11 11 11 11 11 11 11 11 11 11 11 11 11 11 11 11 11 11 11 11 11 11 11 11 11 12 0  0  0  0  0  0  0  0  0  16 31 11 11 11 11 11 11 11 11 11 11 11 11 11 11 11 11 11 11 11 11 11 11 11 11 11 11 
      )

  (objects
  )
   )


;; EOF ;;
