;; Generated by Windstille Editor
(supertux-level
  (version 1)
  (name "Hello World")
  (width  500)
  (height 15)
  (background "arctis.png")
  (music  "Mortimers_chipdisko.mod")
  (bkgd_red    150)
  (bkgd_green  200)
  (bkgd_blue   255)
  (time  500)
  (gravity  10)
  (particle_system "snow")
  (theme "antarctica")
  (interactive-tm
   0  0  0  0  0  0  0  0  0  0  0  0  0  0  0  0  0  0  0  0  0  0  0  0  0  0  0  0  0  0  0  0  0  0  0  0  0  0  0  0  0  0  0  0  0  0  0  0  0  0  0  0  0  0  0  0  0  0  0  0  0  0  0  0  0  0  0  0  0  0  0  0  0  0  0  0  0  0  0  0  0  0  0  0  0  0  0  0  0  0  0  0  0  0  0  0  0  0  0  0  0  0  0  0  0  0  0  0  0  0  0  0  0  0  0  0  0  0  0  0  0  0  0  0  0  0  0  0  0  0  0  0  0  0  0  0  0  0  0  0  0  0  0  0  0  0  0  0  0  0  0  0  0  0  0  0  0  0  0  0  0  0  0  0  0  0  0  0  0  0  0  0  0  0  0  0  0  0  0  0  0  0  0  0  0  0  0  0  0  0  0  0  0  0  0  0  0  0  0  0  0  0  0  0  0  0  0  0  0  0  0  0  0  0  0  0  0  0  0  0  0  0  0  0  0  0  0  0  0  0  0  0  0  0  0  0  0  0  0  0  0  0  0  0  0  0  0  0  0  0  0  0  0  0  0  0  0  0  0  0  0  0  0  0  0  0  0  0  0  0  0  0  0  0  0  0  0  0  0  0  0  0  0  0  0  0  0  0  0  0  0  0  0  0  0  0  0  0  0  0  0  0  0  0  0  0  0  0  0  0  0  0  0  0  0  0  0  0  0  0  0  0  0  0  0  0  0  0  0  0  0  0  0  0  0  0  0  0  0  0  0  0  0  0  0  0  0  0  0  0  0  0  0  0  0  0  0  0  0  0  0  0  0  0  0  0  0  0  0  0  0  0  0  0  0  0  0  0  0  0  0  0  0  0  0  0  0  0  0  0  0  0  0  0  0  0  0  0  0  0  0  0  0  0  0  0  0  0  0  0  0  0  0  0  0  0  0  0  0  0  0  0  0  0  0  0  0  0  0  0  0  0  0  0  0  0  0  0  0  0  0  0  0  0  0  0  0  0  0  0  0  0  0  0  0  0  0  0  0  0  0  0  0  0  0  0  0  0  0  0  0  0  0  0  0  0  0  0  0  0  0  0  0  0  0  0  0  0  0  0  0  0  0  0  0  0  0  0  0  0  
   0  0  0  0  0  0  0  0  0  0  0  0  0  0  0  0  0  0  0  0  0  0  0  0  0  0  0  0  0  0  0  0  0  0  0  0  0  0  0  0  0  0  0  0  0  0  0  0  0  0  0  0  0  0  0  0  0  0  0  0  0  0  0  0  0  0  0  0  0  0  0  0  0  0  0  0  0  0  0  0  0  0  0  0  0  0  0  0  0  0  0  0  0  0  0  0  0  0  0  0  0  0  0  0  0  0  0  0  0  0  0  0  0  0  0  0  0  0  0  0  0  0  0  0  0  0  0  0  0  0  0  0  0  0  0  0  0  0  0  0  0  0  0  0  0  0  0  0  0  0  0  0  0  0  0  0  0  0  0  0  0  0  0  0  0  0  0  0  0  0  0  0  0  0  0  0  0  0  0  0  0  0  0  0  0  0  0  0  0  0  0  0  0  0  0  0  0  0  0  0  0  0  0  0  0  0  0  0  0  0  0  0  0  0  0  0  0  0  0  0  0  0  0  0  0  0  0  0  0  0  0  0  0  0  0  0  0  0  0  0  0  0  0  0  0  0  0  0  0  0  0  0  0  0  0  0  0  0  0  0  0  0  0  0  0  0  0  0  0  0  0  0  0  0  0  0  0  0  0  0  0  0  0  0  0  0  0  0  0  0  0  0  0  0  0  0  0  0  0  0  0  0  0  0  0  0  0  0  0  0  0  0  0  0  0  0  0  0  0  0  0  0  0  0  0  0  0  0  0  0  0  0  0  0  0  0  0  0  0  0  0  0  0  0  0  0  0  0  0  0  0  0  0  0  0  0  0  0  0  0  0  0  0  0  0  0  0  0  0  0  0  0  0  0  0  0  0  0  0  0  0  0  0  0  0  0  0  0  0  0  0  0  0  0  0  0  0  0  0  0  0  0  0  0  0  0  0  0  0  0  0  0  0  0  0  0  0  0  0  0  0  0  0  0  0  0  0  0  0  0  0  0  0  0  0  0  0  0  0  0  0  0  0  0  0  0  0  0  0  0  0  0  0  0  0  0  0  0  0  0  0  0  0  0  0  0  0  0  0  0  0  0  0  0  0  0  0  0  0  0  0  0  0  0  0  0  0  0  0  0  0  0  0  0  0  0  0  0  0  0  
   0  0  0  0  0  0  0  0  0  0  0  0  0  0  0  0  0  0  0  0  0  0  0  0  0  0  0  0  0  0  0  0  0  0  0  0  0  0  0  0  0  0  0  0  0  0  0  0  0  0  0  0  0  0  0  0  0  0  0  0  0  0  0  0  0  0  0  0  0  0  0  0  0  0  0  0  0  0  0  0  0  0  0  0  0  0  0  0  0  0  0  0  0  0  0  0  0  0  0  0  0  0  0  0  0  0  0  0  0  0  0  0  0  0  0  0  0  0  0  0  0  0  0  0  0  0  0  0  0  0  0  0  0  0  0  0  0  0  0  0  0  0  0  0  0  0  0  0  0  0  0  0  0  0  0  0  0  0  0  0  0  0  0  0  0  0  0  0  0  0  0  0  0  0  0  0  0  0  0  0  0  0  0  0  0  0  0  0  0  0  0  0  0  0  0  0  0  0  0  0  0  0  0  0  0  0  0  0  0  0  0  0  0  0  0  0  0  0  0  0  0  0  0  0  0  0  0  0  0  0  0  0  0  0  0  0  0  0  0  0  0  0  0  0  0  0  0  0  0  0  0  0  0  0  0  0  0  0  0  0  0  0  0  0  0  0  0  0  0  0  0  0  0  0  0  0  0  0  0  0  0  0  0  0  0  0  0  0  0  0  0  0  0  0  0  0  0  0  0  0  0  0  0  0  0  0  0  0  0  0  0  0  0  0  0  0  0  0  0  0  0  0  0  0  0  0  0  0  0  0  0  0  0  0  0  0  0  0  0  0  0  0  0  0  0  0  0  0  0  0  0  0  0  0  0  0  0  0  0  0  0  0  0  0  0  0  0  0  0  0  0  0  0  0  0  0  0  0  0  0  0  0  0  0  0  0  0  0  0  0  0  0  0  0  0  0  0  0  0  0  0  0  0  0  0  0  0  0  0  0  0  0  0  0  0  0  0  0  0  0  0  0  0  0  0  0  0  0  0  0  0  0  0  0  0  0  0  0  0  0  0  0  0  0  0  0  0  0  0  0  0  0  0  0  0  0  0  0  0  0  0  0  0  0  0  0  0  0  0  0  0  0  0  0  0  0  0  0  0  0  0  0  0  0  0  0  0  0  0  0  0  0  0  0  0  0  0  0  0  0  
   0  0  0  0  0  0  0  0  0  0  0  0  0  0  0  0  0  0  0  0  0  0  0  0  0  0  0  0  0  0  0  0  0  0  0  0  0  0  0  0  0  0  0  0  0  0  0  0  0  0  0  0  0  0  0  0  0  0  0  0  26 26 0  0  0  0  0  0  0  0  0  0  0  0  0  0  0  0  0  0  0  0  0  0  0  0  0  0  0  0  0  0  0  0  0  0  0  0  0  0  0  0  0  0  0  0  0  0  0  0  0  0  0  0  0  0  0  0  0  0  0  0  0  0  0  0  0  0  0  0  0  0  0  0  0  0  0  0  0  0  0  0  0  0  0  0  0  0  0  0  0  0  0  0  0  0  0  0  0  0  0  0  0  0  0  0  0  0  0  0  0  0  0  0  0  0  0  0  0  0  0  0  0  0  0  0  0  0  0  0  0  0  0  0  0  0  0  0  0  0  0  0  0  0  0  0  0  0  0  0  0  0  0  0  0  0  0  0  0  0  0  0  0  0  0  0  0  0  0  0  0  0  0  0  0  0  0  0  0  0  0  0  0  0  0  0  0  0  0  0  0  0  0  0  27 28 28 26 26 28 28 29 0  0  0  0  0  0  0  0  0  0  0  0  0  0  0  0  0  0  0  0  0  0  0  0  0  0  0  0  0  0  0  0  0  0  0  0  0  0  0  0  0  0  0  0  0  0  0  0  0  0  0  0  0  0  0  0  0  0  0  0  0  0  0  0  0  0  0  0  0  0  0  0  0  0  0  0  0  0  0  0  0  0  0  0  0  0  0  0  0  0  0  0  0  0  0  0  0  0  0  0  0  0  0  0  0  0  0  0  0  0  0  0  0  0  0  0  0  0  0  0  0  0  0  0  0  0  0  0  0  0  0  0  0  0  0  0  0  0  0  0  0  0  0  0  0  0  0  0  0  0  0  0  0  0  0  0  0  0  0  0  0  0  0  0  0  0  0  0  0  0  0  0  0  0  0  0  0  0  0  0  0  0  0  0  0  0  0  0  0  0  0  0  0  0  0  0  0  0  0  0  0  0  0  0  0  0  0  0  0  0  0  0  0  0  0  0  0  0  0  0  0  0  0  0  0  0  0  0  0  0  0  0  0  0  0  0  0  0  
   8  8  9  0  0  0  0  0  0  0  0  0  0  0  0  0  0  0  0  0  0  0  0  0  0  0  0  0  0  0  0  0  0  0  0  0  0  0  0  0  0  0  0  0  0  0  0  0  0  0  0  0  0  0  26 26 0  0  0  0  0  0  0  0  0  0  0  0  0  0  0  0  0  0  0  0  0  0  0  0  0  0  0  0  0  0  0  0  0  0  0  0  0  0  0  0  0  0  26 26 0  0  0  0  0  0  0  0  0  0  0  0  0  0  0  0  0  0  0  0  0  0  0  0  0  0  0  0  0  0  0  0  0  0  0  0  0  0  0  0  0  0  0  0  0  0  0  0  0  0  0  0  0  0  0  0  0  0  0  0  0  0  0  0  0  0  0  0  0  0  0  0  0  0  0  0  0  0  0  0  0  0  0  0  0  0  0  0  0  0  0  0  0  0  0  0  0  0  0  0  0  0  0  0  0  0  0  0  0  0  0  0  0  0  0  0  0  0  0  0  0  0  0  0  0  0  0  0  0  0  0  0  0  0  0  0  0  0  0  0  0  0  0  0  0  0  0  0  0  0  0  0  0  0  0  0  0  0  0  0  0  0  0  0  0  0  0  0  0  0  0  0  0  0  0  0  0  0  0  0  0  0  0  0  0  0  0  0  0  0  0  0  0  0  0  0  0  0  0  0  0  0  0  0  0  0  0  0  0  0  0  0  0  0  0  0  0  0  0  0  0  0  0  0  0  0  0  0  0  0  0  0  0  0  0  0  0  0  0  0  0  0  0  0  0  0  0  0  0  0  0  0  0  0  0  0  0  0  0  0  0  0  0  0  0  0  0  0  0  0  0  0  0  0  0  0  0  0  0  0  0  0  0  0  0  0  0  0  0  0  0  0  0  0  0  0  0  0  0  0  0  0  0  0  0  0  0  0  0  0  0  0  0  0  0  0  0  0  0  0  0  0  0  0  0  0  0  0  0  0  0  0  0  0  0  0  0  0  0  0  0  0  0  0  0  0  0  0  0  0  0  0  0  0  0  0  0  0  0  0  0  0  0  0  0  0  0  0  0  0  0  0  0  0  0  0  0  0  0  0  0  0  0  0  0  0  0  0  0  0  0  0  0  0  0  0  0  0  0  0  
   14 14 15 0  0  0  0  0  0  0  0  0  0  0  0  0  0  0  0  0  0  0  0  0  0  0  0  0  0  0  0  0  0  0  0  0  0  0  0  0  0  0  0  0  0  0  0  0  26 26 0  0  0  0  0  0  0  0  0  0  0  0  0  0  0  0  0  0  0  0  0  0  0  0  0  0  0  0  0  0  0  0  0  0  0  0  0  0  0  0  0  0  0  0  0  0  0  0  0  0  0  0  0  0  0  0  0  0  0  0  0  0  0  0  0  0  0  0  0  0  0  0  0  0  0  0  0  0  0  0  0  0  0  0  0  0  0  0  0  0  0  0  0  0  0  0  0  0  0  0  0  0  0  0  0  0  0  0  0  0  0  0  0  0  0  0  0  0  0  0  0  0  0  0  0  0  0  0  0  0  0  0  0  0  0  0  0  0  0  0  0  0  0  0  0  0  0  0  0  0  0  0  0  0  0  0  0  0  0  0  0  0  0  0  0  0  0  0  0  0  0  0  0  0  0  0  0  0  0  0  0  0  0  0  0  0  0  0  0  0  0  0  0  0  0  0  0  0  0  0  0  0  0  0  0  0  0  0  0  0  0  0  0  0  0  0  0  0  0  0  0  0  0  0  0  0  0  0  0  0  0  0  0  0  0  0  0  0  0  0  0  0  0  0  0  0  0  0  0  0  0  0  0  0  0  0  0  0  0  0  0  0  0  0  0  0  0  0  0  0  0  0  0  0  0  0  0  0  0  0  0  0  0  0  0  0  0  0  0  0  0  0  0  0  0  0  0  0  0  0  0  0  0  0  0  0  0  0  0  0  0  7  8  8  8  8  8  8  8  8  9  0  0  0  0  0  0  0  0  0  0  0  0  0  0  0  0  0  0  0  0  0  0  0  0  0  0  0  0  0  0  0  0  0  0  0  0  0  0  0  0  0  0  0  0  0  0  0  0  0  0  0  0  0  0  0  0  0  0  0  0  0  0  0  0  0  0  0  0  0  0  0  0  0  0  0  0  0  0  0  0  0  0  0  0  0  0  0  0  0  0  0  0  0  0  0  0  0  0  0  0  0  0  0  0  0  0  0  0  0  0  0  0  0  0  0  0  0  0  0  0  0  0  0  0  0  0  0  0  0  
   11 11 12 0  0  0  0  0  0  0  0  0  0  0  0  0  0  0  0  0  0  0  0  0  0  0  0  0  0  0  0  0  0  0  0  0  0  0  0  0  0  0  26 26 0  0  0  0  0  0  0  0  0  0  0  0  0  0  0  7  8  8  9  0  0  0  0  0  0  0  0  0  0  0  0  0  0  0  0  0  0  0  0  0  0  0  0  0  0  0  0  0  0  0  0  0  0  0  0  0  0  0  0  0  0  0  0  0  0  0  0  0  0  0  0  0  0  0  0  0  0  0  0  0  0  0  0  0  0  0  0  0  0  0  0  0  0  0  0  0  0  0  0  0  0  0  0  0  0  0  0  0  0  0  0  0  0  27 28 26 26 28 29 0  0  0  0  0  0  0  0  0  0  0  0  0  0  0  0  0  0  0  0  0  0  0  0  0  0  0  0  0  0  0  0  0  0  0  0  0  0  0  0  0  0  0  0  0  0  0  0  0  0  0  0  0  0  0  0  0  0  0  0  0  0  0  0  0  0  0  0  0  0  0  0  0  0  0  0  0  0  0  0  0  0  0  0  0  0  0  0  0  0  7  8  8  8  8  8  8  8  8  9  0  0  0  0  0  0  0  0  0  0  0  0  0  0  0  0  0  0  0  0  0  0  0  0  0  0  0  0  0  0  0  0  0  0  0  0  0  0  0  0  0  0  0  0  0  0  0  0  0  0  0  0  0  0  0  0  0  0  0  0  0  0  0  0  0  0  0  0  0  0  0  0  0  0  0  0  0  0  0  0  0  0  0  0  0  0  0  0  0  0  0  0  0  0  0  0  0  0  13 14 14 14 14 14 14 14 14 15 0  0  0  0  0  0  0  0  0  0  0  0  0  0  0  0  0  0  27 28 28 28 28 28 28 28 28 26 26 28 28 28 28 28 28 28 28 29 0  0  0  0  0  0  7  8  8  8  8  8  8  8  8  8  8  8  8  8  8  8  8  8  8  8  8  8  8  8  9  0  0  0  0  0  0  0  0  0  0  0  0  0  0  0  0  0  0  0  0  0  0  0  0  0  0  0  0  0  0  0  0  0  0  0  0  0  0  0  0  0  7  8  8  8  8  8  8  8  8  8  8  8  8  8  8  8  8  8  8  
   11 11 12 0  0  0  0  0  0  0  0  0  0  0  0  0  0  0  0  0  0  0  0  0  0  0  0  0  0  0  0  0  0  0  0  0  26 26 0  0  0  0  0  0  0  0  0  0  0  0  0  0  0  7  8  8  9  0  0  13 14 14 15 0  0  0  0  0  0  0  0  0  0  0  0  0  0  0  0  0  0  0  0  0  0  0  0  0  0  0  0  0  0  0  0  0  0  0  0  0  0  0  0  0  0  0  0  0  0  0  0  0  0  0  0  0  0  0  0  0  0  0  0  0  0  0  0  0  0  0  0  0  0  0  0  0  0  0  0  0  0  0  0  0  0  0  0  0  0  0  0  0  7  8  9  0  0  0  0  0  0  0  0  0  0  7  8  9  0  0  0  0  0  0  0  0  0  0  0  0  0  0  0  0  0  0  0  0  0  0  0  0  0  0  0  0  0  0  0  0  0  0  0  0  0  0  0  0  0  0  0  0  0  0  0  0  0  0  0  0  0  0  0  0  0  0  0  0  0  0  0  0  0  0  0  0  0  0  0  0  0  0  0  0  0  0  0  0  0  0  0  0  0  13 14 14 14 14 14 14 14 14 15 0  0  0  0  0  27 28 28 26 26 28 28 29 0  0  0  0  0  0  0  0  0  0  0  0  0  0  0  0  0  0  0  0  0  0  0  0  0  0  0  0  0  0  0  0  0  0  0  0  0  0  0  0  0  0  0  0  0  0  0  0  0  0  0  0  0  0  0  0  0  0  0  0  0  0  0  0  0  0  0  0  0  0  0  0  0  0  0  0  0  0  0  0  0  0  0  0  0  10 11 11 11 11 11 11 11 11 21 8  9  0  0  0  0  0  0  0  0  0  0  0  0  0  0  0  0  0  0  0  0  0  0  0  0  0  0  0  0  0  0  0  0  0  0  0  0  0  0  0  0  0  0  13 14 14 14 14 14 14 14 14 14 14 14 14 14 14 14 14 14 14 14 14 14 14 14 15 0  0  0  0  0  0  0  0  0  0  0  0  0  0  0  0  0  0  0  0  0  0  0  0  0  0  0  0  0  0  7  8  8  8  8  9  0  0  0  0  0  13 14 14 14 14 14 14 14 14 14 14 14 14 14 14 14 14 14 14 
   11 11 12 0  0  0  0  0  0  0  0  0  0  0  0  0  0  0  0  0  0  0  0  0  0  0  0  0  0  0  26 26 0  0  0  0  0  0  0  0  0  0  0  0  0  0  0  7  8  8  9  0  0  13 14 14 15 0  0  10 11 11 12 0  0  7  9  0  0  0  0  0  0  0  0  0  0  0  0  0  0  0  0  7  9  0  0  0  0  0  0  0  0  0  0  27 29 0  0  0  0  27 29 0  0  0  0  0  0  0  0  0  0  7  9  0  0  0  0  0  0  0  0  0  0  0  0  0  0  0  0  0  0  0  0  0  0  0  0  0  0  0  0  0  0  0  0  0  0  0  0  0  13 14 15 0  0  0  0  0  0  0  0  0  0  13 14 15 0  0  0  0  0  0  0  0  0  0  0  0  0  0  0  0  0  0  0  0  0  0  0  0  0  7  8  9  0  0  0  0  0  0  0  0  0  0  0  0  0  0  0  0  0  0  0  0  0  0  0  0  0  0  0  0  0  0  0  0  0  0  0  0  7  8  9  0  0  0  0  0  0  0  0  0  0  0  0  0  0  0  0  0  0  10 11 11 11 11 11 11 11 11 12 0  0  0  0  0  0  0  0  0  0  0  0  0  0  0  0  0  0  0  0  0  0  0  0  0  0  0  0  0  0  0  0  0  0  0  0  0  0  0  0  0  0  0  0  0  0  0  0  0  0  0  0  0  0  0  7  8  8  8  8  8  8  8  8  9  0  0  0  0  0  0  0  0  0  0  0  0  0  0  0  0  0  0  0  0  0  0  0  0  0  0  7  8  8  8  8  8  8  22 11 11 11 11 11 11 11 11 20 14 15 0  0  0  0  0  0  0  0  0  0  0  0  0  0  0  0  0  0  0  0  0  0  0  0  0  0  0  0  0  0  0  0  0  0  0  0  0  0  0  0  0  0  10 11 11 11 11 11 11 11 11 11 11 11 11 11 11 11 11 11 11 11 11 11 11 11 12 0  0  0  0  0  0  0  0  0  0  0  0  7  8  8  8  8  9  0  0  0  7  8  8  8  8  9  0  0  0  13 14 14 14 14 15 0  0  0  0  0  10 11 11 11 11 11 11 11 11 11 11 11 11 11 11 11 11 11 11 
   11 11 12 0  0  0  0  0  0  0  0  0  0  0  0  0  0  0  0  0  0  0  0  0  0  0  0  0  0  0  0  0  0  0  0  0  0  0  0  0  0  7  8  8  9  0  0  13 14 14 15 0  0  10 11 11 12 0  0  10 11 11 12 0  0  13 15 0  0  0  0  7  9  0  0  0  0  7  9  0  0  0  0  13 15 0  0  0  0  27 29 0  0  0  0  0  0  0  0  0  0  0  0  0  0  0  0  27 29 0  0  0  0  13 15 0  0  0  0  0  0  0  0  0  0  0  0  0  0  0  0  0  0  0  0  0  0  0  0  0  0  0  0  0  0  0  0  0  0  0  0  0  10 11 12 0  0  0  0  0  0  0  0  0  0  10 11 12 0  0  0  0  0  0  0  0  0  0  0  0  0  0  0  0  0  7  8  9  0  0  0  0  0  13 14 15 0  0  0  0  0  0  0  0  0  0  0  0  0  0  0  0  0  0  57 58 0  0  0  0  0  0  0  0  0  0  0  0  0  0  0  0  13 14 15 0  0  0  0  0  0  0  0  0  0  0  0  0  0  0  7  8  8  22 11 11 11 11 11 11 11 11 12 0  0  0  0  0  0  0  0  0  0  0  0  0  0  0  0  0  0  0  0  0  0  0  0  0  0  0  0  0  0  0  0  0  0  0  0  0  0  0  0  0  0  0  0  0  0  0  0  0  0  0  0  0  0  0  13 14 14 14 14 14 14 14 14 15 0  0  0  0  0  0  0  0  0  0  0  0  0  0  0  0  0  0  0  0  0  0  0  0  0  0  13 14 14 14 14 14 14 23 11 11 11 11 11 11 11 11 11 11 21 8  8  8  8  8  8  8  8  8  8  9  0  0  0  7  8  8  8  8  9  0  0  0  7  8  8  8  8  8  9  0  0  0  7  8  8  8  9  0  0  0  0  10 11 11 11 11 11 11 11 11 11 11 11 11 11 11 11 11 11 11 11 11 11 11 11 12 0  0  0  7  8  8  8  8  9  0  0  0  13 14 14 14 14 15 0  0  0  13 14 14 14 14 15 0  0  0  10 11 11 11 11 12 0  0  0  0  0  10 11 11 11 11 11 11 11 11 11 11 11 11 11 11 11 11 11 11 
   11 11 12 0  0  0  0  0  0  0  0  0  0  0  0  0  0  0  0  0  0  0  0  0  0  0  0  0  0  0  0  0  0  0  0  7  8  8  9  0  0  13 14 14 15 0  0  10 11 11 12 0  0  10 11 11 12 0  0  10 11 11 12 0  0  10 12 0  0  0  0  13 15 0  0  0  0  13 15 0  0  0  0  10 12 0  0  0  0  0  0  0  0  0  0  0  0  0  0  0  0  0  0  0  0  0  0  0  0  0  0  0  0  10 12 0  0  0  0  0  0  0  0  0  0  0  0  0  0  0  0  0  0  0  0  0  0  7  8  8  8  8  8  8  8  8  8  8  8  8  8  8  22 11 21 8  8  9  0  0  0  0  7  8  8  22 11 21 8  8  8  8  8  8  8  8  8  8  8  9  0  0  0  0  0  13 14 15 0  0  0  0  0  10 11 12 0  0  0  0  0  0  0  0  0  0  0  0  0  0  0  0  0  0  59 60 0  0  0  0  0  0  0  0  0  0  0  0  0  0  0  0  10 11 12 0  0  0  0  0  0  0  0  0  0  0  0  0  0  0  13 14 14 23 11 11 11 11 11 11 11 11 21 8  8  8  8  8  8  8  8  8  8  8  8  8  8  8  8  8  9  0  0  0  0  0  0  0  0  0  0  0  0  0  0  0  0  0  0  0  0  0  0  0  0  0  0  0  0  0  0  0  0  0  0  0  0  0  10 11 11 11 11 11 11 11 11 12 0  0  0  0  0  0  0  0  0  0  0  0  0  0  0  0  0  0  0  0  0  0  0  0  0  0  10 11 11 11 11 11 11 11 11 30 17 17 17 17 17 31 11 11 20 14 14 14 14 14 14 14 14 14 14 15 0  0  0  13 14 14 14 14 15 0  0  0  13 14 14 14 14 14 15 0  0  0  13 14 14 14 15 0  0  0  0  16 31 11 11 11 11 11 11 11 11 11 11 11 11 11 11 11 11 11 11 11 11 11 11 12 0  0  0  13 14 14 14 14 15 0  0  0  10 11 11 11 11 12 0  0  0  10 11 11 11 11 12 0  0  0  10 11 11 11 11 12 0  0  0  0  0  10 11 11 11 11 11 11 11 11 11 11 11 11 11 11 11 11 11 11 
   11 11 12 0  0  0  0  0  0  0  0  0  0  0  0  0  0  0  0  0  0  0  0  0  0  0  0  0  0  7  8  8  9  0  0  13 14 14 15 0  0  10 11 11 12 0  0  10 11 11 12 0  0  10 11 11 12 0  0  10 11 11 12 0  0  10 12 0  0  0  0  10 12 0  0  0  0  10 12 0  0  0  0  10 12 0  0  0  0  0  0  0  0  0  0  0  0  0  7  9  0  0  0  0  0  0  0  0  0  0  0  0  0  10 12 0  0  0  0  0  7  9  0  0  0  0  0  0  0  7  9  0  0  0  0  0  0  13 14 14 14 14 14 14 14 14 14 14 14 14 14 14 23 11 20 14 14 15 0  0  0  0  13 14 14 23 11 20 14 14 14 14 14 14 14 14 14 14 14 15 0  0  0  0  0  10 11 12 0  0  0  0  0  10 11 12 0  0  0  0  0  0  0  0  0  0  0  57 58 0  0  0  0  0  59 60 0  0  0  0  0  57 58 0  0  0  0  0  0  0  0  0  10 11 12 0  0  0  0  0  0  0  0  0  0  0  0  0  0  0  10 11 11 11 11 11 11 11 11 11 11 11 20 14 14 14 14 14 14 14 14 14 14 14 14 14 14 14 14 14 15 0  0  0  0  0  0  7  8  8  8  8  8  8  8  8  9  0  0  0  0  0  0  0  0  0  0  0  0  0  0  0  0  0  27 29 0  0  10 11 11 11 11 11 11 11 11 12 0  0  0  7  8  8  8  8  8  8  8  8  8  8  8  8  8  8  8  8  8  8  8  8  8  8  22 11 11 11 11 11 11 30 17 18 0  0  0  0  0  16 31 11 11 11 11 11 11 11 11 11 11 11 11 12 0  0  0  10 11 11 11 11 12 0  0  0  10 11 11 11 11 11 12 0  0  0  10 11 11 11 12 0  0  0  0  0  10 11 11 11 11 11 11 11 11 11 11 11 11 11 11 11 11 11 11 11 11 30 17 18 0  0  0  10 11 11 11 11 12 0  0  0  10 11 11 11 11 12 0  0  0  10 11 11 11 11 12 0  0  0  16 17 17 17 17 18 0  0  0  0  0  10 11 11 11 11 11 11 11 11 11 11 11 11 11 11 11 11 11 11 
   11 11 21 8  8  8  8  8  8  8  8  8  8  8  8  8  8  8  8  8  8  8  8  8  8  8  9  0  0  13 14 14 15 0  0  10 11 11 12 0  0  10 11 11 12 0  0  10 11 11 12 0  0  10 11 11 12 0  0  10 11 11 12 0  0  10 12 0  0  0  0  10 12 0  0  0  0  10 12 0  0  0  0  10 12 0  0  0  0  0  0  0  0  0  0  0  0  0  13 15 0  0  0  0  0  0  0  0  0  0  0  0  0  10 12 0  0  0  0  0  13 15 0  0  0  0  0  0  0  13 15 0  0  0  0  0  0  10 11 11 11 11 11 11 11 11 11 11 11 11 11 11 11 11 11 11 11 12 0  0  0  0  10 11 11 11 11 11 11 11 11 11 11 11 11 11 11 11 11 21 8  8  8  8  8  22 11 21 8  8  8  8  8  22 11 21 8  8  8  8  8  8  8  8  8  8  8  59 60 8  8  8  8  8  59 60 8  8  8  8  8  59 60 8  8  8  8  8  8  8  8  8  22 11 21 8  8  8  8  8  8  8  8  8  8  8  8  8  8  8  22 11 11 11 11 11 11 11 11 11 11 11 11 11 11 11 11 11 11 11 11 11 11 11 11 11 11 11 11 11 12 0  0  0  0  0  0  13 14 14 14 14 14 14 14 14 15 0  0  0  0  0  0  0  0  0  0  0  0  0  0  0  0  0  0  0  0  0  10 11 11 11 11 11 11 11 11 12 0  0  0  13 14 14 14 14 14 14 14 14 14 14 14 14 14 14 14 14 14 14 14 14 14 14 23 11 11 11 11 11 30 18 0  0  0  0  0  0  0  0  16 17 17 17 17 17 17 17 17 17 31 30 17 18 0  0  0  16 17 31 11 11 21 8  8  8  22 11 30 17 31 11 21 8  8  8  22 11 30 17 18 0  0  0  0  0  16 31 11 11 11 11 11 11 11 11 11 11 11 11 11 11 11 11 11 11 30 18 0  0  0  0  0  10 11 11 11 11 12 0  0  0  16 17 17 17 17 18 0  0  0  16 17 17 17 17 18 0  0  0  0  0  0  0  0  0  0  0  0  0  0  10 11 11 11 11 11 11 11 11 11 11 11 11 11 11 11 11 11 11 
   11 11 20 14 14 14 14 14 14 14 14 14 14 14 14 14 14 14 14 14 14 14 14 14 14 14 15 0  0  10 11 11 12 0  0  10 11 11 12 0  0  10 11 11 12 0  0  10 11 11 12 0  0  10 11 11 12 0  0  10 11 11 12 0  0  10 12 0  0  0  0  10 12 0  0  0  0  10 12 0  0  0  0  10 12 0  0  0  0  0  0  0  0  0  0  0  0  0  10 12 0  0  0  0  0  0  0  0  0  0  0  0  0  10 12 0  0  0  0  0  10 12 0  0  0  0  0  0  0  10 12 0  0  0  0  0  0  10 11 11 11 11 11 11 11 11 11 11 11 11 11 11 11 11 11 11 11 12 0  0  0  0  10 11 11 11 11 11 11 11 11 11 11 11 11 11 11 11 11 20 14 14 14 14 14 23 11 20 14 14 14 14 14 23 11 20 14 14 14 14 14 14 14 14 14 14 14 14 14 14 14 14 14 14 14 14 14 14 14 14 14 14 14 14 14 14 14 14 14 14 14 14 23 11 20 14 14 14 14 14 14 14 14 14 14 14 14 14 14 14 23 11 11 11 11 11 11 11 11 11 11 11 11 11 11 11 11 11 11 11 11 11 11 11 11 11 11 11 11 11 12 0  0  0  0  0  0  10 11 11 11 11 11 11 11 11 12 0  0  0  0  7  8  8  8  8  8  8  8  8  9  0  0  0  0  0  0  0  10 11 11 11 11 11 11 11 11 12 0  0  0  10 11 11 11 11 11 11 11 11 11 11 11 11 11 11 11 11 11 11 11 11 11 11 11 11 11 11 11 30 18 0  0  0  0  0  0  0  0  0  0  0  0  0  0  0  0  0  0  0  10 12 0  0  0  0  0  0  0  16 31 11 20 14 14 14 23 30 18 0  16 31 20 14 14 14 23 30 18 0  0  0  0  0  0  0  0  10 11 11 11 11 11 11 11 11 11 11 11 11 11 11 11 11 30 17 0  0  0  0  0  0  0  16 17 17 17 17 18 0  0  0  0  0  0  0  0  0  0  0  0  0  0  0  0  0  0  0  0  0  0  0  0  0  0  0  0  0  0  0  0  10 11 11 11 11 11 11 11 11 11 11 11 11 11 11 11 11 11 11 
   11 11 11 11 11 11 11 11 11 11 11 11 11 11 11 11 11 11 11 11 11 11 11 11 11 11 12 0  0  10 11 11 12 0  0  10 11 11 12 0  0  10 11 11 12 0  0  10 11 11 12 0  0  10 11 11 12 0  0  10 11 11 12 0  0  10 12 0  0  0  0  10 12 0  0  0  0  10 12 0  0  0  0  10 12 0  0  0  0  0  0  0  0  0  0  0  0  0  10 12 0  0  0  0  0  0  0  0  0  0  0  0  0  10 12 0  0  0  0  0  10 12 0  0  0  0  0  0  0  10 12 0  0  0  0  0  0  10 11 11 11 11 11 11 11 11 11 11 11 11 11 11 11 11 11 11 11 12 0  0  0  0  10 11 11 11 11 11 11 11 11 11 11 11 11 11 11 11 11 11 11 11 11 11 11 11 11 11 11 11 11 11 11 11 11 11 11 11 11 11 11 11 11 11 11 11 11 11 11 11 11 11 11 11 11 11 11 11 11 11 11 11 11 11 11 11 11 11 11 11 11 11 11 11 11 11 11 11 11 11 11 11 11 11 11 11 11 11 11 11 11 11 11 11 11 11 11 11 11 11 11 11 11 11 11 11 11 11 11 11 11 11 11 11 11 11 11 11 11 11 12 0  0  0  0  0  0  10 11 11 11 11 11 11 11 11 12 0  0  0  0  13 14 14 14 14 14 14 14 14 15 0  0  0  0  0  0  0  10 11 11 11 11 11 11 11 11 12 0  0  0  10 11 11 11 11 11 11 11 11 11 11 11 11 11 11 11 11 11 11 11 11 11 11 11 11 11 11 11 12 0  0  0  0  0  0  0  0  0  0  0  0  0  0  0  0  0  0  0  0  10 12 0  0  0  0  0  0  0  0  10 11 11 11 11 11 11 12 0  0  0  10 11 11 11 11 11 12 0  0  0  0  0  0  0  0  0  16 31 11 11 11 11 11 11 11 11 11 11 11 11 11 11 30 18 0  0  0  0  0  0  0  0  0  0  0  0  0  0  0  0  0  0  0  0  0  0  0  0  0  0  0  0  0  0  0  0  0  0  0  0  0  0  0  0  0  0  0  0  0  0  10 11 11 11 11 11 11 11 11 11 11 11 11 11 11 11 11 11 11 
      )

  (objects
  )
   )


;; EOF ;;
