(supertux-level
  (version 3)
  (name (_ "A New Location"))
  (author "Carsten Wirtz")
  (license "CC-BY-SA 4.0 International")
  (allow-item-pocket "off")
  (icon "")
  (icon-locked "")
  (statistics
    (enable-coins #f)
    (enable-secrets #f)
  )
  (sector
    (name "main")
    (init-script "import(\"levels/world2/forest_intro.nut\");

Text.set_anchor_point(7);
Text.set_anchor_offset(0, -160);

trigger_state(\"start\");")
    (ambient-light
      (color 0.9999999 0.9999999 0.9999999)
    )
    (background
      (scroll-offset-y 100)
      (color 1 0.92 0.95)
      (speed 0)
      (image-top "/images/background/misc/transparent_up.png")
      (image "/images/background/forest/forest_panorama.png")
      (image-bottom "/images/background/BlueRock_Forest/blue-bottom.jpg")
      (z-pos -250)
    )
    (background
      (color 0.9999999 0.9 0.88)
      (scroll-speed-x -2)
      (speed 0)
      (image "/images/background/misc/clouds.png")
      (z-pos -280)
    )
    (background
      (color 1 0.9 0.88)
      (scroll-speed-x -0.1)
      (speed 0)
      (image "/images/background/misc/skybox.png")
      (z-pos -290)
    )
    (camera
      (name "Camera")
      (mode "manual")
    )
    (gradient
      (top_color 1 0.62 0.65)
      (bottom_color 1 1 0.5)
    )
    (invisible_wall
      (width 192)
      (height 32)
      (x 0)
      (y 544)
    )
    (music
      (file "/music/forest/forest_midday.music")
    )
    (path
      (name "gen16433626042683532022432")
      (path
        (adapt_speed #f)
        (node
          (x 352)
          (y 1008)
          (time 3.2)
          (speed 5)
          (easing "EaseQuadInOut")
        )
        (node
          (x 352)
          (y 992)
          (time 3.2)
          (speed 5)
          (easing "EaseQuadInOut")
        )
      )
    )
    (platform
      (z-pos 100)
      (handle
        (scale_x 0)
        (scale_y 0)
        (offset_x 0)
        (offset_y 0)
      )
      (path-ref "gen16433626042683532022432")
      (starting-node 1)
      (sprite "/images/objects/boat/boat.sprite")
    )
    (scriptedobject
      (z-pos 50)
      (name "TUX")
      (sprite "/images/creatures/tux/tux.sprite")
      (x 512)
      (y 960)
    )
    (scripttrigger
      (oneshot #t)
      (script "trigger_state(\"textbox\");")
      (button #f)
      (width 32)
      (height 96)
      (x 96)
      (y 448)
    )
    (spawnpoint
      (name "main")
      (x 32)
      (y 480)
    )
    (tilemap
      (solid #f)
      (z-pos -100)
      (width 140)
      (height 45)
      (tiles -3430 0 402 403 434 435 404 405 -9 0 402 403 404 405 -32 0 402 403 404 405 -85 0 406 407 438 439 408 409 -9 0 406 407 408 409 -32 0 406 407 408 409 -51 0 402 403 404 405 -9 0 402 403 404 405 0 5996 -4 0 2579 2580 2581 2582 -5 0 402 403 428 429 450 451 426 427 404 405 -2 0 5997 5998 0 402 403 428 429 426 427 404 405 -4 0 5999 -5 0 402 403 404 405 402 403 404 405 0 2545 2546 2547 2548 -3 0 5997 5998 402 403 428 429 426 427 436 437 404 405 -5 0 402 403 434 435 404 405 -36 0 406 407 408 409 -3 0 402 403 404 405 0 2631 406 407 408 409 0 6000 -2 0 2471 0 2587 2588 2589 2590 0 2631 -3 0 406 407 432 433 454 455 430 431 408 409 -2 0 6001 6002 0 406 407 432 433 430 431 408 409 -3 0 2631 6003 0 2634 2515 0 2471 406 407 408 409 406 407 408 409 0 2549 2550 2555 2566 -3 0 6001 6002 406 407 432 433 430 431 440 441 408 409 0 2516 2517 -2 0 406 407 438 439 408 409 -12 0 80 -5 0 80 -5 0 80 -7 0 402 403 434 435 428 429 426 427 404 405 0 406 407 408 409 -105 0 1349 -5 0 1349 -5 0 1349 -6 0 2471 406 407 438 439 432 433 430 431 408 409 -110 0 79 -5 0 79 -5 0 79 -127 0 1348 -5 0 1348 -5 0 1348 -127 0 79 -5 0 79 -5 0 79 -127 0 79 -5 0 79 -5 0 79 -127 0 79 -5 0 79 -5 0 79 -127 0 79 -5 0 79 -5 0 79 -127 0 79 -5 0 79 -5 0 79 -127 0 79 -5 0 79 -5 0 79 -127 0 79 -5 0 79 -5 0 79 -127 0 79 -5 0 79 -5 0 79 -127 0 79 -5 0 79 -5 0 79 -127 0 79 -5 0 79 -5 0 79 -127 0 79 -5 0 79 -5 0 79 -127 0 79 -5 0 79 -5 0 79 -127 0 79 -5 0 79 -5 0 79 -115 0)
    )
    (tilemap
      (solid #f)
      (z-pos 100)
      (width 140)
      (height 45)
      (tiles -6300 0)
    )
    (tilemap
      (solid #f)
      (z-pos -110)
      (width 140)
      (height 45)
      (tiles -1886 0 5816 5817 -23 0 5816 5817 -11 0 5816 5817 -25 0 5919 5920 -72 0 5823 5824 5825 5826 -21 0 5823 5824 5825 5826 -9 0 5823 5824 5825 5826 -23 0 5924 5925 5926 5927 -61 0 5919 5920 -7 0 5830 5831 5832 5833 5834 5835 -8 0 5919 5920 -9 0 5830 5831 5832 5833 5834 5835 -7 0 5830 5831 5832 5833 5834 5835 -7 0 5919 5920 -13 0 5930 5931 5932 5933 -47 0 5919 5920 -11 0 5924 5925 5926 5927 -6 0 5838 5839 5840 5841 5842 5843 -7 0 5924 5925 5926 5927 -8 0 5838 5839 5840 5841 5842 5843 -7 0 5838 5839 5840 5841 5842 5843 -6 0 5924 5925 5926 5927 -11 0 5935 5936 5937 5938 5939 5940 -45 0 5924 5925 5926 5927 -10 0 5930 5931 5932 5933 -5 0 5845 5846 5847 5848 5849 5850 5851 5852 -6 0 5930 5931 5932 5933 -7 0 5845 5846 5847 5848 5849 5850 5851 5852 -5 0 5845 5846 5847 5848 5849 5850 5851 5852 -5 0 5930 5931 5932 5933 -11 0 5941 5942 5943 5944 5945 5946 -45 0 5930 5931 5932 5933 -9 0 5935 5936 5937 5938 5939 5940 -4 0 5853 5854 5855 5856 5857 5858 5859 5860 -5 0 5935 5936 5937 5938 5939 5940 -6 0 5853 5854 5855 5856 5857 5858 5859 5860 -5 0 5853 5854 5855 5856 5857 5858 5859 5860 -4 0 5935 5936 5937 5938 5939 5940 -10 0 5947 5948 5949 5950 5951 5952 -44 0 5935 5936 5937 5938 5939 5940 -8 0 5941 5942 5943 5944 5945 5946 -4 0 5861 5862 5863 5864 5865 5866 5867 5868 -5 0 5941 5942 5943 5944 5945 5946 -6 0 5861 5862 5863 5864 5865 5866 5867 5868 -5 0 5861 5862 5863 5864 5865 5866 5867 5868 -4 0 5941 5942 5943 5944 5945 5946 -10 0 5953 5954 5955 5956 5957 5958 -44 0 5941 5942 5943 5944 5945 5946 -8 0 5947 5948 5949 5950 5951 5952 -4 0 5869 5870 5871 5872 5873 5874 5875 5876 -5 0 5947 5948 5949 5950 5951 5952 -6 0 5869 5870 5871 5872 5873 5874 5875 5876 -5 0 5869 5870 5871 5872 5873 5874 5875 5876 -4 0 5947 5948 5949 5950 5951 5952 -10 0 5959 5960 5961 5962 5963 5964 -44 0 5947 5948 5949 5950 5951 5952 -8 0 5953 5954 5955 5956 5957 5958 -4 0 5877 5878 5879 5880 5881 5882 5883 5884 -5 0 5953 5954 5955 5956 5957 5958 -6 0 5877 5878 5879 5880 5881 5882 5883 5884 -5 0 5877 5878 5879 5880 5881 5882 5883 5884 -4 0 5953 5954 5955 5956 5957 5958 -10 0 5965 5966 5967 5968 5969 5970 -44 0 5953 5954 5955 5956 5957 5958 -8 0 5959 5960 5961 5962 5963 5964 -7 0 5888 5889 -8 0 5959 5960 5961 5962 5963 5964 -9 0 5888 5889 -11 0 5888 5889 -7 0 5959 5960 5961 5962 5963 5964 -12 0 6082 6083 -46 0 5959 5960 5961 5962 5963 5964 -8 0 5965 5966 5967 5968 5969 5970 -7 0 5896 5897 -8 0 5965 5966 5967 5968 5969 5970 -9 0 5896 5897 -11 0 5896 5897 -7 0 5965 5966 5967 5968 5969 5970 -12 0 6089 6090 -46 0 5965 5966 5967 5968 5969 5970 -10 0 5973 5974 -9 0 5888 5889 -10 0 5973 5974 -11 0 6084 6085 -11 0 5888 5889 -9 0 5973 5974 -14 0 5973 5974 -48 0 6082 6083 -12 0 5979 5980 -9 0 5896 5897 -10 0 5979 5980 -11 0 6091 6092 -11 0 5896 5897 -9 0 5979 5980 -14 0 5979 5980 -48 0 6089 6090 -12 0 5985 5986 -9 0 5904 5905 -10 0 5985 5986 -11 0 5904 5905 -11 0 5904 5905 -9 0 5985 5986 -14 0 5985 5986 -48 0 5985 5986 -12 0 5991 5992 -9 0 5912 5913 -10 0 5991 5992 -11 0 5912 5913 -11 0 5912 5913 -9 0 5991 5992 -14 0 5991 5992 -48 0 5991 5992 -403 0 5645 5689 5646 -136 0 5645 5690 5687 5688 5646 -134 0 5645 5690 5665 5685 5674 5677 -127 0 5645 5646 -4 0 5645 5690 5687 5665 5685 5686 5677 -120 0 5645 5646 -3 0 5645 5689 5690 5688 5646 -2 0 5645 5690 5675 5685 5664 5687 5675 5688 5646 -118 0 5645 5690 5688 -3 5689 5690 5665 5676 5685 5688 -2 5689 5690 5686 5674 5686 5663 5665 5674 5675 5677 -116 0 5645 5689 5690 5675 5676 5665 5676 5674 5686 5687 5685 5663 5665 5664 5686 5665 5675 5676 5675 5665 5663 5676 5663 5677 -113 0 5645 -2 5689 5690 5675 -2 5687 5674 5675 5663 5665 5664 5685 5687 5686 5674 5685 5686 5685 5674 5687 5665 5676 5686 5687 5663 5677 -110 0 5645 -2 5689 5690 5676 5663 5687 5664 5663 5674 5665 5685 5686 5674 5685 5676 5664 5675 5676 5665 5687 5665 -2 5675 5674 5663 5686 5675 5663 5677 -109 0 5689 5690 5675 -2 5663 5665 5663 5665 5663 5664 5663 5664 5663 5675 5676 5665 5676 5685 5674 5687 -2 5664 5663 5685 5664 5676 5687 5663 5665 5674 5688 5646 -108 0 5675 5685 5664 5663 5674 5663 5664 5686 5687 5675 5676 5665 5675 5674 5686 5663 5686 5665 5675 5674 5663 5676 -4 5663 5686 5676 5665 5687 5676 5677 -108 0 5676 -2 5663 5664 5686 5687 -2 5674 -2 5686 5665 5674 5663 5665 5664 5686 -2 5663 5685 5663 -2 5665 5663 5685 5665 5685 5663 5665 5675 5685 5687 5677 -108 0 5685 5675 5685 -2 5665 5685 5676 5663 5686 5664 5663 5676 5685 5674 -2 5685 5674 5686 5663 5687 5676 5663 5665 5675 5676 5675 5665 5664 5687 5685 5675 5677 -108 0 5686 5687 5675 5674 5686 5676 5687 5676 5687 5676 5663 5687 5674 5675 5665 5686 5687 5686 5674 5686 -2 5663 5686 5675 5663 5675 5687 5665 5676 5687 5665 5677 -108 0)
    )
    (tilemap
      (solid #t)
      (z-pos -1)
      (name "pier")
      (width 140)
      (height 45)
      (tiles -4212 0 27 -16 28 29 -2070 0)
    )
    (tilemap
      (solid #t)
      (z-pos -101)
      (width 140)
      (height 45)
      (tiles -4480 0 2019 2140 2141 2142 2019 2140 2141 2142 2019 2140 2141 2142 2019 2140 2141 2142 2019 2140 2141 2142 2019 2140 2141 2142 2019 2140 2141 -113 0 -27 2020 -113 0 -27 2020 -113 0 -27 2020 -113 0 -28 2020 -112 0 -28 2020 -112 0 -28 2020 -112 0 -28 2020 -112 0 -29 2020 -111 0 -29 2020 -111 0 -29 2020 -111 0 -29 2020 -111 0 -29 2020 -111 0)
    )
    (tilemap
      (solid #t)
      (z-pos 0)
      (width 140)
      (height 45)
      (tiles -3826 0 6004 6005 -4 1001 1002 -2 1001 1002 1001 -5 1002 1001 -2 1002 1001 -4 1002 1001 -3 1002 -7 1001 -2 1002 -2 1001 -2 1002 1001 1002 -2 1001 1002 -2 1001 -2 1002 1001 1002 1001 1002 -2 1001 -2 1002 1001 -2 1002 1001 -3 1002 1001 1002 -7 1001 -6 1002 1001 -2 1002 1001 -7 1002 1001 1002 1001 -40 0 6004 6005 1001 1002 6014 6015 6008 6009 -3 1005 1006 1005 1006 1005 1006 1005 -9 1006 1005 -2 1006 -2 1005 -3 1006 -3 1005 -6 1006 1005 1006 -3 1005 1006 -2 1005 1006 -2 1005 -8 1006 -2 1005 1006 -2 1005 1006 1005 -2 1006 1005 1006 1005 -2 1006 -8 1005 -3 1006 -3 1005 1006 -3 1005 -2 1006 1005 1006 1005 1006 -29 0 6004 6005 -2 1001 1002 1001 1002 -2 1001 6014 6015 6008 6009 1005 1006 6018 6019 1068 -3 1009 -2 1014 1013 1010 1014 1013 1009 1014 -2 1013 1009 -2 1013 1009 1013 1014 1013 1009 1013 -4 1014 1013 1009 1014 1013 1009 1014 1013 1010 1009 1010 1013 1014 1013 -2 1009 1013 1009 1014 1009 1014 1013 1009 1014 1009 1014 1009 1014 1009 1014 -2 1013 1009 -3 1013 1014 -3 1009 1014 1010 1014 -2 1009 -2 1013 -2 1014 1009 1010 1013 1009 1014 1013 1010 1013 1014 1013 1010 1013 -3 1014 -2 1013 1009 1014 -27 0 6022 6023 6008 6009 1005 -5 1006 1005 6018 6019 1068 -8 1009 1014 1009 1014 1009 -2 1013 -2 1009 1014 1009 1014 -2 1009 1014 1010 1013 1010 1014 1009 -2 1013 1010 1009 1013 1009 1014 1009 1013 1009 1013 1009 1014 -3 1013 1014 1010 -2 1014 1009 1013 1010 1013 1009 1014 1010 1009 1010 -2 1009 1014 -2 1009 1013 1014 1013 1014 1009 1014 1013 -3 1014 1013 1010 1014 1010 1013 1014 1009 1013 1014 1009 1013 1009 1014 -2 1013 1014 1009 -3 1013 1009 -2 1014 1010 1009 1013 1010 1013 -26 0 1045 6026 6027 1068 -2 1009 1010 1014 1009 1014 1010 -5 1009 1010 1009 1014 1009 -3 1013 1009 1014 1010 -2 1009 1014 1009 1014 -2 1009 -3 1013 -3 1014 1010 -3 1014 1013 1009 1014 1009 1013 1014 1009 1013 1014 1009 1013 1009 -4 1013 1014 1013 1009 1010 1014 -2 1013 -2 1009 1010 -2 1009 1014 1009 1014 -2 1009 1013 1014 1013 -3 1009 1014 1009 -3 1013 1009 1014 1013 1014 1013 1014 1010 1014 1010 1014 -3 1013 1014 1009 -3 1013 1014 -2 1013 1009 -2 1014 -2 1013 1009 -26 0 6046 6030 -3 1009 -2 1010 -3 1009 1010 1013 1014 1009 1014 -2 1013 1014 1013 -2 1009 1014 -2 1013 -2 1009 1013 1010 1014 1013 -2 1009 1013 1014 1013 -3 1009 1013 1014 1009 1014 1013 1009 1013 1014 1009 1010 -2 1013 -2 1014 1009 1013 1014 1010 -3 1014 1009 1013 -2 1010 1014 -2 1013 -2 1014 1009 -2 1014 1013 1014 1013 -2 1014 -3 1013 1009 -2 1010 1009 1013 1014 -2 1009 -2 1014 1013 1009 1014 1010 1009 -2 1013 -3 1009 1013 1014 1013 1009 1010 1013 1010 1009 1013 1009 1010 -2 1014 1009 1014 -26 0 6050 -3 1009 1013 1009 1013 1014 1013 1014 1013 1010 -2 1009 1010 1014 1010 -2 1009 1013 -2 1010 1014 -2 1013 -2 1010 -2 1014 -2 1013 1009 -2 1013 1014 -2 1009 1013 1014 1009 1014 1013 1009 -2 1013 -9 1014 1009 1013 1009 -3 1014 1010 -2 1009 1010 -2 1009 1013 1009 1013 1009 1013 1009 1010 1009 -2 1013 1009 1010 1009 1014 -3 1009 1014 1009 -5 1013 -2 1009 1014 -2 1013 1010 -2 1013 1014 1009 -3 1014 1009 1014 1013 1014 -2 1013 1014 1013 1014 1013 1014 -26 0 1008 1009 1014 -2 1009 -4 1014 -2 1009 1013 1014 1013 -3 1009 1014 1013 1010 1014 -2 1010 1014 1013 1014 1013 1014 1013 1014 1013 -2 1014 1013 -2 1014 1010 -2 1014 1013 1009 1014 -5 1009 1014 -2 1013 -5 1009 1013 1014 -3 1013 1014 -3 1013 -2 1009 -5 1013 1010 -2 1013 -2 1014 1013 -2 1014 1013 1014 -2 1009 1014 1010 1014 -9 1009 1010 1013 1014 1013 1009 1014 1009 1010 -2 1014 1009 -2 1013 1014 -2 1013 -2 1009 1014 -26 0 3466 1009 1013 1009 1014 1009 1013 1009 1014 1010 1009 -3 1014 1009 1014 -2 1013 1014 -2 1013 1014 -2 1013 -2 1014 -2 1009 -2 1013 -2 1009 1014 -2 1009 1014 -3 1009 1014 1009 -3 1013 1010 1009 1014 1013 1009 1013 1010 1009 -3 1014 1009 1013 -3 1014 1009 -3 1013 -2 1009 1013 1010 1013 1010 1013 1010 -2 1013 1014 1009 1014 -2 1009 1014 1013 -2 1014 1013 1010 1014 1009 1013 -2 1014 -2 1009 -2 1013 1014 1009 1013 1009 -2 1014 1009 1010 -2 1014 1009 1013 1010 1013 -2 1009 -2 1013 -2 1014 -26 0 3470 4318 -6 1013 -2 1014 1009 1013 1009 -3 1014 1009 -3 1014 -2 1013 1014 -2 1013 1009 1010 1014 1009 1013 1014 1013 -2 1009 1014 1010 1013 1010 1014 1010 -3 1013 1009 1014 1013 1009 1013 1009 1013 1009 1013 1010 -3 1009 1013 1014 -2 1013 1014 1010 1009 1010 -2 1014 -6 1009 -2 1010 -3 1014 1009 1010 1009 1014 1009 -2 1010 1009 1014 1013 1014 1009 1013 1014 1009 1013 1009 1013 1009 1014 -3 1013 1009 -2 1013 1014 1009 1014 1009 -2 1013 1014 1013 1014 1013 1014 -27 0 1008 1014 1009 1014 1009 1014 1010 1009 1014 -3 1013 1014 1013 -2 1009 1010 -2 1014 1009 -2 1013 -2 1014 1009 1014 1009 1014 -2 1009 -2 1014 1013 1009 1010 1009 1014 1010 -2 1013 1010 1009 1013 1009 1013 1014 1009 1013 1014 1013 1014 1013 -4 1009 1013 -2 1009 1010 1014 1013 1014 1010 1009 -4 1013 1014 1013 -2 1014 -3 1013 1009 -2 1010 1009 1013 -4 1014 1013 1009 1013 1009 1013 1009 1014 1010 1009 -3 1014 1009 1013 1009 1014 1009 1013 1010 1013 1014 1013 1014 1013 1014 1010 1013 1009 -27 0 1012 -5 1009 -2 1013 1014 1009 1014 -3 1013 1014 1013 1010 1013 -2 1014 1009 -2 1014 -2 1009 -2 1013 -2 1009 1014 -2 1009 1013 -2 1014 1013 1014 -2 1009 1014 1013 1009 1013 1014 1009 1010 1013 1014 1009 1010 1013 1009 1014 -3 1013 1014 1013 1010 1013 -3 1014 1013 1010 1014 1013 1014 1013 -2 1014 -2 1009 1014 -2 1009 1014 -3 1009 1013 1009 1010 -2 1013 1010 1009 1014 1013 1010 1009 1014 -4 1013 1009 1013 -3 1009 1014 -2 1013 1014 1013 1014 -2 1013 -2 1014 -2 1010 -27 0 3466 -2 1009 1014 1010 1014 -2 1013 -2 1009 1010 1013 1009 -2 1014 1009 1013 1010 1013 1009 1014 1009 1014 1009 -2 1014 1013 -2 1014 -2 1009 1014 -2 1009 1014 1009 -2 1013 1009 1014 1010 -2 1014 -2 1009 1010 -3 1013 1014 1009 1013 1009 -3 1013 1014 1013 1009 1010 1014 -2 1013 -2 1009 1013 1010 1014 1013 -2 1014 1010 1013 1009 -2 1013 1009 -3 1014 1013 1009 1013 1014 -4 1009 -6 1014 1009 1013 1009 -2 1014 1009 1013 1009 1010 1014 -2 1013 1009 1014 1010 1009 1013 1009 1013 -27 0 3470 4318 -2 1013 -2 1014 1009 1013 1014 1013 -3 1009 1013 1009 1014 1009 1013 1010 1013 -2 1009 -2 1013 1014 1013 -2 1009 1013 1014 1013 -3 1014 1009 -2 1013 1009 1014 1010 1013 -9 1014 1009 1013 1014 1013 -2 1009 1013 -3 1014 -3 1009 1014 1013 1009 1014 1010 1009 -2 1013 1009 1010 1009 1013 1014 1013 1009 -3 1013 1009 1014 1009 1013 -2 1014 -3 1009 -2 1013 1014 1010 1014 1013 -2 1010 1013 1009 -2 1014 1009 -2 1014 1010 1009 1013 1009 1013 1009 1010 1009 -28 0 1008 1009 1014 1013 1009 -3 1014 1009 1010 1014 -2 1013 1014 -3 1009 -2 1013 1014 1010 1013 -2 1009 -2 1014 1013 -2 1014 1009 1013 1010 1014 -3 1009 1013 1009 1010 -3 1013 1010 1009 -2 1014 -3 1013 -2 1014 1010 1014 -2 1013 1014 1009 1014 1009 1013 1009 1010 -2 1014 1010 1009 -2 1013 -2 1009 1014 1009 1014 1013 -2 1014 1013 1014 -3 1009 1014 1010 1014 1009 1013 1014 1009 1013 1014 1013 1014 1013 -2 1010 1013 1014 -3 1009 1013 -2 1009 1013 1010 1013 -2 1009 -2 1014 -2 1013 -28 0 1012 1014 1009 1010 1013 1014 1013 1009 -3 1014 1009 1014 1013 1014 -3 1009 1014 1013 1009 1014 1009 1014 -2 1009 -2 1013 1009 -2 1013 1009 -3 1013 1009 1013 -3 1014 -2 1013 1009 1014 1013 1010 1009 -3 1014 1009 1010 1014 -3 1013 1009 -2 1014 -3 1009 -2 1014 -2 1009 -2 1014 1009 1010 1009 -2 1013 1009 -3 1013 1009 -4 1013 1010 1009 1013 1009 1014 1010 1014 1013 1009 -3 1014 1009 1013 1009 -2 1014 1010 -2 1009 1010 -2 1009 -2 1014 -2 1009 -2 1013 1009 -28 0 1012 1009 -2 1013 1010 1009 1010 1013 1014 1013 -2 1009 1013 -3 1014 1010 1009 1010 1014 1009 -2 1013 -2 1009 -3 1014 -2 1009 1014 1010 -2 1013 1009 1013 -3 1014 -2 1013 1009 1013 1010 1014 1013 1009 -4 1014 1009 1013 -3 1009 1013 1010 1013 1014 1013 1014 -2 1013 -2 1014 -2 1013 1009 1013 1009 -2 1014 1013 1009 -2 1010 1009 1013 1014 -4 1009 1014 -2 1013 -2 1009 -3 1014 1009 1010 1014 1013 1010 1013 1014 -2 1013 1014 1013 1014 -2 1009 1013 1010 -2 1013 -2 1014 -28 0 3466 1009 1013 1014 1009 1014 1013 -2 1010 1013 1014 1013 1010 1013 -3 1014 1013 1010 -6 1013 -2 1014 1010 1013 1010 1014 -2 1009 1014 1009 -3 1013 1010 1009 1013 1009 1014 1009 1014 1009 1014 1013 -3 1009 1010 1014 1013 1009 1010 1014 -2 1013 1009 1014 1009 -2 1014 1010 1013 -2 1009 1014 -2 1009 -3 1014 1013 -3 1014 1013 1009 1013 -2 1014 -7 1009 1010 1013 1009 1014 -3 1013 1009 -2 1014 1009 -2 1014 1010 1009 1013 1009 1013 1009 1013 1010 1014)
    )
  )
)
