(supertux-level
  (version 3)
  (name (_ "Roots of All Evil"))
  (author "Carsten Wirtz")
  (license "CC-BY-SA 4.0 International")
  (allow-item-pocket "inherit")
  (icon "")
  (icon-locked "")
  (statistics
    (enable-coins #f)
    (enable-secrets #f)
  )
  (sector
    (name "main")
    (ambient-light
      (color 0.62 0.66 0.78)
    )
    (background
      (color 0.56 0.6 0.8 0.7)
      (scroll-speed-x -22)
      (speed 1.1)
      (image-top "/images/background/misc/fog.png")
      (image "/images/background/misc/fog.png")
      (image-bottom "/images/background/misc/fog.png")
      (z-pos 200)
    )
    (background
      (color 1 1 1 0.7)
      (speed 0)
      (fill #t)
      (target "lightmap")
      (image-top "/images/background/misc/vignette.png")
      (image "/images/background/misc/vignette.png")
      (image-bottom "/images/background/misc/vignette.png")
      (z-pos 300)
    )
    (background
      (color 0.2 0.3 0.5)
      (alignment "bottom")
      (speed 0)
      (image "/images/background/corrupted_forest/mountain_panorama.png")
      (z-pos -350)
    )
    (background
      (color 1 1 1)
      (alignment "top")
      (speed 0)
      (fill #t)
      (image "/images/background/misc/skybox_storm.png")
      (z-pos -375)
    )
    (background
      (scroll-offset-y -120)
      (color 0.6 0.6 0.7)
      (speed 0.5)
      (image-top "/images/background/misc/transparent_up.png")
      (image "/images/background/corrupted_forest/corrupttrees.png")
      (image-bottom "/images/background/corrupted_forest/corrupttrees_bottom.png")
    )
    (camera
      (name "Camera")
      (mode "normal")
    )
    (ghosttree
      (z-pos -20)
      (dead-script "sector.Tux.trigger_sequence(\"fireworks\");")
      (x 776)
      (y 584)
      (hud-icon "images/creatures/ghosttree/hudlife.png")
    )
    (gradient
      (top_color 0.1 0.2 0.3)
      (bottom_color 0.1137255 0 0.2117647)
      (z-pos -400)
    )
    (gradient
      (top_color 0 0 0 0)
      (bottom_color 1 1 1 0.4)
      (z-pos -310)
    )
    (hurting_platform
      (z-pos -60)
      (handle
        (scale_x 0)
        (scale_y 0)
        (offset_x 0)
        (offset_y 0)
      )
      (running #f)
      (name "green_root")
      (path-ref "gen17349019701831442736352")
    )
    (music
      (file "/music/forest/treeboss.music")
    )
    (particles-rain
    )
    (path
      (name "gen17349019701831442736352")
      (path
        (adapt_speed #f)
        (node
          (x 496)
          (y 704)
          (time 0.7466667)
          (speed 150)
          (easing "EaseQuadIn")
        )
        (node
          (x 496)
          (y 592)
        )
      )
    )
    (sound-object
      (sample "/sounds/rain.wav")
      (volume 1)
    )
    (spawnpoint
      (name "main")
      (x 784)
      (y 640)
    )
    (thunderstorm
      (running #f)
    )
    (tilemap
      (solid #f)
      (z-pos -100)
      (width 50)
      (height 30)
      (tiles -983 0 6346 6347 6348 6349 -24 0 6346 6347 6366 6367 6348 6349 -16 0 6354 6355 6356 6357 -3 0 6346 6347 6348 6349 -12 0 6346 6347 6348 6349 0 6354 6355 6374 6375 6356 6357 -16 0 6378 6379 6350 6351 6348 6349 0 6354 6355 6356 6357 -12 0 6354 6355 6356 6357 0 6378 6379 6398 6399 6364 6365 -16 0 6386 6387 6358 6359 6356 6357 0 6378 6379 6380 6381 -356 0)
    )
    (tilemap
      (solid #f)
      (z-pos 100)
      (width 50)
      (height 30)
      (tiles -1312 0 6410 -4 6411 6412 -11 0 6410 -4 6411 6412 -23 0 6410 -3 6411 6420 6426 -3 6417 6419 -2 6411 6412 -4 0 6410 -3 6411 6420 -4 6426 6419 -3 6411 6412 -14 0 6410 -4 6411 6420 6425 -2 6417 6425 6426 6417 6425 6417 6425 6426 6417 6419 -4 6411 6420 6426 6425 -2 6417 6425 6417 6425 -3 6417 6425 6417 6419 -5 6411 6412 -4 0 6410 -3 6411 6420 -3 6417 -2 6426 -4 6417 -2 6425 -4 6417 6425 6417 6426 -3 6417 6425 -3 6417 -4 6425 -3 6417 6425 6426 -3 6417 -2 6426 6417 6419 -4 6411 6420)
    )
    (tilemap
      (solid #t)
      (z-pos 0)
      (width 50)
      (height 30)
      (tiles -350 0 6274 -47 0 6289 6290 6278 1448 1444 -44 0 3384 6293 6294 1451 1452 1447 6706 -43 0 6707 6297 1432 1437 1432 1451 6710 -43 0 6711 1436 1437 1436 1437 3414 3411 -43 0 3406 3407 3415 3414 3408 3409 -46 0 3410 3411 -413 0 6212 6195 6194 6195 5454 1424 1425 1424 1425 -2 1424 1425 -4 1424 1425 5453 -2 6194 6213 -7 0 6194 6195 -10 0 6212 6195 6194 6195 6194 -2 6195 6194 6195 6217 6218 -3 1432 5456 1428 1429 1428 1429 -2 1428 1429 -4 1428 1429 5455 1432 1433 6219 6220 -2 6194 6195 -2 6194 6195 6194 -2 6195 6213 -4 0 6194 -2 6195 6217 6218 -3 1432 1433 -5 1432 1450 -3 1436 1433 1432 1436 1437 1436 1437 -3 1432 1437 -2 1432 1436 1432 -2 1436 1433 -4 1432 1433 -5 1432 6219 6220 6194 -2 6195 -3 1432 1436 1450 1432 1433 1436 -3 1433 -7 1432 1437 1432 1437 -3 1436 1433 1437 1432 1433 -2 1432 1437 1436 -5 1432 -2 1436 -3 1432 1436 -2 1432 1451 -4 1432 1436 -2 1432 1436 1433 1432 1436 1437 1436 1437 -2 1436 1432 1433 1437 1432 1437 -2 1432 1436 -2 1437 1433 -3 1437 1436 1432 -2 1436 -6 1437 -2 1432 1433 1436 1432 -3 1436 -5 1432 1437 -3 1436 1432 -2 1436 1432 -2 1437 1433 1432 -2 1436 -2 1437 1433 1436 1432 -2 1433 1437 -3 1432 1436 1437 1432 -2 1437 1436 1432 1436 1432 1436 1432 1436 1432 1437 1436 1433 1432 1436 1437 -3 1432 1433 -2 1437 1432 -2 1437 1432 -2 1437 1432 -2 1436 -2 1437 1432 -2 1437 1436 -2 1437 -2 1432 1437 -2 1432 1437 1433 -2 1436 1432 1437 1432 -9 1436 -2 1437 1433 1437 -3 1436 1437 1436 1433 1436 1432 -2 1437 1432 1437 1436 1437 1433 1432 1436 1432 1433 -2 1437 -2 1436 1432 1433 1432 -2 1436 1432 -3 1436 1432 -4 1436 1432 1437 1433 1437 1433 1437 1432 1437 1433 -2 1437 1436 -2 1437 1433 1432 1437 1432 -3 1436 1432 1437 1436 1433 1436 -3 1437 -2 1436 -2 1437 -2 1432 -2 1436 1437 1432 1437 1432 1433 1432 1436 -3 1437 1433 1437 -2 1432 -4 1433 -3 1432 1433 1436 1437 1432 1437 -2 1436 1437 1436 -2 1432 1437 -2 1436)
    )
    (tilemap
      (solid #t)
      (z-pos -1)
      (width 50)
      (height 30)
      (tiles -1000 0 6669 6670 -46 0 6667 6668 6677 6678 -46 0 6675 6676 6683 6684 6619 6620 6619 6620 6619 6620 6619 6620 6619 6620 6619 6669 6670 -19 0 6667 6668 6619 6620 6619 6620 6619 6620 6619 6620 6619 6620 6619 6620 6685 6686 6691 6692 6627 6628 6627 6628 6627 6628 6627 6628 6627 6628 6627 6677 6678 -19 0 6675 6676 6627 6628 6627 6628 6627 6628 6627 6628 6627 6628 6627 6628 6693 6694 -300 0)
    )
    (tilemap
      (solid #f)
      (z-pos -110)
      (width 50)
      (height 30)
      (tiles -459 0 6225 6226 -27 0 6225 6226 -18 0 6230 6231 6232 6233 -25 0 6230 6231 6232 6233 -17 0 6236 6237 6238 6239 -25 0 6236 6237 6238 6239 -17 0 6242 6243 6244 6245 -25 0 6242 6243 6244 6245 -17 0 6248 6249 6250 6251 -25 0 6248 6249 6250 6251 -16 0 6253 6254 6255 6256 6257 6258 -23 0 6253 6254 6255 6256 6257 6258 -15 0 6259 6260 6261 6262 6263 6264 -23 0 6259 6260 6261 6262 6263 6264 -16 0 6266 6267 6268 6269 -25 0 6266 6267 6268 6269 -18 0 5973 5974 -27 0 6082 6083 -19 0 5979 5980 -27 0 6089 6090 -19 0 6082 6083 -27 0 5973 5974 -19 0 6089 6090 -27 0 5979 5980 -19 0 6096 6097 -27 0 6096 6097 -19 0 6103 6104 -27 0 6103 6104 -360 0)
    )
    (tilemap
      (solid #t)
      (z-pos -10)
      (width 50)
      (height 30)
      (tiles -250 0 6656 -48 0 6655 6664 -48 0 6663 6672 -48 0 6671 6680 -48 0 6679 -149 0 6637 6638 -48 0 6645 6646 -48 0 6637 6638 -48 0 6645 6646 -48 0 6637 6638 -48 0 6645 6646 -48 0 6637 6638 -48 0 6645 6646 -48 0 6637 6638 -48 0 6645 6646 6620 6669 6670 -9 0 6667 6668 6619 6620 6669 6670 -12 0 6667 6668 6619 6620 6669 6670 -9 0 6667 6668 6619 6637 6638 6628 6677 6678 -9 0 6675 6676 6627 6628 6677 6678 -12 0 6675 6676 6627 6628 6677 6678 -9 0 6675 6676 6627 6645 6646 -48 0 6637 -49 0 6645 -250 0)
    )
  )
  (sector
    (name "sector2")
    (ambient-light
      (color 1 1 1)
    )
    (background
      (color 1 1 1)
      (speed 0.5)
      (image-top "images/background/antarctic/arctis2.png")
      (image "images/background/antarctic/arctis2.png")
      (image-bottom "images/background/antarctic/arctis2.png")
    )
    (camera
      (name "Camera")
      (mode "normal")
    )
    (music
    )
    (spawnpoint
      (name "main")
      (x 64)
      (y 480)
    )
    (tilemap
      (solid #f)
      (z-pos -100)
      (width 100)
      (height 35)
      (tiles -3500 0)
    )
    (tilemap
      (solid #f)
      (z-pos 100)
      (width 100)
      (height 35)
      (tiles -3500 0)
    )
    (tilemap
      (solid #t)
      (z-pos 0)
      (width 100)
      (height 35)
      (tiles -3500 0)
    )
  )
)
