(supertux-level
  (version 2)
  (name (_ "Forest World"))
  (author "")
  (sector
    (name "main")
    (music "music/forestmap.ogg")
    (init-script "import(\"levels/world2/default.nut\");")
    (tilemap
      (z-pos -100)
      (solid #t)
      (speed 1)
      (width 70)
      (height 50)
      (tiles 651 651 651 651 651 651 640 640 640 640 640 640 651 651 651 651 651 651 651 651 651 651 651 651 651 747 410 410 651 651 651 651 651 651 651 651 651 651 651 651 651 651 651 651 651 651 651 651 651 651 651 651 651 651 651 651 651 651 651 651 651 651 651 651 651 651 651 651 651 651 651 651 651 651 651 640 640 651 651 651 651 651 651 651 651 651 651 651 651 640 640 651 651 651 651 651 747 410 410 410 651 651 651 651 651 651 651 651 651 651 651 651 651 651 651 651 651 651 651 651 651 651 651 651 651 651 651 651 651 651 651 651 651 651 651 651 651 651 651 651 651 651 651 651 651 651 640 640 640 640 640 640 651 651 651 651 651 651 651 651 651 651 651 651 651 651 747 410 410 410 410 748 748 651 651 651 651 651 651 651 651 651 651 564 564 564 564 564 564 564 564 564 564 564 564 564 564 651 651 651 651 651 651 651 651 651 651 651 651 651 651 651 651 651 651 640 651 651 651 651 651 651 651 651 651 651 651 651 651 640 640 651 651 651 651 651 747 410 410 748 410 410 651 651 651 651 651 651 651 651 651 564 564 758 762 762 762 762 762 762 762 762 762 762 762 761 564 564 651 651 651 651 651 651 651 651 651 651 651 651 651 640 640 640 640 651 640 640 640 640 640 651 651 651 651 651 651 640 640 640 640 640 640 640 640 747 410 410 410 552 553 410 410 410 687 564 564 564 564 564 564 564 564 765 564 564 564 564 564 564 564 564 564 743 558 760 762 762 761 564 651 651 651 651 651 651 651 651 651 651 651 651 651 651 553 640 651 651 651 651 651 651 651 651 651 651 640 640 747 410 410 640 747 410 410 410 410 410 410 555 556 410 748 748 687 564 758 762 762 762 762 762 762 764 564 743 564 564 564 564 743 559 564 564 564 564 564 564 765 564 564 651 651 651 651 651 651 651 651 651 651 640 640 640 553 553 640 640 640 640 640 651 651 651 651 651 640 747 693 410 410 410 410 410 410 410 410 402 406 406 406 405 410 410 687 564 765 564 564 564 564 564 564 765 564 564 564 1500 1501 1502 1503 1504 1505 1506 1507 1508 1509 1510 765 564 564 651 651 651 651 651 651 651 651 651 651 640 640 640 553 553 553 651 651 651 651 651 651 651 651 651 651 747 402 406 406 406 406 406 406 406 406 408 410 748 410 409 748 410 687 564 765 564 564 564 564 564 564 765 564 564 721 1513 1514 1515 1516 1517 1518 1519 1520 1521 1522 1523 760 761 564 564 651 640 640 640 651 651 651 651 640 640 640 640 553 553 553 640 640 640 640 651 651 651 651 651 640 747 409 871 872 873 874 875 876 877 878 404 405 410 410 409 748 748 687 564 760 762 762 761 564 564 564 765 564 564 900 1526 1527 1528 1529 1530 1531 1532 1533 1735 1535 564 564 760 761 564 564 564 640 640 640 651 651 651 640 651 651 651 553 553 553 420 420 420 420 420 651 651 640 640 640 747 409 880 881 882 883 884 885 886 887 410 409 693 410 409 816 817 687 564 564 564 564 765 564 564 564 765 564 743 899 1539 1540 1541 1542 1543 1544 1545 1546 1736 1548 1549 1550 564 765 564 564 564 640 640 640 651 651 651 640 640 640 420 420 420 420 420 420 420 420 420 651 651 640 651 651 410 409 889 890 891 892 893 894 895 896 410 409 410 410 409 825 826 687 564 564 564 564 765 564 564 564 765 564 564 861 1552 1553 1554 1555 1556 1557 1558 1559 1737 1561 1562 1563 564 765 564 564 564 640 640 640 640 640 651 651 651 651 420 420 420 816 817 420 420 420 410 651 651 651 651 651 410 409 898 899 900 901 902 903 904 905 410 409 410 410 409 834 835 690 689 564 564 564 760 763 762 762 764 564 564 855 1565 1566 1567 1568 1569 1570 1571 1572 1738 1574 1575 1576 1577 760 761 564 564 564 640 640 640 651 651 640 640 640 420 420 420 825 826 420 420 420 693 748 410 651 651 870 410 409 907 866 908 909 910 911 912 913 693 403 406 406 413 843 844 410 687 564 564 564 564 765 564 564 765 564 564 564 1578 1579 1580 1739 1740 1741 1742 1585 1743 1744 1588 1589 1590 564 765 564 564 564 640 640 640 651 651 63 63 640 651 420 420 834 835 420 420 410 410 693 410 410 410 410 410 409 410 410 410 410 410 552 553 410 410 409 410 410 410 852 853 748 690 689 564 564 564 765 564 564 765 564 564 853 1591 1592 1593 1745 1595 1596 1746 1598 1599 1747 1601 1602 1603 564 765 564 564 564 564 640 651 651 651 640 640 640 640 420 420 843 844 420 420 410 410 420 410 693 748 693 748 409 410 420 420 420 410 555 556 410 693 409 748 748 410 861 862 693 554 687 564 564 758 769 564 564 765 564 564 852 1604 1605 1606 1749 1750 1609 1751 1611 1612 1752 1614 1615 1616 564 765 564 564 564 564 564 651 651 640 640 651 651 651 651 420 852 853 845 846 847 848 849 850 851 410 410 870 409 410 848 849 850 851 410 402 406 406 412 406 406 405 410 410 410 410 687 564 564 765 564 564 564 760 761 564 933 1617 1618 1619 1620 1753 1622 1754 1624 1625 1756 1627 1628 1629 564 765 564 564 564 564 564 651 651 651 640 640 640 640 640 420 861 862 854 855 856 857 858 859 860 402 406 406 408 748 857 858 859 860 410 409 410 693 410 410 410 404 406 405 410 410 690 689 564 760 762 761 564 564 760 761 832 1630 1631 1632 1633 1757 1635 1758 1759 1760 1761 1640 1641 1642 564 760 762 761 564 564 564 564 640 651 651 651 651 651 651 651 870 410 863 864 865 866 867 868 869 409 748 693 409 693 866 867 912 410 410 409 845 846 847 848 849 850 851 409 410 693 410 687 564 564 564 765 564 564 564 765 831 1643 1644 1645 1646 1763 1648 1649 1650 1651 1652 1653 1654 1655 564 564 564 765 564 564 564 564 651 651 640 640 640 640 640 651 410 748 410 410 410 748 410 410 410 409 748 410 409 410 748 410 410 410 410 409 854 855 856 857 858 859 860 409 748 410 748 690 689 564 564 765 564 564 564 765 824 1656 1657 1658 1659 1765 1661 1662 1663 1664 1665 1666 1667 1668 564 564 564 765 564 564 564 564 651 640 640 640 640 651 640 651 410 870 693 748 552 553 693 748 410 409 410 870 409 554 410 410 693 410 410 409 863 864 865 866 867 868 869 404 405 410 693 410 687 564 564 765 564 564 564 764 816 1669 1670 1671 1672 1766 1767 1768 1769 1677 1678 1679 1680 1681 564 564 564 765 564 564 564 564 651 640 640 640 651 651 651 651 410 410 410 870 555 556 410 693 554 409 410 410 409 554 693 410 410 410 410 409 410 693 816 817 410 420 410 410 409 554 410 410 690 689 564 760 762 762 763 769 815 1682 1683 1684 1685 1686 1687 1688 1770 1690 1691 1692 1693 1694 564 564 758 769 564 564 564 564 651 640 651 640 640 640 651 693 693 402 406 406 405 410 402 406 406 412 406 406 412 406 406 406 406 406 406 412 406 405 825 826 848 849 850 410 409 748 552 553 410 687 564 564 564 564 765 564 800 1695 1696 1697 1698 1699 1700 1701 1771 1703 1704 1705 1706 1707 564 758 769 564 564 564 564 564 651 640 640 640 651 651 651 651 410 409 410 410 404 406 413 410 410 693 410 410 845 846 847 848 849 850 851 816 817 409 834 835 857 858 859 410 409 693 555 556 748 690 689 564 564 564 765 564 808 1708 1709 1710 1711 1712 1713 1714 1772 1717 1718 1719 1720 1721 724 765 564 564 564 564 564 564 651 640 651 640 640 640 651 651 410 404 405 410 410 693 693 410 410 410 410 748 854 855 856 857 858 859 860 825 826 409 843 844 866 867 912 410 404 405 410 410 410 410 687 564 564 564 765 564 807 1722 1723 1724 1725 1726 1727 1728 1773 1730 1731 1732 1733 1734 621 765 564 564 564 564 564 564 640 651 651 651 651 651 747 693 693 748 409 871 872 873 874 875 876 877 878 410 863 864 865 866 867 868 869 834 835 409 852 853 748 410 410 410 410 409 410 554 816 817 687 564 564 564 765 564 789 790 791 792 793 794 795 564 409 564 796 797 798 799 806 765 564 564 564 564 564 640 640 651 651 640 640 640 640 752 754 870 409 880 881 882 883 884 885 886 887 402 406 406 407 406 406 405 410 843 844 409 861 862 410 420 410 410 410 409 552 553 825 826 690 691 689 564 765 564 564 564 564 564 564 564 758 762 768 762 762 762 762 763 762 764 564 564 564 564 564 640 640 651 651 640 651 651 651 651 747 410 409 889 890 891 892 893 894 895 896 409 410 410 409 410 552 409 410 852 853 409 410 410 410 410 410 410 410 404 405 556 834 835 410 748 687 564 760 762 762 763 762 762 762 762 769 564 564 564 564 564 564 765 564 765 564 564 564 640 640 640 640 651 640 640 640 640 640 640 747 748 409 898 899 900 901 902 903 904 905 409 410 410 409 410 555 409 410 861 862 409 410 410 410 410 410 402 406 406 413 410 843 844 410 693 690 689 564 564 564 765 564 564 564 564 564 564 564 564 758 762 762 769 564 765 564 564 564 640 640 640 651 651 640 651 651 651 651 651 747 870 409 907 866 908 909 910 911 912 913 409 410 410 409 410 555 404 405 693 748 409 410 410 410 410 410 409 410 410 748 748 852 853 410 410 410 687 564 564 1842 760 762 761 743 564 564 564 564 564 765 564 564 564 564 765 564 640 640 640 626 640 651 651 640 640 640 640 640 640 747 410 404 405 410 410 410 410 402 406 406 413 410 410 409 410 420 410 404 406 406 412 406 406 406 406 406 412 406 407 406 405 861 862 748 410 410 690 689 1842 1842 743 564 760 762 762 762 762 762 762 769 615 632 743 564 765 564 640 640 634 564 635 651 651 651 651 651 651 651 747 410 816 817 404 406 406 406 406 408 410 410 410 410 410 409 410 420 410 748 410 410 693 410 410 410 410 410 410 693 409 410 404 406 406 406 405 410 410 687 1842 1842 743 564 564 564 564 694 694 564 564 615 642 631 694 642 79 651 9 640 640 643 640 651 651 640 640 640 640 640 747 748 825 826 410 410 410 410 410 409 748 410 410 410 410 404 406 405 410 410 410 410 871 872 873 874 875 876 877 878 409 410 410 748 410 410 409 410 554 690 691 691 689 651 651 564 652 651 651 631 694 642 651 651 640 9 79 651 9 640 640 640 640 651 651 651 651 651 651 747 410 870 834 835 410 410 410 410 693 409 748 410 410 410 816 817 410 404 405 410 748 748 880 881 882 883 884 885 886 887 409 420 410 420 410 410 409 410 410 554 410 693 410 651 651 631 642 651 640 651 640 651 640 640 651 651 79 651 9 640 640 640 640 651 651 640 640 640 640 747 748 410 843 844 552 553 410 410 410 404 405 410 410 410 825 826 410 410 409 410 410 410 889 890 891 892 893 894 895 896 409 748 848 849 850 851 403 406 406 406 405 410 640 9 651 640 640 651 640 651 640 651 640 640 640 651 79 651 651 9 640 640 640 626 651 640 640 640 640 747 553 553 852 853 555 556 748 410 748 410 404 406 406 405 834 835 693 410 409 410 410 748 898 899 900 901 902 903 904 905 409 693 857 858 859 860 409 693 410 748 409 748 640 9 640 410 753 651 640 651 747 753 640 640 747 753 79 640 640 410 753 640 634 564 635 640 651 651 651 747 553 553 861 862 410 748 410 410 748 410 410 552 553 409 843 844 552 553 409 410 410 410 907 866 908 909 910 911 912 913 409 410 866 867 912 410 409 410 410 410 409 410 640 9 640 747 410 753 651 651 747 753 640 651 747 753 79 651 651 410 753 640 651 643 9 640 640 640 640 553 553 553 640 752 752 752 752 754 410 870 410 555 556 409 852 853 555 556 409 410 410 554 748 410 410 410 410 410 410 410 409 410 748 410 410 410 409 410 410 410 409 410 410 693 410 410 410 410 753 651 747 410 410 410 748 410 409 651 410 410 753 640 651 651 9 651 651 651 651 553 553 553 651 640 640 640 640 747 410 410 410 410 410 409 861 862 410 410 403 406 406 406 406 406 406 406 406 406 406 406 412 406 406 406 406 406 408 410 410 748 404 406 405 410 410 748 748 410 410 748 410 410 748 410 410 410 409 410 410 748 753 640 651 651 9 640 640 640 640 553 640 640 640 651 651 651 651 651 752 752 754 410 748 404 405 554 410 410 403 406 406 405 748 410 410 410 410 410 693 845 846 847 848 849 850 851 409 410 410 693 748 748 409 410 748 693 402 406 406 406 406 406 406 406 406 406 413 748 410 410 753 651 9 651 9 63 63 63 553 640 640 640 640 640 640 640 640 640 640 640 640 410 748 410 403 406 406 406 413 410 748 409 552 553 748 410 410 748 410 854 855 856 857 858 859 860 404 406 406 406 406 406 412 406 406 406 408 410 693 410 748 410 410 693 748 410 410 748 410 410 753 9 651 651 9 63 63 651 651 651 651 651 651 651 651 651 651 651 651 651 651 9 752 697 767 703 704 693 410 748 748 409 555 556 410 870 410 748 410 863 864 865 866 867 868 869 410 410 410 410 410 410 748 410 410 748 404 406 406 405 410 748 410 410 552 553 410 410 410 410 553 553 651 9 9 63 63 640 640 640 640 640 640 640 640 640 640 640 640 640 640 9 9 9 772 9 9 410 410 693 693 409 410 410 410 410 410 752 752 410 410 410 555 556 748 410 410 410 410 554 410 410 410 748 693 410 693 410 748 409 410 748 410 410 555 556 410 410 410 410 553 553 553 9 9 63 63 651 651 651 651 651 651 651 651 651 63 63 63 63 63 63 9 9 79 9 63 640 410 410 410 409 748 693 748 693 752 63 63 752 410 752 752 752 752 410 410 410 410 410 410 410 693 410 410 410 410 693 693 748 410 410 748 693 553 553 553 553 553 553 553 553 553 553 63 63 63 640 640 640 640 640 640 640 640 640 63 63 63 63 63 63 9 9 79 9 640 640 640 640 752 409 752 693 752 752 63 63 63 63 752 63 63 63 9 752 752 752 410 410 410 410 410 410 410 410 410 410 410 553 553 553 553 553 553 553 553 553 553 553 553 553 553 553 63 63 63 63 63 63 78 78 78 81 651 651 651 640 63 63 63 80 78 78 85 63 63 63 63 63 63 409 63 9 9 63 63 63 63 63 9 9 9 9 63 63 9 9 752 752 752 752 409 409 409 409 409 752 752 553 553 553 553 63 63 63 553 553 553 553 553 553 553 553 63 63 63 63 63 63 63 63 63 84 78 78 78 78 78 78 78 85 63 63 63 63 63 63 63 63 63 412 407 407 407 407 407 407 407 407 407 407 407 407 407 407 407 407 406 406 406 406 45 45 45 45 45 9 640 640 63 63 63 63 63 63 63 553 553 553 553 553 553 553 63 63 63 63 63 63 63 63 63 63 63 63 63 63 63 63 63 63 63 63 63 63 63 63 63 63 63 63 411 411 411 411 411 411 411 411 411 411 411 411 411 411 411 411 9 9 9 9 411 411 411 411 411 9 651 651 651 651 63 63 63 63 63 553 553 553 553 553 63 63 63 63 63 63 63 63 63 63 63 640 640 640 640 640 640 63 63 63 63 63 63 640 640 640 640 640 640 640 640 640 63 63 63 63 63 63 63 63 63 63 63 63 63 63 63 63 63 63 63 63 63 63 63 9 651 651 651 651 63 63 640 640 651 651 651 553 553 553 63 63 63 63 63 640 640 640 640 640 640 640 640 651 651 651 651 63 63 63 63 63 63 640 651 640 640 640 640 640 63 63 63 63 63 63 63 63 63 63 63 63 63 63 63 63 63 63 63 63 63 63 63 63 63 63 651 651 651 63 63 63 63 640 640 640 63 63 63 63 63 63 63 63 63 63 640 651 651 651 651 651 651 640 640 640 640 63 63 63 63 63 63 640 640 640 651 651 651 651 63 63 63 63 63 63 63 63 63 63 63 63 63 63 63 63 63 63 63 63 63 63 63 63 63 63 63 63 63 63 63 63 63 63 640 640 63 63 63 63 63 63 63)
    )
    (worldmap-spawnpoint
      (name "main")
      (x 12)
      (y 45)
    )
    (level
      (name "castledoor.stl")
      (x 50)
      (y 12)
      (sprite "images/worldmap/common/torch1.sprite")
    )
    (level
      (name "castledoor.stl")
      (x 51)
      (y 18)
      (sprite "images/worldmap/common/n_stone.sprite")
    )
    (level
      (name "castledoor.stl")
      (x 55)
      (y 16)
      (sprite "images/worldmap/common/torch.sprite")
    )
    (level
      (name "castledoor.stl")
      (x 56)
      (y 12)
      (sprite "images/worldmap/common/torch1.sprite")
    )
    (level
      (name "castledoor.stl")
      (x 55)
      (y 8)
      (sprite "images/worldmap/common/torch.sprite")
    )
    (level
      (name "key4.stl")
      (x 50)
      (y 46)
      (sprite "images/worldmap/forest/small_fire.sprite")
    )
    (level
      (name "key3.stl")
      (x 49)
      (y 46)
      (sprite "images/worldmap/forest/small_wood.sprite")
    )
    (level
      (name "key2.stl")
      (x 48)
      (y 46)
      (sprite "images/worldmap/forest/small_earth.sprite")
    )
    (level
      (name "key1.stl")
      (x 47)
      (y 46)
      (sprite "images/worldmap/forest/small_water.sprite")
    )
    (level
      (name "airkey.stl")
      (x 51)
      (y 44)
      (sprite "images/worldmap/forest/leveldots/anmaster-1.sprite")
    )
    (level
      (name "christoph1.stl")
      (x 34)
      (y 46)
      (sprite "images/worldmap/forest/leveldots/sommer-1.sprite")
    )
    (level
      (name "christoph2.stl")
      (x 33)
      (y 46)
      (sprite "images/worldmap/forest/leveldots/sommer-2.sprite")
    )
    (level
      (name "christoph3.stl")
      (x 32)
      (y 46)
      (sprite "images/worldmap/forest/leveldots/sommer-3.sprite")
    )
    (level
      (name "christoph4.stl")
      (x 31)
      (y 46)
      (sprite "images/worldmap/forest/leveldots/sommer-4.sprite")
    )
    (level
      (name "christoph5.stl")
      (x 30)
      (y 46)
      (sprite "images/worldmap/forest/leveldots/sommer-5.sprite")
    )
    (level
      (name "christoph6.stl")
      (x 29)
      (y 46)
      (sprite "images/worldmap/forest/leveldots/sommer-6.sprite")
    )
    (level
      (name "owls_revenge.stl")
      (x 27)
      (y 46)
      (sprite "images/worldmap/forest/leveldots/sommer-revenge.sprite")
    )
    (level
      (name "forest1-grumbel.stl")
      (x 35)
      (y 46)
      (sprite "images/worldmap/forest/leveldots/grumbel-1.sprite")
    )
    (level
      (name "level1.stl")
      (x 36)
      (y 46)
      (sprite "images/worldmap/forest/leveldots/wansti-1.sprite")
    )
    (level
      (name "level2.stl")
      (x 48)
      (y 44)
      (sprite "images/worldmap/forest/leveldots/wansti-2.sprite")
    )
    (level
      (name "level4.stl")
      (x 38)
      (y 46)
      (sprite "images/worldmap/forest/leveldots/anubis-4.sprite")
    )
    (level
      (name "level5.stl")
      (x 39)
      (y 46)
      (sprite "images/worldmap/forest/leveldots/anubis-5.sprite")
    )
    (level
      (name "castledoor.stl")
      (x 41)
      (y 46)
      (sprite "images/worldmap/forest/leveldots/gwater-1.sprite")
    )
    (level
      (name "level6.stl")
      (x 40)
      (y 46)
      (sprite "images/worldmap/forest/leveldots/anubis-6.sprite")
    )
    (level
      (name "christoph7.stl")
      (x 28)
      (y 46)
      (sprite "images/worldmap/forest/leveldots/sommer-7.sprite")
    )
    (level
      (name "key5.stl")
      (x 51)
      (y 46)
      (sprite "images/worldmap/forest/small_air.sprite")
    )
  )
  (tileset "images/worldmap.strf")
)
