; Generated by Flexlay Editor
(supertux-worldmap
  (properties
    (name (_ "Forest World"))
    (music "forestmap.ogg")
  )
  (spawnpoint
    (name "main")
    (x 2)
    (y 15)
  )
  (tilemap
    (width 70)
    (height 50)
    (layer "interactive")
    (solid #t)
    (speed 1.000000)
    (tiles
 73  73  73  73  73  73  73  73  73  73  73  73  73  73  73  73  95  73  73  73  73  73  73  73  73  73  73  73  73  73  73  73  73  73  73  73  73  73  73  73  73  73  73  73  73  73  73  73  73  73  73  73  73  73  73  73  73  73  73  73  73  73  73  73  73  73  73  73  73  73
 73  73  73  73  73  73  114 73  73  73  73  73  73  73  73  73  95  73  73  73  73  73  73  73  73  73  73  73  73  73  73  73  73  73  73  73  73  73  73  73  73  73  73  73  73  73  73  73  73  73  73  73  73  73  73  73  73  73  73  73  73  73  73  73  73  73  73  73  73  73
 73  73  73  73  73  73  73  113 108 108 73  73  73  73  73  73  95  73  73  73  73  73  73  73  73  73  73  73  73  73  73  73  73  73  73  73  73  73  73  73  73  73  73  73  73  73  73  73  73  73  73  73  73  73  73  73  73  73  73  73  73  73  73  73  73  73  73  73  73  73
 73  73  73  73  73  73  113 109 74  74  74  74  74  74  74  74  95  74  74  74  74  74  74  74  74  74  74  74  74  74  74  74  74  74  74  74  74  74  74  74  74  74  74  74  74  74  74  73  73  73  73  73  73  73  73  73  73  73  73  73  73  73  73  73  73  73  73  73  73  73
 73  73  73  114 73  73  106 74  74  102 103 104 74  74  74  74  91  74  74  74  74  74  74  74  74  74  74  74  74  74  74  74  74  74  74  74  74  74  74  74  74  74  74  74  74  74  74  73  73  73  73  73  73  73  73  73  73  73  73  73  73  73  73  73  73  73  73  73  73  73
 73  73  73  73  73  113 109 74  74  105 113 109 83  75  75  75  89  90  75  75  75  75  86  75  75  75  75  75  75  75  75  75  75  75  75  88  74  74  74  74  74  74  74  74  77  74  74  73  73  73  73  73  73  73  73  73  73  73  73  73  73  73  73  73  73  73  73  73  73  73
 73  73  73  73  73  106 74  74  74  107 109 74  78  74  74  74  93  92  74  74  74  74  78  74  74  74  74  74  74  74  74  74  74  74  74  78  74  74  74  74  74  74  74  74  74  74  74  74  73  73  73  73  73  73  73  73  73  73  73  73  73  73  73  73  73  73  73  73  73  73
 73  73  73  73  73  106 74  83  75  75  75  75  84  74  74  74  94  97  74  74  74  74  78  74  74  74  74  74  74  74  74  74  74  74  74  78  74  74  74  74  74  74  77  77  77  74  74  74  73  73  73  73  73  73  73  73  73  73  73  73  73  73  73  73  73  73  73  73  73  73
 73  73  73  73  73  106 74  78  74  74  74  74  74  74  74  94 100  74  74  74  74  74  78  74  74  74  74  74  77  74  74  74  74  74  74  78  74  77  77  77  77  77  77  77  77  74  74  73  73  73  73  73  73  73  73  73  73  73  73  73  73  73  73  73  73  73  73  73  73  73
 73  73  73  73  73  106 74  82  88  74  74  74  74  74  74  95  74  74  74  74  74  74  78  74  74  74  74  74  77  77  74  74  74  74  77  82  76  76  76  76  76  76  76  76  77  74  74  73  73  73  73  73  73  73  73  73  73  73  73  73  73  73  73  73  73  73  73  73  73  73
 73  73  73  73  73  111 104 74  78  74  74  74  74  74  74  98 101  74  74  74  74  74  78  74  74  74  77  74  77  77  74  74  74  74  77  77  77  77  77  77  77  77  77  76  77  74  74  73  73  73  73  73  73  73  73  73  73  73  73  73  73  73  73  73  73  73  73  73  73  73
 73  73  73  73  73  113 109 74  78  74  74  74  74  74  74  74  95  74  74  74  74  74  78  74  74  77  77  77  77  77  77  77  74  74  77  77  77  77  77  77  77  77  77  76  77  74  74  73  73  73  73  73  73  73  73  73  73  73  73  73  73  73  73  73  73  73  73  73  73  73
 73  73  73  73  73  106 74  83  84  74  74  74  74  74  74  94  97  74  74  74  74  74  78  74  74  77  77  77  77  77  77  77  74  77  77  77  77  77  77  77  77  77  77  76  77  77  74  73  73  73  73  73  73  73  73  73  73  73  73  73  73  73  73  73  73  73  73  73  73  73
 73  73  73  73  73  106 74  78  74  74  74  74  74  74  74  91  74  74  74  74  74  74  78  74  74  77  77  77  77  77  77  77  77  77  77  77  77  77  77  77  77  77  77  76  77  77  74  74  73  73  73  73  73  73  73  73  73  73  73  73  73  73  73  73  73  73  73  73  73  73
 73  113 108 108 108 109 74  80  75  75  75  75  75  75  75  89  90  75  75  75  75  75  85  74  77  77  77  77  77  77  77  77  77  77  77  77  77  77  77  77  77  77  77  76  77  74  74  74  74  73  73  73  73  73  73  73  73  73  73  73  73  73  73  73  73  73  73  73  73  73
 73  106 75  75  75  75  75  79  74  74  74  74  74  74  74  93  92  74  74  74  74  77  76  77  77  77  77  77  77  77  77  77  77  77  77  77  77  77  77  77  77  77  77  76  77  77  74  74  74  73  73  73  73  73  73  73  73  73  73  73  73  73  73  73  73  73  73  73  73  73
 73  111 103 103 103 74  74  78  74  74  74  74  74  74  74  74  95  74  74  74  77  77  76  77  77  77  77  77  77  77  77  77  77  77  77  77  77  77  77  77  77  77  77  76  77  74  74  74  74  73  73  73  73  73  73  73  73  73  73  73  73  73  73  73  73  73  73  73  73  73
 73  73  73  73  74  74  74  78  74  74  74  74  74  74  74  74  95  74  74  77  77  77  76  76  76  76  76  76  76  76  77  77  77  77  77  77  77  77  77  77  77  77  77  76  77  74  74  74  74  73  73  73  73  73  73  73  73  73  73  73  73  73  73  73  73  73  73  73  73  73
 73  73  73  73  74  74  74  78  74  74  74  74  74  74  74  74  95  74  74  77  77  77  76  77  77  77  77  77  77  76  77  77  77  77  77  77  77  77  76  77  77  77  77  76  77  74  74  74  74  73  73  73  73  73  73  73  73  73  73  73  73  73  73  73  73  73  73  73  73  73
 73  73  73  73  74  74  74  78  74  74  74  74  74  94  96  96  97  74  74  77  77  77  76  77  77  77  77  77  77  76  77  77  77  77  77  77  77  77  76  77  77  76  76  76  77  77  74  74  74  73  73  73  73  73  73  73  73  73  73  73  73  73  73  73  73  73  73  73  73  73
 73  73  73  73  74  74  74  78  74  74  74  74  74  98 101  74  74  74  74  74  77  77  76  77  77  77  77  77  77  76  77  77  77  77  77  77  77  77  76  76  76  76  77  76  77  77  74  74  74  73  73  73  73  73  73  73  73  73  73  73  73  73  73  73  73  73  73  73  73  73
 73  73  73  73  74  74  74  78  74  74  74  74  74  74  98  101 74  74  74  74  77  77  76  77  77  77  77  77  77  76  77  77  77  77  77  77  77  77  77  77  77  77  77  76  77  74  74  74  74  73  73  73  73  73  73  73  73  73  73  73  73  73  73  73  73  73  73  73  73  73
 73  73  73  73  74  74  74  78  74  74  74  74  74  74  94  97  74  74  74  74  74  77  76  77  77  77  77  77  77  76  77  77  77  77  77  77  77  77  77  77  77  77  77  76  77  74  74  74  74  73  73  73  73  73  73  73  73  73  73  73  73  73  73  73  73  73  73  73  73  73
 73  73  73  73  74  74  74  78  74  74  74  74  74  74  91  74  74  74  74  74  74  74  78  74  77  77  77  77  77  76  77  77  77  77  77  77  77  77  77  77  77  77  77  76  77  74  74  74  74  73  73  73  73  73  73  73  73  73  73  73  73  73  73  73  73  73  73  73  73  73
 73  73  73  73  74  74  74  80  75  75  75  75  75  75  89  90  75  75  74  74  74  74  78  74  74  77  77  77  77  76  76  76  76  76  76  76  76  76  76  76  76  76  76  76  77  74  74  74  74  73  73  73  73  73  73  73  73  73  73  73  73  73  73  73  73  73  73  73  73  73
 73  73  73  73  74  74  74  78  74  74  74  74  74  74  93  92  74  74  74  74  74  74  78  74  74  77  77  77  77  77  77  77  77  77  77  77  77  77  77  77  77  77  77  77  77  74  74  74  74  73  73  73  73  73  73  73  73  73  73  73  73  73  73  73  73  73  73  73  73  73
 73  73  73  73  74  74  74  78  74  74  74  74  74  74  74  95  74  74  74  74  74  74  78  74  74  77  77  77  77  77  77  77  77  77  74  74  78  74  77  77  77  77  77  77  77  74  74  74  74  73  73  73  73  73  73  73  73  73  73  73  73  73  73  73  73  73  73  73  73  73
 73  73  73  73  74  74  74  78  74  74  74  74  74  74  74  95  74  74  74  74  74  74  78  74  74  77  77  77  77  77  74  74  74  74  74  74  78  74  74  77  77  77  77  77  77  74  74  74  74  74  73  73  73  73  73  73  73  73  73  73  73  73  73  73  73  73  73  73  73  73
 73  73  73  73  74  74  74  78  74  74  74  74  74  74  74  98 101  74  74  74  74  74  78  74  74  74  77  74  77  74  74  74  74  74  74  74  78  74  74  77  77  77  77  77  74  74  74  74  74  73  73  73  73  73  73  73  73  73  73  73  73  73  73  73  73  73  73  73  73  73
 73  73  73  73  74  74  74  78  74  74  74  74  74  74  74  74  91  74  74  74  74  74  78  74  74  74  74  74  74  74  74  74  74  74  74  74  78  74  74  74  74  77  77  74  74  74  74  74  74  73  73  73  73  73  73  73  73  73  73  73  73  73  73  73  73  73  73  73  73  73
 73  73  73  73  73  74  74  82  75  75  75  75  75  75  75  75  89  90  75  75  75  75  87  75  75  75  75  75  75  75  75  75  75  75  75  75  81  74  74  74  74  74  77  74  74  74  74  74  73  73  73  73  73  73  73  73  73  73  73  73  73  73  73  73  73  73  73  73  73  73
 73  73  73  73  74  74  74  74  74  74  74  74  74  74  74  74  93  92  74  74  74  74  74  74  74  74  74  74  74  74  74  74  74  74  74  74  74  74  74  74  74  74  74  74  74  74  73  73  73  73  73  73  73  73  73  73  73  73  73  73  73  73  73  73  73  73  73  73  73  73
 73  73  73  73  74  74  74  74  74  74  74  74  74  74  74  74  74  95  74  74  74  74  74  74  74  74  74  74  74  74  74  74  74  74  74  74  74  74  74  74  74  74  74  74  73  73  73  73  73  73  73  73  73  73  73  73  73  73  73  73  73  73  73  73  73  73  73  73  73  73
 73  73  73  73  74  74  73  74  74  74  74  74  74  74  74 103  74  95  74  74  74  74  74  74  74  74  74  74  74  74  74  74  74  74  74  74  74  74  74  74  73  73  73  73  73  73  73  73  73  73  73  73  73  73  73  73  73  73  73  73  73  73  73  73  73  73  73  73  73  73
 73  73  73  73  73  73  73  73  73  73  73  73  73  73  73  73  73  73  73  73  73  73  73  73  73  73  73  73  73  73  73  73  73  73  73  73  73  73  73  73  73  73  73  73  73  73  73  73  73  73  73  73  73  73  73  73  73  73  73  73  73  73  73  73  73  73  73  73  73  73
 73  73  73  73  73  73  73  73  73  73  73  73  73  73  73  73  73  73  73  73  73  73  73  73  73  73  73  73  73  73  73  73  73  73  73  73  73  73  73  73  73  73  73  73  73  73  73  73  73  73  73  73  73  73  73  73  73  73  73  73  73  73  73  73  73  73  73  73  73  73
 73  73  73  73  73  73  73  73  73  73  73  73  73  73  73  73  73  73  73  73  73  73  73  73  73  73  73  73  73  73  73  73  73  73  73  73  73  73  73  73  73  73  73  73  73  73  73  73  73  73  73  73  73  73  73  73  73  73  73  73  73  73  73  73  73  73  73  73  73  73
 73  73  73  73  73  73  73  73  73  73  73  73  73  73  73  73  73  73  73  73  73  73  73  73  73  73  73  73  73  73  73  73  73  73  73  73  73  73  73  73  73  73  73  73  73  73  73  73  73  73  73  73  73  73  73  73  73  73  73  73  73  73  73  73  73  73  73  73  73  73
 73  73  73  73  73  73  73  73  73  73  73  73  73  73  73  73  73  73  73  73  73  73  73  73  73  73  73  73  73  73  73  73  73  73  73  73  73  73  73  73  73  73  73  73  73  73  73  73  73  73  73  73  73  73  73  73  73  73  73  73  73  73  73  73  73  73  73  73  73  73
 73  73  73  73  73  73  73  73  73  73  73  73  73  73  73  73  73  73  73  73  73  73  73  73  73  73  73  73  73  73  73  73  73  73  73  73  73  73  73  73  73  73  73  73  73  73  73  73  73  73  73  73  73  73  73  73  73  73  73  73  73  73  73  73  73  73  73  73  73  73
 73  73  73  73  73  73  73  73  73  73  73  73  73  73  73  73  73  73  73  73  73  73  73  73  73  73  73  73  73  73  73  73  73  73  73  73  73  73  73  73  73  73  73  73  73  73  73  73  73  73  73  73  73  73  73  73  73  73  73  73  73  73  73  73  73  73  73  73  73  73
 73  73  73  73  73  73  73  73  73  73  73  73  73  73  73  73  73  73  73  73  73  73  73  73  73  73  73  73  73  73  73  73  73  73  73  73  73  73  73  73  73  73  73  73  73  73  73  73  73  73  73  73  73  73  73  73  73  73  73  73  73  73  73  73  73  73  73  73  73  73
 73  73  73  73  73  73  73  73  73  73  73  73  73  73  73  73  73  73  73  73  73  73  73  73  73  73  73  73  73  73  73  73  73  73  73  73  73  73  73  73  73  73  73  73  73  73  73  73  73  73  73  73  73  73  73  73  73  73  73  73  73  73  73  73  73  73  73  73  73  73
 73  73  73  73  73  73  73  73  73  73  73  73  73  73  73  73  73  73  73  73  73  73  73  73  73  73  73  73  73  73  73  73  73  73  73  73  73  73  73  73  73  73  73  73  73  73  73  73  73  73  73  73  73  73  73  73  73  73  73  73  73  73  73  73  73  73  73  73  73  73
 73  73  73  73  73  73  73  73  73  73  73  73  73  73  73  73  73  73  73  73  73  73  73  73  73  73  73  73  73  73  73  73  73  73  73  73  73  73  73  73  73  73  73  73  73  73  73  73  73  73  73  73  73  73  73  73  73  73  73  73  73  73  73  73  73  73  73  73  73  73
 73  73  73  73  73  73  73  73  73  73  73  73  73  73  73  73  73  73  73  73  73  73  73  73  73  73  73  73  73  73  73  73  73  73  73  73  73  73  73  73  73  73  73  73  73  73  73  73  73  73  73  73  73  73  73  73  73  73  73  73  73  73  73  73  73  73  73  73  73  73
 73  73  73  73  73  73  73  73  73  73  73  73  73  73  73  73  73  73  73  73  73  73  73  73  73  73  73  73  73  73  73  73  73  73  73  73  73  73  73  73  73  73  73  73  73  73  73  73  73  73  73  73  73  73  73  73  73  73  73  73  73  73  73  73  73  73  73  73  73  73
 73  73  73  73  73  73  73  73  73  73  73  73  73  73  73  73  73  73  73  73  73  73  73  73  73  73  73  73  73  73  73  73  73  73  73  73  73  73  73  73  73  73  73  73  73  73  73  73  73  73  73  73  73  73  73  73  73  73  73  73  73  73  73  73  73  73  73  73  73  73
 73  73  73  73  73  73  73  73  73  73  73  73  73  73  73  73  73  73  73  73  73  73  73  73  73  73  73  73  73  73  73  73  73  73  73  73  73  73  73  73  73  73  73  73  73  73  73  73  73  73  73  73  73  73  73  73  73  73  73  73  73  73  73  73  73  73  73  73  73  73
 73  73  73  73  73  73  73  73  73  73  73  73  73  73  73  73  73  73  73  73  73  73  73  73  73  73  73  73  73  73  73  73  73  73  73  73  73  73  73  73  73  73  73  73  73  73  73  73  73  73  73  73  73  73  73  73  73  73  73  73  73  73  73  73  73  73  73  73  73  73

)
  )
  (level
    (x 6)
    (y 14)
    (name "level1.stl")
  )
  (level
    (x 13)
    (y 5)
    (name "level5.stl")
  )

)
