; Generated by Flexlay Editor
(supertux-worldmap
  (properties
    (name (_ "Forest World"))
    (music "forestmap.ogg")
    (start_pos_x 0)
    (start_pos_y 0)
  )
  (tilemap
    (width 70)
    (height 50)
    (layer "interactive")
    (solid #t)
    (speed 1.000000)
    (tiles 168 168 168 168 168 168 168 168 168 168 413 413 413 413 413 413 413 413 413 413 296 296 296 296 296 296 296 296 296 296 296 296 296 296 296 296 296 296 296 296 296 296 413 413 413 413 413 413 413 413 413 413 413 413 413 413 413 413 413 413 413 413 413 413 413 413 413 413 413 413 168 168 168 168 413 413 413 168 168 168 413 413 413 413 413 413 296 296 413 413 296 296 296 296 296 296 296 296 296 296 296 296 296 296 296 296 296 296 296 296 296 413 413 413 413 413 413 413 413 413 413 413 413 413 413 413 413 413 413 413 413 413 413 413 413 413 413 413 413 413 168 168 168 168 413 413 413 413 413 413 413 413 413 413 413 296 296 296 413 413 296 296 296 296 296 296 296 296 296 296 296 296 296 296 296 296 296 296 296 296 296 413 413 413 413 413 413 413 413 413 413 413 413 413 413 413 413 413 413 413 413 413 413 413 413 413 413 413 413 413 168 168 168 168 413 413 413 413 413 413 413 413 413 413 413 296 296 296 413 413 296 296 296 296 296 296 296 296 296 296 296 296 296 296 296 296 296 296 296 296 413 413 413 413 413 413 413 413 413 413 413 413 413 413 413 413 413 413 413 413 413 413 413 413 413 413 413 413 413 413 168 168 413 413 413 413 413 413 413 413 413 413 413 413 413 413 296 296 296 296 296 296 296 296 296 296 296 296 296 296 296 296 296 296 296 296 296 296 296 296 413 413 413 413 413 413 413 413 413 413 413 413 413 413 413 413 413 413 413 413 413 413 413 413 413 413 413 413 413 413 168 168 413 413 413 413 413 413 413 413 413 413 404 407 407 407 407 407 407 407 407 407 408 407 407 407 407 407 407 407 407 407 407 407 407 406 296 296 296 413 413 413 413 413 413 413 413 413 413 413 413 413 413 413 413 413 413 413 413 413 413 413 413 413 413 413 413 413 413 413 168 168 413 168 168 413 413 413 413 413 413 413 414 413 413 413 413 413 296 296 413 296 414 296 400 400 296 296 296 296 296 296 168 168 168 414 296 296 296 413 413 413 413 413 413 413 413 413 413 413 413 413 413 413 413 413 413 413 413 413 413 413 413 413 413 413 413 413 413 413 168 168 168 413 413 413 413 404 407 407 407 407 419 413 413 413 413 413 413 413 413 296 414 296 296 296 168 296 296 296 296 296 168 168 168 414 296 296 296 296 296 296 296 296 413 413 413 413 413 413 413 413 413 413 413 413 413 413 413 413 413 413 413 413 413 413 413 413 413 413 168 168 168 413 413 413 413 414 413 413 413 413 413 413 413 413 413 413 413 413 296 296 414 296 168 168 168 168 168 168 168 168 168 168 168 414 296 296 296 296 296 296 296 296 413 413 413 413 413 413 413 413 413 413 413 413 413 413 413 413 413 413 413 413 413 413 413 413 413 413 168 168 168 413 413 413 413 420 406 413 413 413 413 413 413 413 413 413 413 413 296 296 414 296 168 168 168 168 168 168 168 168 168 168 168 420 407 407 407 407 407 407 407 406 413 413 413 413 413 413 413 413 413 413 413 413 413 413 413 413 413 413 413 413 413 413 413 413 413 413 168 168 168 413 413 413 413 413 414 413 168 168 168 413 413 413 413 413 413 296 296 296 414 296 296 296 296 168 168 168 168 168 168 168 168 168 168 168 168 168 168 168 168 414 413 413 413 413 413 413 413 413 413 413 413 413 413 413 413 413 413 413 413 413 413 413 413 413 413 413 168 168 168 413 413 413 413 413 414 413 413 168 168 413 413 413 413 413 413 296 296 413 414 296 296 296 296 168 168 167 168 169 170 171 172 173 174 175 176 177 178 168 168 414 413 413 413 413 413 413 413 413 413 413 413 413 413 413 413 413 413 413 413 413 413 413 413 413 413 413 168 168 413 413 413 413 413 404 419 413 413 413 413 413 413 413 413 413 413 413 413 413 414 296 296 296 296 168 168 180 181 182 183 168 185 186 187 188 189 190 191 168 168 414 413 413 413 413 413 413 413 413 413 413 413 413 413 413 413 413 413 413 413 413 413 413 413 413 413 413 168 168 413 413 413 413 413 414 413 413 413 413 413 413 413 413 413 413 413 413 413 413 414 296 296 296 168 168 168 193 194 195 196 197 198 199 200 201 202 203 204 168 168 414 413 413 413 413 413 413 413 413 413 413 413 413 413 413 413 413 413 413 413 413 413 413 413 413 413 413 168 168 413 413 413 413 413 405 407 407 407 407 407 407 407 407 407 407 407 407 407 407 409 296 296 296 168 168 168 206 207 208 209 210 211 212 213 214 215 216 217 168 168 414 413 413 413 413 413 413 413 413 413 413 413 413 413 413 413 413 413 413 413 413 413 413 413 413 413 413 168 168 407 407 407 407 407 409 413 413 413 413 413 413 413 413 413 413 413 413 413 413 414 296 296 296 168 168 168 219 220 221 222 223 224 225 226 227 228 229 230 168 168 414 413 413 413 413 413 413 413 413 413 413 413 413 413 413 413 413 413 413 413 413 413 413 413 413 413 413 168 168 413 413 413 413 413 414 413 413 413 168 413 413 413 413 413 413 413 413 413 413 414 296 296 296 168 168 168 232 233 234 235 236 237 238 239 240 241 242 243 244 168 414 413 413 413 413 413 413 413 413 413 413 413 413 413 413 413 413 413 413 413 413 413 413 413 413 413 413 168 168 413 413 413 413 413 414 413 168 168 168 413 413 413 413 413 413 413 413 296 296 415 407 407 407 407 407 407 168 246 247 248 249 250 251 252 253 254 255 256 257 168 414 413 413 413 413 413 413 413 413 413 413 413 413 413 413 413 413 413 413 413 413 413 413 413 413 413 413 168 168 413 413 413 413 413 414 413 168 168 168 413 413 413 413 413 413 413 413 296 296 414 400 400 400 168 168 168 258 259 260 261 262 263 264 265 266 267 268 269 270 168 414 168 168 413 413 413 413 413 413 413 413 413 413 413 413 413 413 413 413 413 413 413 413 413 413 413 413 168 168 413 413 413 413 413 414 413 168 168 413 413 413 413 413 413 413 413 413 296 296 414 296 168 168 168 168 168 271 272 273 274 275 276 277 278 279 280 281 282 283 413 414 168 168 413 413 413 413 413 413 413 413 413 413 413 413 413 413 413 413 413 413 413 413 413 413 413 413 168 168 413 413 413 413 413 414 413 168 168 413 413 413 413 413 413 413 413 296 296 296 414 296 168 168 168 168 168 284 285 286 287 288 289 290 291 292 293 294 295 296 168 414 168 168 413 413 413 413 413 413 413 413 413 413 413 413 413 413 413 413 413 413 413 413 413 413 413 413 168 168 413 413 413 413 413 414 413 413 413 413 413 413 413 413 413 413 413 296 296 296 414 296 168 168 168 168 168 297 298 299 300 301 302 303 304 305 306 307 308 309 168 414 168 168 413 413 413 413 413 413 413 413 413 413 413 413 413 413 413 413 413 413 413 413 413 413 413 413 168 168 413 413 168 413 413 414 413 413 413 413 413 413 413 413 413 413 413 296 296 413 414 296 296 168 168 168 168 310 311 312 313 314 315 316 317 318 319 320 321 322 168 414 168 413 413 413 413 413 413 413 413 413 413 413 413 413 413 413 413 413 413 413 413 413 413 413 413 413 168 168 413 413 168 168 413 414 413 413 413 413 413 413 413 413 413 413 413 413 296 413 414 168 168 168 168 168 168 323 324 325 326 327 328 329 330 331 332 333 334 335 168 414 168 413 413 413 413 413 413 413 413 413 413 413 413 413 413 413 413 413 413 413 413 413 413 413 413 413 168 168 413 413 413 413 413 405 407 407 407 407 407 407 407 407 407 407 413 413 413 413 414 168 168 168 168 168 168 336 337 338 339 340 341 342 343 344 345 346 347 348 413 414 168 413 413 413 413 413 413 413 413 413 413 413 413 413 413 413 413 413 413 413 413 413 413 413 413 413 168 168 413 413 413 413 413 414 413 413 413 413 413 413 413 413 413 413 413 413 413 413 414 168 168 168 168 168 168 349 350 351 352 353 354 355 356 357 358 359 360 361 168 414 168 413 413 413 413 413 413 413 413 413 413 413 413 413 413 413 413 413 413 413 413 413 413 413 413 413 168 168 413 413 413 413 413 414 413 413 413 413 413 413 413 413 413 413 413 413 413 413 414 168 168 168 168 168 168 362 363 364 365 366 367 368 369 370 371 372 373 374 168 414 168 413 413 413 413 413 413 413 413 413 413 413 413 413 413 413 413 413 413 413 413 413 413 413 413 413 168 168 413 413 413 413 413 414 413 413 413 413 413 413 413 413 413 413 413 413 413 296 414 168 168 168 168 168 168 376 377 378 379 380 381 382 383 384 385 386 387 388 168 414 168 413 413 413 413 413 413 413 413 413 413 413 413 413 413 413 413 413 413 413 413 413 413 413 413 413 168 168 413 413 413 413 413 414 413 413 413 413 413 413 413 413 413 413 413 413 296 296 414 168 168 168 168 168 168 389 390 391 392 393 394 395 396 397 390 399 400 401 168 414 413 413 413 413 413 413 413 413 413 413 413 413 413 413 413 413 413 413 413 413 413 413 413 413 413 413 168 168 168 413 413 413 413 414 413 413 413 413 413 413 413 413 413 413 413 413 413 296 414 168 168 168 168 168 168 168 167 168 168 168 413 413 414 413 168 168 168 168 168 414 413 413 413 413 413 413 413 413 413 413 413 413 413 413 413 413 413 413 413 413 413 413 413 413 413 413 168 168 168 413 413 413 413 420 407 407 407 407 407 407 407 407 407 407 407 407 407 407 418 407 407 407 407 407 407 407 407 407 407 407 407 407 418 407 407 407 407 407 407 419 413 413 413 413 413 413 413 413 413 413 413 413 413 413 413 413 413 413 413 413 413 413 413 413 413 413 168 168 168 413 413 413 413 413 413 413 413 413 413 413 413 413 413 413 413 413 413 413 413 413 413 296 296 296 296 296 296 413 413 413 413 413 413 168 168 168 168 413 413 413 413 413 413 413 413 413 413 413 413 413 413 413 413 413 413 413 413 413 413 413 413 413 413 413 413 413 168 168 168 413 413 413 413 413 413 413 413 413 413 413 413 413 413 413 413 413 413 413 413 413 413 413 413 413 413 413 413 413 413 413 413 413 413 168 168 168 168 413 413 413 413 413 413 413 413 413 413 413 413 413 413 413 413 413 413 413 413 413 413 413 413 413 413 413 413 413 168 168 168 413 413 413 413 413 413 413 413 413 413 413 413 413 413 413 413 413 413 413 413 413 413 296 296 413 413 413 296 413 413 296 413 168 168 168 168 413 413 413 413 413 413 413 413 413 413 413 413 413 413 413 413 413 413 413 413 413 413 413 413 413 413 413 413 413 413 413 168 168 168 413 413 413 413 413 413 413 413 413 413 413 413 413 413 413 413 413 413 296 296 296 296 296 296 296 296 296 296 296 296 413 413 168 168 168 168 413 413 413 413 413 413 413 413 413 413 413 413 413 413 413 413 413 413 413 413 413 413 413 413 413 413 413 413 413 413 413 168 168 413 413 413 168 413 413 413 413 413 413 413 413 413 413 413 413 413 413 296 296 296 296 296 296 296 296 296 296 296 296 296 413 168 168 168 168 413 413 413 413 413 413 413 413 413 413 413 413 413 413 413 413 413 413 413 413 413 413 413 413 413 413 413 413 413 413 413 413 168 168 413 413 413 168 168 413 413 413 413 413 413 413 413 413 413 413 296 296 296 296 296 296 296 296 296 296 296 296 296 296 296 413 168 168 413 413 413 413 413 413 413 413 413 413 413 413 413 413 413 413 413 413 413 413 413 413 413 413 413 413 413 413 413 413 413 413 413 413 168 413 413 413 413 413 413 413 413 413 413 413 413 413 413 413 413 413 296 296 296 296 296 296 296 296 413 413 413 413 413 413 413 413 413 168 413 413 413 413 413 413 413 413 413 413 413 413 413 413 413 413 413 413 413 413 413 413 413 413 413 413 413 413 413 413 413 413 413 413 168 413 413 413 413 413 413 413 413 413 413 413 413 413 413 413 413 413 413 413 413 413 413 413 413 168 168 168 168 168 168 168 168 168 413 413 413 413 413 413 413 413 413 413 413 413 413 413 413 413 413 413 413 413 413 413 413 413 413 413 413 413 413 413 413 413 413 413 413 413 168 413 168 413 413 413 413 413 413 413 413 413 413 413 413 413 413 168 168 413 413 168 168 168 168 168 168 168 168 168 168 168 413 413 413 413 413 413 413 413 413 413 413 413 413 413 413 413 413 413 413 413 413 413 413 413 413 413 413 413 413 413 413 413 413 413 413 413 413 413 168 413 413 413 413 413 413 413 413 413 413 413 413 413 413 413 413 168 168 168 168 168 168 168 168 168 413 413 168 168 168 413 413 413 413 413 413 413 413 413 413 413 413 413 413 413 413 413 413 413 413 413 413 413 413 413 413 413 413 413 413 413 413 413 413 413 413 413 413 413 168 413 413 413 413 413 413 413 413 413 413 413 413 413 413 413 413 413 413 413 413 413 413 413 413 413 413 413 413 413 413 413 413 413 413 413 413 413 413 413 413 413 413 413 413 413 413 413 413 413 413 413 413 413 413 413 413 413 413 413 413 413 413 413 413 413 413 413 413 413 168 168 413 413 413 413 413 413 413 413 413 413 413 413 413 413 413 413 413 413 413 413 413 413 413 413 413 413 413 413 413 413 413 413 413 413 413 413 413 413 413 413 413 413 413 413 413 413 413 413 413 413 413 413 413 413 413 413 413 413 413 413 413 413 413 413 413 413 413 413 413 413 413 413 413 413 413 413 413 413 413 413 413 413 413 413 413 413 413 413 413 413 413 413 413 413 413 413 413 413 413 413 413 413 413 413 413 413 413 413 413 413 413 413 413 413 413 413 413 413 413 413 413 413 413 413 413 413 413 413 413 413 413 413 413 413 413 413 413 413 413 413 413 413 413 413 413 413 413 413 413 413 413 413 413 413 413 413 413 413 413 413 413 413 413 413 413 413 413 413 413 413 413 413 413 413 413 413 413 413 413 413 413 413 413 413 413 413 413 413 413 413 413 413 413 413 413 413 413 413 413 413 413 413 413 413 413 413 413 413 413 413 413 413 413 413 413 413 413 413 413 413 413 413 413 413 413 413 413 413 413 413 413 413 413 413 413 413 413 413 413 413 413 413 413 413 413 413 413 413 413 413 413 413 413 413 413 413 413 413 413 413 413 413 413 413 413 413 413 413 413 413 413 413 413 413 413 413 413 413 413 413 413 413 413 413 413 413 413 413 413 413 413 413 413 413 413 413 413 413 413 413 413 413 413 413 413 413 413 413 413 413 413 413 413 413 413 413 413 413 413 413 413 413 413 413 413 413 413 413 413 413 413 413 413 413 413 413 413 413 413 413 413 413 413 413 413 413 413 413 413 413 413 413 413 413 413 413 413 413 413 413 413 413 413 413 413 413 413 413 413 413 413 413 413 413 413 413 413 413 413 413 413 413 413 413 413 413 413 413 413 413 413 413 413 413 413 413 413 413 413 413 413 413 413 413 413 413 413 413 413 413 413 413 413 413 413 413 413 413 413 413 413 413 413 413 413 413 413 413 413 413 413 413 413 413 413 413 413 413 413 413 413 413 413 413 413 413 413 413 413 413 413 413 413 413 413 413 413 413 413 413 413 413 413 413 413 413 413 413 413 413 413 413 413 413 413 413 413 413 413 413 413 413 413 413 413 413 413 413 413 413 413 413 413 413 413 413 413 413 413 413 413 413 413 413 413 413 413 413 413 413 413 413 413 413 413 413 413 413 413 413 413 413 413 413 413 413 413 413 413 413 413 413 413 413 413 413 413 413 413 413 413 413 413 413 413 413 413 413 413 413 413 413 413 413 413 413 413 413)
  )
  (spawnpoint
    (x 36)
    (y 27)
    (name "main")
  )
  (level
    (x 7)
    (y 9)
    (name "level2.stl")
  )
  (level
    (x 13)
    (y 5)
    (name "level4.stl")
  )
  (level
    (x 17)
    (y 24)
    (name "level3.stl")
  )
  (level
    (x 27)
    (y 5)
    (name "level6.stl")
  )
  (level
    (x 32)
    (y 17)
    (sprite "images/worldmap/common/torch.sprite")
    (name "castle.stl")
  )
)
