(supertux-level
  (version 2)
  (name (_ "Forest World"))
  (author "")
  (sector
    (name "main")
    (music "music/forestmap.ogg")
    (init-script "import(\"levels/world2/default.nut\");")
    (tilemap
      (z-pos -100)
      (solid #t)
      (speed 1)
      (width 70)
      (height 50)
      (tiles 743 743 743 429 430 431 432 743 743 743 742 742 742 742 742 742 742 742 742 742 742 742 742 742 737 410 410 410 410 410 410 748 748 748 748 748 748 748 748 748 748 410 410 410 410 410 687 563 563 563 563 9 9 9 9 9 9 420 420 420 420 420 420 420 420 420 420 420 420 420 743 743 437 438 439 440 441 442 443 743 742 742 742 742 742 742 742 742 742 742 742 742 742 742 737 410 410 410 410 410 410 410 748 748 748 748 748 748 748 748 748 410 410 410 410 694 687 563 563 563 563 9 9 9 9 559 9 420 420 420 420 420 420 420 420 420 420 420 420 420 743 445 446 447 448 449 450 451 452 743 743 743 743 742 742 742 742 742 742 742 742 742 742 742 737 410 410 410 410 410 410 410 410 410 410 748 748 748 748 748 748 748 410 410 410 557 687 563 563 563 563 563 559 9 558 559 9 420 420 420 420 420 420 420 420 420 420 420 420 420 453 454 455 456 457 458 459 460 461 743 743 743 743 742 742 742 742 742 742 742 742 735 733 733 736 410 410 410 410 410 410 410 410 410 410 410 410 748 748 748 748 748 748 552 553 693 687 563 563 563 563 563 559 559 558 563 558 420 420 420 420 420 420 420 420 420 420 420 420 420 462 463 464 465 466 467 468 469 470 743 743 743 743 742 742 742 742 742 742 742 742 737 748 410 410 410 410 410 748 748 748 410 410 410 410 410 748 748 748 748 840 841 842 555 556 410 687 563 563 563 563 559 559 559 558 563 563 420 420 420 420 420 420 420 420 420 420 420 420 420 471 472 473 474 475 476 477 478 479 743 743 743 743 742 742 499 500 501 502 742 742 737 410 410 410 410 410 410 410 410 897 898 410 862 863 864 865 748 748 848 849 850 851 410 410 410 687 563 563 673 673 673 673 673 558 563 673 420 420 420 420 420 420 420 420 420 420 420 420 420 480 481 482 483 484 485 486 487 488 743 743 743 743 738 743 508 509 510 511 742 735 736 748 748 410 801 802 803 804 805 906 907 870 871 872 873 874 748 856 857 858 859 860 748 410 693 687 563 563 563 673 673 673 673 673 673 673 420 420 420 420 420 420 420 420 420 420 420 420 420 918 743 743 743 493 494 495 496 497 743 743 743 743 755 516 517 518 519 520 735 736 410 748 410 809 810 811 812 813 814 839 869 879 880 881 882 883 897 898 866 867 748 748 748 694 410 690 689 563 563 673 673 673 673 673 560 673 420 420 420 420 420 420 420 420 420 420 420 420 420 917 920 918 743 743 503 504 489 743 743 743 743 743 755 525 526 527 528 735 736 410 410 748 410 818 819 820 821 822 823 839 410 888 889 890 891 748 906 907 748 748 897 898 862 863 864 865 690 689 673 673 673 563 563 673 560 560 420 420 420 420 420 420 420 420 420 420 420 420 420 920 920 917 918 743 738 738 738 738 738 759 768 768 768 762 742 498 742 737 410 410 410 825 826 827 828 829 912 830 410 402 406 406 406 406 406 406 406 406 405 410 906 907 871 872 873 874 693 690 689 673 673 560 560 560 560 560 420 420 420 420 420 420 420 420 420 420 420 420 420 920 920 920 918 743 738 743 743 738 759 775 477 478 479 761 768 764 768 750 751 405 410 834 835 836 837 838 912 402 406 413 908 410 410 410 410 410 410 410 404 405 410 879 880 881 882 883 694 693 687 673 673 560 569 570 571 572 420 420 420 420 420 420 420 420 420 420 420 420 420 920 920 920 917 918 738 755 738 759 775 485 486 487 488 743 742 771 742 742 756 404 405 843 844 845 846 847 402 413 1500 1501 1502 1503 1504 1505 1506 1507 1508 1509 1510 1511 1512 888 889 890 891 693 685 683 686 673 576 563 578 579 580 581 420 420 420 420 420 420 420 420 420 420 420 420 420 920 920 920 916 918 738 755 759 775 493 494 495 496 497 743 743 771 735 733 736 410 404 406 406 407 406 406 413 721 1513 1514 1515 1516 1517 1518 1519 1520 1521 1522 1523 1524 1525 406 406 405 748 685 686 563 563 673 673 586 587 588 589 590 420 420 420 420 420 420 420 420 420 420 420 420 420 920 920 920 920 918 738 755 771 743 743 503 504 743 743 743 759 775 737 694 748 897 898 748 869 409 897 898 410 900 1526 1527 1528 1529 1530 1531 1532 1533 1735 1535 1536 1537 1538 898 410 409 693 687 559 563 563 563 594 595 596 597 598 599 420 420 420 420 420 420 420 420 420 420 420 420 420 920 920 920 920 918 768 768 774 767 743 743 743 759 763 763 770 743 740 741 739 906 907 748 869 409 906 907 410 899 1539 1540 1541 1542 1543 1544 1545 1546 1736 1548 1549 1550 1551 907 410 404 406 700 701 712 711 563 602 603 604 605 606 559 420 420 420 420 420 420 420 420 420 420 420 420 420 920 920 916 916 925 743 743 743 760 763 763 763 775 743 743 761 768 762 735 736 410 410 748 869 409 410 869 410 861 1552 1553 1554 1555 1556 1557 1558 1559 1737 1561 1562 1563 1564 410 897 898 748 705 706 560 715 563 611 612 613 614 615 560 420 420 420 420 420 420 420 420 420 420 420 420 420 926 926 926 926 926 743 743 759 775 743 743 743 428 429 430 431 432 761 750 751 406 406 406 406 408 410 410 869 855 1565 1566 1567 1568 1569 1570 1571 1572 1738 1574 1575 1576 1577 716 906 907 748 693 707 560 715 599 599 599 599 607 608 609 420 420 420 420 420 420 420 420 420 420 420 420 420 551 429 430 431 432 743 743 771 489 468 435 436 437 438 439 440 441 442 443 756 897 898 897 898 404 405 410 410 854 1578 1579 1580 1739 1740 1741 1742 1585 1743 1744 1588 1589 1590 677 410 748 748 748 707 563 715 563 559 599 599 616 617 9 420 420 420 420 420 420 420 420 420 420 420 420 420 437 438 439 440 441 442 443 771 433 489 444 445 446 447 448 449 450 451 452 737 906 907 906 907 410 409 410 410 853 1591 1592 1593 1745 1595 1596 1746 1598 1599 1747 1601 1602 1603 676 410 693 693 685 686 563 717 712 711 599 624 625 626 627 628 630 631 632 633 637 563 409 563 563 563 563 563 446 447 448 449 450 451 452 771 489 468 453 454 455 456 457 458 459 460 461 740 741 741 741 739 410 409 410 410 852 1604 1605 1606 1749 1750 1609 1751 1611 1612 1752 1614 1615 1616 675 897 898 557 687 563 673 560 563 715 599 563 634 635 560 638 639 640 641 642 563 563 409 563 563 563 563 563 455 456 457 458 459 460 461 771 743 743 462 463 464 465 466 467 468 469 470 743 743 742 498 737 410 409 897 898 933 1617 1618 1619 1620 1753 1622 1754 1624 1625 1756 1627 1628 1629 667 906 907 694 687 563 563 563 563 717 712 711 673 673 601 647 648 649 650 651 563 563 409 563 563 563 563 563 464 465 466 427 427 743 743 761 763 767 471 472 473 474 475 742 742 759 767 743 759 763 763 750 751 408 906 907 832 1630 1631 1632 1633 1757 1635 1758 1759 1760 1761 1640 1641 1642 666 410 748 694 707 563 563 673 673 673 559 715 563 673 560 656 657 658 659 563 563 560 409 563 563 563 563 563 473 474 475 427 427 743 743 743 743 771 480 481 482 483 484 759 768 775 761 763 775 744 744 426 756 404 405 410 831 1643 1644 1645 1646 1763 1648 1649 1650 1651 1652 1653 1654 1655 665 410 685 683 686 561 622 673 564 601 601 715 563 563 563 563 601 601 560 560 560 560 409 643 563 563 563 563 482 483 484 505 427 743 743 743 743 760 763 763 763 763 768 775 742 742 742 743 744 489 735 733 736 410 409 410 824 1656 1657 1658 1659 1765 1661 1662 1663 1664 1665 1666 1667 1668 629 410 687 576 569 570 571 572 573 574 576 717 711 601 402 406 406 406 406 406 406 406 413 420 420 420 420 563 743 512 513 514 515 743 743 743 743 771 755 499 500 501 502 742 742 505 506 743 744 744 737 557 410 410 409 557 816 1669 1670 1671 1672 1766 1767 1768 1769 1677 1678 1679 1680 1681 620 410 707 559 578 579 580 581 582 583 601 601 715 601 409 601 601 630 631 632 633 563 563 643 563 563 563 563 743 521 522 523 524 743 743 743 743 771 507 508 509 510 511 512 513 514 515 743 744 735 736 410 410 410 763 405 815 1682 1683 1684 1685 1686 1687 1688 1770 1690 1691 1692 1693 1694 726 685 686 586 587 588 589 590 591 592 710 712 718 712 412 711 638 639 640 641 642 643 563 563 563 563 563 563 529 530 531 532 533 743 743 743 743 771 516 517 518 519 520 521 522 523 524 735 733 736 869 862 863 864 865 409 800 1695 1696 1697 1698 1699 1700 1701 1771 1703 1704 1705 1706 1707 725 687 594 595 596 597 598 599 710 712 719 630 631 632 633 715 647 648 649 650 651 563 563 563 563 563 563 563 538 539 540 541 743 743 743 743 743 771 525 526 527 528 529 530 531 532 533 737 410 410 870 871 872 873 874 409 808 1708 1709 1710 1711 1712 1713 1714 1772 1717 1718 1719 1720 1721 724 687 602 603 604 605 606 708 719 623 638 639 640 641 642 715 656 657 658 659 652 563 563 563 563 563 563 563 547 548 549 550 743 743 743 743 743 761 768 762 536 537 538 539 540 541 743 740 739 410 879 880 881 882 883 409 807 1722 1723 1724 1725 1726 1727 1728 1773 1730 1731 1732 1733 1734 621 687 611 612 613 614 615 715 643 643 647 648 649 650 651 715 673 601 601 601 652 563 563 563 563 563 563 563 743 743 743 743 743 489 490 743 743 743 743 761 762 545 547 548 549 550 743 743 737 410 888 889 890 891 869 409 789 790 791 792 793 794 795 410 409 410 796 797 798 799 806 698 689 563 563 708 712 719 643 623 656 657 658 659 623 715 673 601 601 563 563 563 563 563 563 563 563 563 743 743 743 743 743 743 743 743 743 743 743 743 761 763 763 763 763 763 763 763 750 751 406 406 406 406 406 412 405 410 410 410 410 402 406 406 412 407 406 406 406 406 406 406 700 701 712 714 576 607 608 609 610 599 563 622 710 719 559 563 563 563 563 563 563 563 563 563 563 563 743 743 743 743 743 743 743 743 743 743 429 430 431 432 743 743 743 743 743 743 743 756 420 557 748 410 410 410 404 406 405 897 898 409 410 748 410 409 410 410 840 841 842 694 705 706 559 715 563 616 617 618 619 708 712 712 719 563 610 563 563 563 563 563 563 563 563 563 563 563 919 919 919 743 743 743 743 743 743 437 438 439 440 441 442 443 426 743 743 743 743 757 420 862 863 864 865 748 410 410 409 906 907 409 410 410 410 409 410 848 849 850 851 410 748 687 563 715 624 625 626 627 628 715 563 563 559 559 610 563 563 563 563 563 563 563 563 563 563 563 920 920 920 917 743 743 743 743 445 446 447 448 449 450 451 452 426 743 735 733 733 736 870 871 872 873 874 748 410 410 404 407 406 413 876 877 878 409 856 857 858 859 860 410 693 687 563 715 681 634 635 708 712 719 563 576 567 559 569 570 571 572 573 574 563 563 563 563 563 563 920 920 920 920 917 743 743 453 454 455 456 457 458 459 460 461 426 743 740 739 693 410 879 880 881 882 883 410 410 552 553 409 410 884 885 886 887 409 410 866 867 912 913 685 683 686 563 717 712 712 712 719 600 563 610 610 610 610 578 579 580 581 582 583 563 563 563 563 563 563 920 920 920 920 920 743 743 462 463 464 465 466 467 743 743 743 426 743 743 737 410 410 888 889 890 891 410 410 410 555 556 409 892 893 894 895 896 409 897 898 410 410 410 687 563 559 576 563 559 559 563 660 645 646 563 610 610 586 587 588 589 590 591 592 563 563 563 563 563 563 920 920 920 920 920 917 743 471 472 473 474 475 743 743 743 743 743 743 743 737 748 410 410 410 410 897 898 410 748 897 898 409 901 902 903 904 402 413 906 907 410 410 410 690 691 691 691 689 563 563 652 653 654 655 563 559 594 595 596 597 598 599 563 563 563 563 563 563 563 563 920 920 920 920 920 920 743 480 481 482 483 484 743 743 743 743 743 743 743 737 748 410 410 410 410 906 907 410 410 906 907 409 909 910 911 410 409 410 410 410 410 410 410 410 694 410 693 687 563 660 661 662 663 664 563 559 602 603 604 605 606 563 563 563 563 563 563 563 563 563 920 920 920 920 920 920 917 743 743 743 743 743 743 743 743 743 743 743 743 737 748 410 410 410 410 410 410 410 410 410 410 404 406 406 407 406 413 898 552 553 410 410 410 410 410 693 748 687 668 669 670 671 672 563 563 559 611 612 613 614 615 563 563 563 563 563 563 563 563 563 920 920 920 920 920 920 920 919 919 919 919 743 743 743 743 743 743 743 743 737 748 748 748 748 748 410 410 410 410 410 410 410 410 912 409 410 906 907 555 556 748 410 410 410 410 748 748 687 563 678 679 680 681 563 563 559 559 563 563 563 563 563 563 563 563 563 563 563 563 563 920 920 920 920 920 920 920 920 920 920 920 917 919 919 919 919 919 743 743 737 694 410 410 410 748 748 410 410 410 410 410 410 410 410 409 410 410 410 410 410 410 410 410 410 748 748 748 690 689 563 560 560 560 563 563 563 563 563 563 563 563 563 563 755 755 755 755 563 563 563 920 920 920 920 920 920 920 920 920 920 920 920 920 920 920 920 920 917 919 920 414 414 414 414 410 410 410 410 410 410 402 406 406 406 413 410 410 410 410 410 410 410 410 410 552 553 748 748 707 755 755 563 560 560 563 563 755 755 755 755 755 755 755 755 755 755 755 563 563 920 920 920 920 920 920 920 920 920 920 920 920 920 920 920 920 920 920 920 920 920 920 920 920 920 414 414 414 414 414 414 409 414 414 414 414 410 410 410 410 410 410 410 410 410 555 556 414 414 687 755 755 755 755 755 755 755 755 755 755 919 919 919 919 918 755 755 755 563 563 920 920 920 920 920 920 920 920 920 920 920 920 920 920 920 920 920 920 920 920 920 920 920 920 920 920 920 920 920 920 920 411 920 920 920 920 410 410 410 410 410 410 410 414 414 920 920 920 920 920 917 919 919 919 919 919 919 919 919 920 920 920 920 920 917 919 919 919 563 920 920 920 920 920 920 920 920 920 920 920 920 920 920 920 920 920 920 920 920 920 920 920 920 920 920 920 920 920 920 920 920 920 920 920 920 920 912 912 912 410 414 414 414 920 920 920 920 920 920 920 920 920 920 920 920 920 920 920 920 920 920 920 920 920 920 920 920 920 920 920 920 920 920 920 920 920 920 920 920 920 920 920 920 920 920 920 920 920 920 920 920 920 920 920 920 920 920 920 920 920 920 920 920 920 920 920 912 912 414 414 920 920 920 920 920 920 920 920 920 920 920 920 920 920 920 920 920 920 920 920 920 920 920 920 920 920 920 920 920 920 920 920 920 920 920 920 920 920 920 920 920 920 920 920 920 920 920 920 920 920 920 920 920 920 920 920 920 920 920 920 920 920 920 920 920 920 414 414 920 920 920 920 920 920 920 920 920 920 920 920 920 920 920 920 920 920 920 920 920 920 920 920 920 920 920 920 920 920 920 920 920 920 920 920 920 920 920 920 920 920 920 920 920 920 920 920 920 920 920 920 920 920 920 920 920 920 920 920 920 920 920 920 920 920 920 920 920 920 920 920 920 920 920 920 920 920 920 920 920 920 920 920 920 920 920 920 920 920 920 920 920 920 920 920 920 920 920 920 920 920 920 920 920 920 920 920 920 920 920 920 920 920 920 920 920 920 920 920 920 920 920 920 920 920 920 920 920 920 920 920 920 920 920 920 920 920 920 920 920 920 920 920 920 920 920 920 920 920 920 920 920 920 920 920 920 920 920 920 920 920 920 920 920 920 920 920 920 920 920 920 920 920 920 920 920 920 920 920 920 920 920 920 920 920 920 920 920 920 920 920 920 920 920 920 920 920 920 920 920 920 920 920 920 920 920 920 920 920 920 920 920 920 920 920 920 920 920 920 920 920 920 920 920 920 920 920 920 920 920 920 920 920 920 920 920 920 920 920 920 920 920)
    )
    (worldmap-spawnpoint
      (name "main")
      (x 31)
      (y 41)
    )
    (level
      (name "castledoor.stl")
      (x 32)
      (y 17)
      (sprite "images/worldmap/common/torch1.sprite")
    )
    (level
      (name "castledoor.stl")
      (x 33)
      (y 24)
      (sprite "images/worldmap/common/n_stone.sprite")
    )
    (level
      (name "castledoor.stl")
      (x 37)
      (y 21)
      (sprite "images/worldmap/common/torch.sprite")
    )
    (level
      (name "castledoor.stl")
      (x 38)
      (y 17)
      (sprite "images/worldmap/common/torch1.sprite")
    )
    (level
      (name "castledoor.stl")
      (x 37)
      (y 13)
      (sprite "images/worldmap/common/torch.sprite")
    )
    (level
      (name "level2.stl")
      (x 53)
      (y 25)
      (sprite "images/worldmap/common/shroom.sprite")
    )
    (level
      (name "christoph1.stl")
      (x 7)
      (y 18)
      (sprite "images/worldmap/common/shroom.sprite")
    )
    (level
      (name "christoph2.stl")
      (x 16)
      (y 15)
      (sprite "images/worldmap/common/shroom.sprite")
    )
    (level
      (name "key4.stl")
      (x 40)
      (y 30)
      (sprite "images/worldmap/common/shroom.sprite")
    )
    (level
      (name "key3.stl")
      (x 39)
      (y 30)
      (sprite "images/worldmap/common/shroom.sprite")
    )
    (level
      (name "key2.stl")
      (x 38)
      (y 30)
      (sprite "images/worldmap/common/shroom.sprite")
    )
    (level
      (name "key1.stl")
      (x 37)
      (y 30)
      (sprite "images/worldmap/common/shroom.sprite")
    )
    (level
      (name "key5.stl")
      (x 41)
      (y 30)
      (sprite "images/worldmap/common/shroom.sprite")
    )
  )
  (tileset "images/worldmap.strf")
)
