; Generated by Flexlay Editor
(supertux-worldmap
  (properties
    (name (_ "Forest World"))
    (music "salcon.ogg")
  )
  (spawnpoint
    (name "main")
    (x 2)
    (y 15)
  )
  (tilemap
    (width 70)
    (height 50)
    (layer "interactive")
    (solid #t)
    (speed 1.000000)
    (tiles
73 73 73 73 73 73 73 73 73 73 73 73 73 73 73 73 73 73 73 73 73 73 73 73 73 73 73 73 73 73 73 73 73 73 73 73 73 73 73 73 73 73 73 73 73 73 73 73 73 73 73 73 73 73 73 73 73 73 73 73 73 73 73 73 73 73 73 73 73 73 
73 73 73 73 73 73 73 73 73 73 73 73 73 73 73 73 73 73 73 73 73 73 73 73 73 73 73 73 73 73 73 73 73 73 73 73 73 73 73 73 73 73 73 73 73 73 73 73 73 73 73 73 73 73 73 73 73 73 73 73 73 73 73 73 73 73 73 73 73 73 
73 73 73 73 73 73 73 73 73 73 73 73 73 73 73 73 73 73 73 73 73 73 73 73 73 73 73 73 73 73 73 73 73 73 73 73 73 73 73 73 73 73 73 73 73 73 73 73 73 73 73 73 73 73 73 73 73 73 73 73 73 73 73 73 73 73 73 73 73 73 
73 73 73 73 73 73 74 74 74 74 74 74 74 74 73 74 74 74 74 74 74 74 74 74 74 74 74 74 74 74 74 74 74 74 74 74 74 74 74 74 74 74 74 74 74 73 73 73 73 73 73 73 73 73 73 73 73 73 73 73 73 73 73 73 73 73 73 73 73 73  
73 73 73 73 73 74 74 74 74 74 74 74 74 74 73 74 74 74 74 74 74 74 74 74 74 74 74 74 74 74 74 74 74 74 74 74 74 74 74 74 74 74 74 74 74 73 73 73 73 73 73 73 73 73 73 73 73 73 73 73 73 73 73 73 73 73 73 73 73 73  
73 73 73 73 73 74 74 74 74 74 75 75 75 75 75 75 75 75 75 75 75 75 75 75 75 75 75 75 75 75 75 75 75 75 74 74 74 74 74 74 74 74 77 74 74 73 73 73 73 73 73 73 73 73 73 73 73 73 73 73 73 73 73 73 73 73 73 73 73 73  
73 73 73 73 74 74 74 74 74 74 75 74 74 74 73 74 74 74 74 74 75 74 74 74 74 74 74 74 74 74 74 74 74 75 74 74 74 74 74 74 74 74 74 74 74 74 73 73 73 73 73 73 73 73 73 73 73 73 73 73 73 73 73 73 73 73 73 73 73 73  
73 73 73 73 74 75 75 75 75 75 75 74 74 74 73 74 74 74 74 74 75 74 74 74 74 74 74 74 74 74 74 74 74 75 74 74 74 74 74 74 77 77 77 74 74 74 73 73 73 73 73 73 73 73 73 73 73 73 73 73 73 73 73 73 73 73 73 73 73 73  
73 73 73 73 74 75 74 74 74 74 74 74 74 74 73 73 74 74 74 74 75 74 74 74 74 74 77 74 74 74 74 74 74 75 74 77 77 77 77 77 77 77 77 74 74 73 73 73 73 73 73 73 73 73 73 73 73 73 73 73 73 73 73 73 73 73 73 73 73 73  
73 73 73 73 74 75 74 74 74 74 74 74 74 74 74 73 74 74 74 74 75 74 74 74 74 74 77 77 74 74 74 74 77 75 76 76 76 76 76 76 76 76 77 74 74 73 73 73 73 73 73 73 73 73 73 73 73 73 73 73 73 73 73 73 73 73 73 73 73 73  
73 73 73 73 74 75 74 74 74 74 74 74 74 74 74 73 74 74 74 74 75 74 74 74 77 74 77 77 74 74 74 74 77 77 77 77 77 77 77 77 77 76 77 74 74 73 73 73 73 73 73 73 73 73 73 73 73 73 73 73 73 73 73 73 73 73 73 73 73 73  
73 73 73 73 74 75 74 74 74 74 74 74 74 74 74 73 74 74 74 74 75 74 74 77 77 77 77 77 77 77 74 74 77 77 77 77 77 77 77 77 77 76 77 74 74 73 73 73 73 73 73 73 73 73 73 73 73 73 73 73 73 73 73 73 73 73 73 73 73 73  
73 73 73 73 74 75 74 74 74 74 74 74 74 74 73 73 74 74 74 74 75 74 74 77 77 77 77 77 77 77 74 77 77 77 77 77 77 77 77 77 77 76 77 77 74 73 73 73 73 73 73 73 73 73 73 73 73 73 73 73 73 73 73 73 73 73 73 73 73 73  
73 73 73 73 74 75 74 74 74 74 74 74 74 74 73 74 74 74 74 74 75 74 74 77 77 77 77 77 77 77 77 77 77 77 77 77 77 77 77 77 77 76 77 77 74 74 73 73 73 73 73 73 73 73 73 73 73 73 73 73 73 73 73 73 73 73 73 73 73 73  
73 73 73 73 74 75 75 75 75 75 75 75 75 75 75 75 75 75 75 75 75 74 77 77 77 77 77 77 77 77 77 77 77 77 77 77 77 77 77 77 77 76 77 74 74 74 74 73 73 73 73 73 73 73 73 73 73 73 73 73 73 73 73 73 73 73 73 73 73 73  
73 73 75 75 75 75 74 74 74 74 74 74 74 74 73 74 74 74 74 77 76 77 77 77 77 77 77 77 77 77 77 77 77 77 77 77 77 77 77 77 77 76 77 77 74 74 74 73 73 73 73 73 73 73 73 73 73 73 73 73 73 73 73 73 73 73 73 73 73 73  
73 73 74 74 74 75 74 74 74 74 74 74 74 74 73 74 74 74 77 77 76 77 77 77 77 77 77 77 77 77 77 77 77 77 77 77 77 77 77 77 77 76 77 74 74 74 74 73 73 73 73 73 73 73 73 73 73 73 73 73 73 73 73 73 73 73 73 73 73 73  
73 73 74 74 74 75 74 74 74 74 74 74 74 73 73 74 74 77 77 77 76 76 76 76 76 76 76 76 77 77 77 77 77 77 77 77 77 77 77 77 77 76 77 74 74 74 74 73 73 73 73 73 73 73 73 73 73 73 73 73 73 73 73 73 73 73 73 73 73 73  
73 73 74 74 74 75 74 74 74 74 74 74 74 73 74 74 74 77 77 77 76 77 77 77 77 77 77 76 77 77 77 77 77 77 77 77 76 77 77 77 77 76 77 74 74 74 74 73 73 73 73 73 73 73 73 73 73 73 73 73 73 73 73 73 73 73 73 73 73 73  
73 73 74 74 74 75 74 74 74 74 74 74 74 73 74 74 74 77 77 77 76 77 77 77 77 77 77 76 77 77 77 77 77 77 77 77 76 77 77 76 76 76 77 77 74 74 74 73 73 73 73 73 73 73 73 73 73 73 73 73 73 73 73 73 73 73 73 73 73 73  
73 73 74 74 74 75 74 74 74 74 74 74 74 73 74 74 74 74 77 77 76 77 77 77 77 77 77 76 77 77 77 77 77 77 77 77 76 76 76 76 77 76 77 77 74 74 74 73 73 73 73 73 73 73 73 73 73 73 73 73 73 73 73 73 73 73 73 73 73 73  
73 73 74 74 74 75 74 74 74 74 74 74 74 73 74 74 74 74 77 77 76 77 77 77 77 77 77 76 77 77 77 77 77 77 77 77 77 77 77 77 77 76 77 74 74 74 74 73 73 73 73 73 73 73 73 73 73 73 73 73 73 73 73 73 73 73 73 73 73 73  
73 73 74 74 74 75 74 74 74 74 74 74 74 73 74 74 74 74 74 77 76 77 77 77 77 77 77 76 77 77 77 77 77 77 77 77 77 77 77 77 77 76 77 74 74 74 74 73 73 73 73 73 73 73 73 73 73 73 73 73 73 73 73 73 73 73 73 73 73 73  
73 73 74 74 74 75 74 74 74 74 74 74 74 73 74 74 74 74 74 74 75 74 77 77 77 77 77 76 77 77 77 77 77 77 77 77 77 77 77 77 77 76 77 74 74 74 74 73 73 73 73 73 73 73 73 73 73 73 73 73 73 73 73 73 73 73 73 73 73 73  
73 73 74 74 74 75 75 75 75 75 75 75 75 75 75 75 74 74 74 74 75 74 74 77 77 77 77 76 76 76 76 76 76 76 76 76 76 76 76 76 76 76 77 74 74 74 74 73 73 73 73 73 73 73 73 73 73 73 73 73 73 73 73 73 73 73 73 73 73 73  
73 73 74 74 74 75 74 74 74 74 74 74 74 73 74 74 74 74 74 74 75 74 74 77 77 77 77 77 77 77 77 77 77 77 77 77 77 77 77 77 77 77 77 74 74 74 74 73 73 73 73 73 73 73 73 73 73 73 73 73 73 73 73 73 73 73 73 73 73 73  
73 73 74 74 74 75 74 74 74 74 74 74 74 73 73 74 74 74 74 74 75 74 74 77 77 77 77 77 77 77 77 77 74 74 75 74 77 77 77 77 77 77 77 74 74 74 74 73 73 73 73 73 73 73 73 73 73 73 73 73 73 73 73 73 73 73 73 73 73 73  
73 73 74 74 74 75 74 74 74 74 74 74 74 74 73 74 74 74 74 74 75 74 74 77 77 77 77 77 74 74 74 74 74 74 75 74 74 77 77 77 77 77 77 74 74 74 74 74 73 73 73 73 73 73 73 73 73 73 73 73 73 73 73 73 73 73 73 73 73 73 
73 73 74 74 74 75 74 74 74 74 74 74 74 74 73 73 74 74 74 74 75 74 74 74 77 74 77 74 74 74 74 74 74 74 75 74 74 77 77 77 77 77 74 74 74 74 74 73 73 73 73 73 73 73 73 73 73 73 73 73 73 73 73 73 73 73 73 73 73 73 
73 73 74 74 74 75 74 74 74 74 74 74 74 74 74 73 74 74 74 74 75 74 74 74 74 74 74 74 74 74 74 74 74 74 75 74 74 74 74 77 77 74 74 74 74 74 74 73 73 73 73 73 73 73 73 73 73 73 73 73 73 73 73 73 73 73 73 73 73 73  
73 73 74 74 74 75 75 75 75 75 75 75 75 75 75 75 75 75 75 75 75 75 75 75 75 75 75 75 75 75 75 75 75 75 75 74 74 74 74 74 77 74 74 74 74 74 73 73 73 73 73 73 73 73 73 73 73 73 73 73 73 73 73 73 73 73 73 73 73 73  
73 73 74 74 74 74 74 74 74 74 74 74 74 74 74 73 74 74 74 74 74 74 74 74 74 74 74 74 74 74 74 74 74 74 74 74 74 74 74 74 74 74 74 74 73 73 73 73 73 73 73 73 73 73 73 73 73 73 73 73 73 73 73 73 73 73 73 73 73 73  
73 73 74 74 74 74 74 74 74 74 74 74 74 74 74 73 74 74 74 74 74 74 74 74 74 74 74 74 74 74 74 74 74 74 74 74 74 74 74 74 74 74 73 73 73 73 73 73 73 73 73 73 73 73 73 73 73 73 73 73 73 73 73 73 73 73 73 73 73 73 
73 73 74 74 74 74 74 74 74 74 74 74 74 74 74 73 74 74 74 74 74 74 74 74 74 74 74 74 74 74 74 74 74 74 74 74 74 74 73 73 73 73 73 73 73 73 73 73 73 73 73 73 73 73 73 73 73 73 73 73 73 73 73 73 73 73 73 73 73 73  
73 73 73 73 73 73 73 73 73 73 73 73 73 73 73 73 73 73 73 73 73 73 73 73 73 73 73 73 73 73 73 73 73 73 73 73 73 73 73 73 73 73 73 73 73 73 73 73 73 73 73 73 73 73 73 73 73 73 73 73 73 73 73 73 73 73 73 73 73 73  
73 73 73 73 73 73 73 73 73 73 73 73 73 73 73 73 73 73 73 73 73 73 73 73 73 73 73 73 73 73 73 73 73 73 73 73 73 73 73 73 73 73 73 73 73 73 73 73 73 73 73 73 73 73 73 73 73 73 73 73 73 73 73 73 73 73 73 73 73 73  
73 73 73 73 73 73 73 73 73 73 73 73 73 73 73 73 73 73 73 73 73 73 73 73 73 73 73 73 73 73 73 73 73 73 73 73 73 73 73 73 73 73 73 73 73 73 73 73 73 73 73 73 73 73 73 73 73 73 73 73 73 73 73 73 73 73 73 73 73 73  
73 73 73 73 73 73 73 73 73 73 73 73 73 73 73 73 73 73 73 73 73 73 73 73 73 73 73 73 73 73 73 73 73 73 73 73 73 73 73 73 73 73 73 73 73 73 73 73 73 73 73 73 73 73 73 73 73 73 73 73 73 73 73 73 73 73 73 73 73 73  
73 73 73 73 73 73 73 73 73 73 73 73 73 73 73 73 73 73 73 73 73 73 73 73 73 73 73 73 73 73 73 73 73 73 73 73 73 73 73 73 73 73 73 73 73 73 73 73 73 73 73 73 73 73 73 73 73 73 73 73 73 73 73 73 73 73 73 73 73 73  
73 73 73 73 73 73 73 73 73 73 73 73 73 73 73 73 73 73 73 73 73 73 73 73 73 73 73 73 73 73 73 73 73 73 73 73 73 73 73 73 73 73 73 73 73 73 73 73 73 73 73 73 73 73 73 73 73 73 73 73 73 73 73 73 73 73 73 73 73 73  
73 73 73 73 73 73 73 73 73 73 73 73 73 73 73 73 73 73 73 73 73 73 73 73 73 73 73 73 73 73 73 73 73 73 73 73 73 73 73 73 73 73 73 73 73 73 73 73 73 73 73 73 73 73 73 73 73 73 73 73 73 73 73 73 73 73 73 73 73 73  
73 73 73 73 73 73 73 73 73 73 73 73 73 73 73 73 73 73 73 73 73 73 73 73 73 73 73 73 73 73 73 73 73 73 73 73 73 73 73 73 73 73 73 73 73 73 73 73 73 73 73 73 73 73 73 73 73 73 73 73 73 73 73 73 73 73 73 73 73 73  
73 73 73 73 73 73 73 73 73 73 73 73 73 73 73 73 73 73 73 73 73 73 73 73 73 73 73 73 73 73 73 73 73 73 73 73 73 73 73 73 73 73 73 73 73 73 73 73 73 73 73 73 73 73 73 73 73 73 73 73 73 73 73 73 73 73 73 73 73 73 
73 73 73 73 73 73 73 73 73 73 73 73 73 73 73 73 73 73 73 73 73 73 73 73 73 73 73 73 73 73 73 73 73 73 73 73 73 73 73 73 73 73 73 73 73 73 73 73 73 73 73 73 73 73 73 73 73 73 73 73 73 73 73 73 73 73 73 73 73 73  
73 73 73 73 73 73 73 73 73 73 73 73 73 73 73 73 73 73 73 73 73 73 73 73 73 73 73 73 73 73 73 73 73 73 73 73 73 73 73 73 73 73 73 73 73 73 73 73 73 73 73 73 73 73 73 73 73 73 73 73 73 73 73 73 73 73 73 73 73 73 
73 73 73 73 73 73 73 73 73 73 73 73 73 73 73 73 73 73 73 73 73 73 73 73 73 73 73 73 73 73 73 73 73 73 73 73 73 73 73 73 73 73 73 73 73 73 73 73 73 73 73 73 73 73 73 73 73 73 73 73 73 73 73 73 73 73 73 73 73 73  
73 73 73 73 73 73 73 73 73 73 73 73 73 73 73 73 73 73 73 73 73 73 73 73 73 73 73 73 73 73 73 73 73 73 73 73 73 73 73 73 73 73 73 73 73 73 73 73 73 73 73 73 73 73 73 73 73 73 73 73 73 73 73 73 73 73 73 73 73 73  
73 73 73 73 73 73 73 73 73 73 73 73 73 73 73 73 73 73 73 73 73 73 73 73 73 73 73 73 73 73 73 73 73 73 73 73 73 73 73 73 73 73 73 73 73 73 73 73 73 73 73 73 73 73 73 73 73 73 73 73 73 73 73 73 73 73 73 73 73 73  
73 73 73 73 73 73 73 73 73 73 73 73 73 73 73 73 73 73 73 73 73 73 73 73 73 73 73 73 73 73 73 73 73 73 73 73 73 73 73 73 73 73 73 73 73 73 73 73 73 73 73 73 73 73 73 73 73 73 73 73 73 73 73 73 73 73 73 73 73 73  
73 73 73 73 73 73 73 73 73 73 73 73 73 73 73 73 73 73 73 73 73 73 73 73 73 73 73 73 73 73 73 73 73 73 73 73 73 73 73 73 73 73 73 73 73 73 73 73 73 73 73 73 73 73 73 73 73 73 73 73 73 73 73 73 73 73 73 73 73 73 

)
  )
  (level
    (x 6)
    (y 14)
    (name "level1.stl")
  )

)
