(supertux-level
  (version 2)
  (name (_ "Forest World"))
  (author "")
  (sector
    (name "main")
    (music "music/forestmap.ogg")
    (init-script "import(\"levels/world2/default.nut\");")
    (tilemap
      (z-pos -100)
      (solid #t)
      (speed 1)
      (width 70)
      (height 50)
      (tiles 743 743 743 1803 1804 1805 1806 1807 1808 743 742 742 1816 1817 1842 742 742 742 742 742 742 742 742 742 742 735 736 748 410 410 410 410 410 410 410 410 410 410 410 748 748 748 840 841 842 410 687 743 743 743 743 743 743 743 743 743 743 743 743 743 1834 1835 1842 743 743 743 743 743 743 743 743 1842 1842 1812 1813 1814 1815 1816 1817 743 742 742 1825 1826 1842 742 742 742 742 742 742 742 742 742 742 737 748 410 410 410 748 410 410 410 410 410 410 410 410 748 748 848 849 850 851 410 687 743 743 743 743 743 743 743 743 743 743 743 743 743 1843 1844 1842 743 743 743 743 743 743 743 743 1842 1820 1821 1822 1823 1824 1825 1826 743 743 743 1834 1835 1842 742 742 742 742 742 742 742 742 742 742 737 410 862 863 864 865 410 410 410 410 410 410 410 410 748 856 857 858 859 860 410 687 743 743 743 559 560 561 562 563 564 738 738 738 743 743 743 743 743 743 743 743 1807 1808 743 1827 1828 1829 1830 1831 1832 1833 1834 1835 743 743 743 1843 1844 1842 742 742 742 742 742 766 735 733 733 691 736 748 871 872 873 874 410 410 410 410 410 410 410 410 897 898 866 867 748 748 410 687 743 743 743 738 569 570 571 572 573 738 738 738 743 743 743 743 743 743 743 743 1816 1817 1842 1836 1837 1838 1839 1840 1842 1842 1843 1844 743 743 743 743 742 742 742 742 742 742 742 771 737 748 410 410 410 879 880 881 882 883 410 410 410 410 410 410 748 748 748 840 841 842 555 556 410 687 743 743 743 738 738 579 580 581 582 738 738 738 743 743 743 743 743 743 743 743 1825 1826 1842 1845 1846 1847 1848 1849 1850 1851 1852 1853 743 743 743 743 742 742 1873 1874 1875 1876 742 742 737 410 410 410 869 888 889 890 891 748 898 410 862 863 864 865 748 748 848 849 850 851 410 410 410 687 743 743 743 586 587 588 589 590 591 592 738 738 743 743 743 743 743 743 743 743 1834 1835 1842 1854 1855 1856 1857 1858 1859 1860 1861 1862 743 743 743 743 738 1881 1882 1883 1884 1885 742 735 736 748 748 410 801 802 803 804 805 906 907 870 871 872 873 874 748 856 857 858 859 860 748 410 693 687 743 743 743 738 738 738 598 599 600 601 602 766 743 743 1803 1804 1805 1806 743 743 1843 1844 1842 606 743 743 743 1867 1868 1869 1870 1842 743 743 743 743 766 1890 1891 1893 1894 1895 735 736 410 748 410 809 810 811 812 813 814 839 410 879 880 881 882 883 897 898 866 867 748 748 748 554 410 690 689 743 743 743 743 743 607 608 609 610 611 771 743 1811 1812 1813 1814 1815 743 743 743 743 743 648 594 606 743 743 1877 1878 1863 743 743 743 743 743 771 1900 1901 1902 1903 735 736 410 410 748 410 818 819 820 821 822 823 839 410 888 889 890 891 748 906 907 748 748 897 898 862 863 864 865 690 689 743 743 743 743 616 617 618 619 620 743 1819 1820 1821 1822 1823 1824 743 743 743 743 743 63 63 648 606 743 738 738 738 738 738 758 762 762 762 761 742 1872 742 737 410 410 410 825 826 827 828 829 402 406 406 406 406 406 406 406 406 406 406 406 406 405 906 907 871 872 873 874 693 690 689 743 743 743 743 743 743 743 743 1827 1828 1829 1830 1831 1832 1833 743 743 743 743 743 63 63 63 641 743 738 743 743 738 758 769 1851 1852 1853 760 762 763 762 750 751 405 410 834 835 836 837 838 409 416 416 416 908 410 410 410 410 410 410 410 416 409 410 879 880 881 882 883 554 693 687 743 743 743 743 743 743 743 743 1836 1837 1838 1839 1840 1842 743 743 743 743 743 743 63 63 63 631 606 738 742 742 758 769 1859 1860 1861 1862 743 742 765 742 742 756 404 405 843 844 845 846 847 409 416 1500 1501 1502 1503 1504 1505 1506 1507 1508 1509 1510 409 1512 888 889 890 891 693 685 683 686 743 743 743 743 743 743 743 743 1845 1846 1847 1848 1849 743 743 1807 1808 743 560 561 63 63 63 63 649 738 742 758 769 1867 1868 1869 1870 1871 743 743 765 735 733 736 410 404 406 406 407 406 406 413 721 1513 1514 1515 1516 1517 1518 1519 1520 1521 1522 1523 409 1525 410 410 410 748 685 686 743 743 743 743 743 743 743 743 743 743 1854 1855 1856 1857 1858 743 743 1816 1817 1842 569 570 63 63 63 603 605 738 742 765 743 743 1877 1878 743 743 743 758 769 737 554 748 897 898 565 566 409 897 898 410 900 1526 1527 1528 1529 1530 1531 1532 1533 1735 1535 1536 404 406 407 406 405 693 687 743 743 743 766 743 743 743 559 560 561 562 563 564 738 738 738 743 743 1825 1826 1842 738 579 63 63 63 603 605 742 766 760 761 743 743 743 758 762 762 764 743 740 741 739 906 907 574 575 409 906 907 410 899 1539 1540 1541 1542 1543 1544 1545 1546 1736 1548 1549 1550 1551 404 405 404 406 700 701 762 761 771 743 743 743 738 569 570 571 572 573 738 738 738 743 743 1834 1835 1842 587 588 63 625 625 63 649 743 771 743 760 762 763 762 769 743 742 760 762 761 735 736 410 410 583 584 409 410 410 410 861 1552 1553 1554 1555 1556 1557 1558 1559 1737 1561 1562 1563 1564 410 409 554 748 705 706 743 765 743 743 743 743 738 738 579 580 581 582 738 738 738 743 743 1843 1844 1842 738 738 655 596 596 655 633 743 743 758 762 762 769 743 1842 1803 1804 1805 1842 760 750 751 406 406 406 406 408 410 565 566 855 1565 1566 1567 1568 1569 1570 1571 1572 1738 1574 1575 1576 1577 716 409 869 748 693 707 743 765 743 743 743 743 586 587 588 589 590 591 592 738 738 743 743 743 743 743 743 743 1842 1803 1804 1805 1806 1807 1808 765 1863 1842 1809 1842 1811 1812 1813 1814 1815 1807 1808 756 897 898 897 898 404 405 574 575 854 1578 1579 1580 1739 1740 1741 1742 1585 1743 1744 1588 1589 1590 629 409 748 748 748 707 743 765 743 743 743 743 738 738 738 598 599 600 601 602 738 743 743 743 743 743 743 743 1811 1812 1813 1814 1815 1816 1817 765 1842 1863 1818 1800 1820 1821 1822 1823 1824 1816 1817 737 906 907 906 907 410 409 583 584 853 1591 1592 1593 1745 1595 1596 1746 1598 1599 1747 1601 1602 1603 630 404 406 405 685 686 743 765 734 743 743 766 743 743 743 607 608 609 766 743 743 1803 1804 1805 1806 743 1807 1808 1820 1821 1822 1823 1824 1825 1826 765 1863 1842 1827 1828 1829 1830 1831 1832 1833 1825 1826 740 741 741 741 739 410 409 410 410 852 1604 1605 1606 1749 1750 1609 1751 1611 1612 1752 1614 1615 1616 621 897 898 409 687 743 743 765 743 743 743 771 743 743 743 616 617 618 771 743 1811 1812 1813 1814 1815 743 1816 1817 1829 1830 1831 1832 1833 1834 1835 765 743 743 1836 1837 1838 1839 1840 1841 1842 1834 1835 743 743 742 1872 737 410 409 897 898 933 1617 1618 1619 1620 1753 1622 1754 1624 1625 1756 1627 1628 1629 638 906 907 404 700 701 762 764 743 743 743 743 743 743 743 743 743 743 743 1819 1820 1821 1822 1823 1824 743 1825 1826 1838 1839 1840 1842 1842 1843 1844 760 762 761 1845 1846 1847 1848 1849 742 742 1843 1844 743 758 762 762 750 751 408 906 907 832 1630 1631 1632 1633 1757 1635 1758 1759 1760 1761 1640 1641 1642 637 410 748 554 705 706 742 760 762 762 761 743 743 743 743 743 743 743 1827 1828 1829 1830 1831 1832 1833 743 1834 1835 1847 1848 1849 1842 1842 743 743 743 743 765 1854 1855 1856 1857 1858 758 762 762 762 762 769 744 744 1842 756 404 405 410 831 1643 1644 1645 1646 1763 1648 1649 1650 1651 1652 1653 1654 1655 636 410 685 683 683 686 734 734 734 766 765 743 743 743 743 743 743 743 1836 1837 1838 1839 1840 1842 743 743 1843 1844 1856 1857 1858 1879 1842 743 743 743 743 759 762 762 762 762 762 769 742 742 742 743 744 1863 735 733 736 410 409 410 824 1656 1657 1658 1659 1765 1661 1662 1663 1664 1665 1666 1667 1668 629 410 687 734 734 734 734 734 734 771 765 734 734 743 743 734 743 743 1845 1846 1847 1848 1849 743 743 743 743 743 743 1886 1887 1888 1889 743 743 743 743 765 742 1873 1874 1875 1876 742 742 1879 1842 743 744 744 737 557 410 410 409 557 816 1669 1670 1671 1672 1766 1767 1768 1769 1677 1678 1679 1680 1681 628 410 707 734 734 734 734 734 734 734 765 734 734 734 734 743 743 743 1854 1855 1856 1857 1858 743 743 743 743 743 743 1896 1897 1898 1899 743 743 743 743 765 1881 1882 1883 1884 1885 1886 1887 1888 1889 743 744 735 736 410 410 410 404 405 815 1682 1683 1684 1685 1686 1687 1688 1770 1690 1691 1692 1693 1694 726 685 686 1807 1808 734 734 734 734 734 759 762 762 762 762 761 743 1807 1808 743 743 743 743 743 743 743 743 743 1904 1905 1906 1907 1908 743 743 743 743 765 1890 1891 1893 1894 1895 1896 1897 1898 1899 735 733 736 869 862 863 864 865 409 800 1695 1696 1697 1698 1699 1700 1701 1771 1703 1704 1705 1706 1707 725 687 734 1816 1817 734 766 734 734 734 765 743 743 743 743 765 743 1816 1817 1842 743 743 743 743 559 560 561 562 1913 1914 1915 1916 743 743 743 743 743 765 1900 1901 1902 1903 1904 1905 1906 1907 1908 737 410 410 870 871 872 873 874 409 808 1708 1709 1710 1711 1712 1713 1714 1772 1717 1718 1719 1720 1721 724 687 734 1825 1826 734 771 758 762 762 769 743 766 743 743 765 743 1825 1826 1842 743 743 743 743 738 569 570 571 1922 1923 1924 1925 743 743 743 743 743 760 762 762 761 1912 1913 1914 1915 1916 743 740 739 410 879 880 881 882 883 409 807 1722 1723 1724 1725 1726 1727 1728 1773 1730 1731 1732 1733 1734 621 687 734 1834 1835 734 734 765 743 743 743 766 771 743 743 765 743 1834 1835 1842 743 1803 1804 1805 1806 738 579 580 743 743 743 743 743 1863 1864 743 743 743 743 742 765 1921 1922 1923 1924 1925 1926 743 737 410 888 889 890 891 410 409 789 790 791 792 793 794 795 410 409 410 796 797 798 799 806 698 689 1843 1844 734 734 759 762 762 761 771 743 743 758 769 743 1843 1844 1842 1811 1812 1813 1814 1815 587 588 589 743 743 743 743 743 743 743 743 743 743 743 743 760 762 762 762 762 762 762 762 750 751 406 406 406 406 406 412 405 554 410 410 410 402 406 406 412 407 406 406 406 406 406 406 700 701 762 762 762 769 743 743 760 762 762 762 769 743 743 743 743 1819 1820 1821 1822 1823 1824 738 738 598 594 594 594 632 743 743 743 766 743 743 1803 1804 1805 1806 1807 1808 743 743 743 743 743 756 420 557 748 410 410 410 404 406 405 897 898 409 410 748 410 409 410 410 840 841 842 554 705 706 1842 1842 1842 560 561 562 563 564 738 738 738 743 743 743 1827 1828 1829 1830 1831 1832 1833 743 743 607 63 63 63 631 632 743 743 771 743 1811 1812 1813 1814 1815 1816 1817 1842 743 743 743 743 757 420 862 863 864 865 565 566 410 409 906 907 409 410 410 410 409 410 848 849 850 851 410 748 687 1842 1842 1842 569 570 571 572 573 738 738 738 743 743 743 1836 1837 1838 1839 1840 1842 743 743 743 616 63 63 63 63 641 743 743 743 1819 1820 1821 1822 1823 1824 1825 1826 1842 743 735 733 733 736 870 871 872 873 874 574 575 410 404 407 406 413 876 877 878 409 856 857 858 859 860 410 693 687 1842 1842 1842 738 579 580 581 582 738 738 738 743 1807 1808 743 1846 1847 1848 1849 743 743 743 743 743 63 63 63 63 631 606 743 1827 1828 1829 1830 1831 1832 1833 1834 1835 1842 743 740 739 693 410 879 880 881 882 883 583 584 552 553 409 410 884 885 886 887 409 566 866 867 912 913 685 683 686 1842 1842 1842 587 588 589 590 591 592 738 738 743 1816 1817 1842 1855 1856 1857 1858 743 743 743 615 594 63 63 63 63 63 641 743 1836 1837 1838 1839 1840 1842 743 1843 1844 1842 743 743 737 410 410 888 889 890 891 410 410 410 555 556 409 892 893 894 895 896 409 575 748 410 410 410 687 743 743 743 738 738 738 738 598 599 600 601 602 738 743 1825 1826 1842 743 743 743 615 594 594 594 642 9 63 63 63 63 63 631 606 1845 1846 1847 1848 1849 743 743 743 743 743 743 743 737 748 410 410 410 410 699 703 703 692 419 419 409 901 902 903 904 748 409 584 748 410 410 410 690 691 691 691 689 743 743 743 607 608 609 610 611 738 743 1834 1835 1842 743 559 615 642 63 63 9 9 9 63 63 63 63 63 63 641 1854 1855 1856 1857 1858 743 766 743 743 615 594 594 695 696 692 420 699 703 704 9 9 697 703 692 409 909 910 911 410 699 409 703 703 703 692 410 410 554 410 693 687 743 743 743 616 617 618 619 620 738 743 1843 1844 1842 743 615 642 9 9 9 9 9 9 63 63 63 63 63 63 631 606 743 743 743 743 743 771 743 615 642 63 63 9 9 697 703 704 9 9 9 9 9 9 747 770 554 699 703 703 704 409 9 9 9 697 692 693 699 703 745 746 743 743 743 743 743 615 594 594 606 743 743 743 743 615 642 9 626 9 9 9 9 9 63 63 63 63 63 63 63 631 594 595 594 606 743 743 743 614 656 9 9 63 9 9 9 9 9 9 9 9 9 9 697 767 703 704 9 9 9 409 9 9 9 9 697 703 704 9 9 9 631 594 594 594 594 642 9 9 631 594 594 594 594 642 9 634 743 635 9 9 9 9 63 63 63 63 63 63 63 63 63 604 9 631 594 595 594 595 642 9 63 63 63 9 9 9 9 9 9 9 9 9 9 772 9 9 9 9 9 409 9 9 9 9 9 9 9 9 9 9 9 9 9 9 9 9 9 9 63 63 9 9 9 9 9 9 643 9 9 9 9 9 63 63 63 63 63 63 63 63 63 63 63 63 63 604 63 604 63 9 9 63 9 9 9 9 9 417 9 9 9 9 9 79 9 9 9 63 63 409 9 63 9 9 9 9 9 9 9 9 9 9 9 626 9 9 9 63 63 63 9 9 9 626 9 9 9 9 9 9 9 9 63 63 63 63 63 63 63 63 63 63 63 63 63 63 63 63 63 63 63 63 63 63 63 9 80 78 78 78 78 78 78 85 9 9 63 63 63 404 406 406 406 405 9 9 417 63 9 9 9 9 634 559 635 9 9 9 63 63 63 9 634 743 635 9 9 9 9 9 9 63 63 63 63 63 63 63 63 417 63 63 63 63 63 63 63 63 63 63 63 63 63 63 80 78 85 63 63 63 9 9 9 9 9 63 63 63 63 63 63 63 63 409 9 9 63 63 63 63 63 9 9 643 9 9 9 9 63 626 9 9 9 643 63 9 9 626 9 9 63 63 63 63 63 63 63 78 78 78 81 63 63 63 63 63 63 63 80 78 78 78 78 78 85 63 63 63 63 63 9 9 9 9 9 63 9 63 63 63 63 63 63 409 63 9 9 63 9 9 63 9 9 9 9 9 9 9 634 559 635 9 9 63 63 9 634 743 635 63 63 63 63 63 63 63 63 63 63 63 84 78 78 78 78 78 78 78 85 63 63 63 63 63 63 407 407 407 407 407 407 407 407 407 407 407 407 407 407 407 407 406 406 412 406 407 407 407 407 407 9 63 63 9 626 63 63 63 63 643 63 63 63 63 63 63 63 643 63 63 63 63 63 63 63 63 63 63 63 63 63 63 63 63 63 63 63 63 63 63 63 63 63 63 63 411 411 411 411 411 411 411 411 411 411 411 411 411 411 411 411 9 9 9 9 411 411 411 411 411 9 63 9 634 559 635 63 63 63 63 63 63 63 626 63 63 63 63 63 63 63 63 63 63 63 63 63 63 63 63 63 625 625 63 63 63 63 63 63 63 63 63 63 63 63 63 63 63 63 63 63 63 63 63 63 63 63 63 63 63 63 63 63 63 63 63 63 63 63 63 9 9 63 63 643 63 63 63 63 63 63 63 634 743 635 63 63 63 63 63 63 63 63 63 640 63 63 63 63 63 654 596 596 656 63 63 63 63 63 63 63 63 63 63 654 655 656 63 63 63 63 63 63 63 63 63 63 63 63 63 63 63 63 63 63 63 63 63 63 63 63 63 63 63 63 63 63 63 63 63 63 63 63 643 63 63 63 63 63 63 63 63 63 63 63 63 654 655 655 655 633 1800 1800 652 63 63 63 63 63 63 63 63 63 654 633 559 614 656 63 63 63 63 63 63 63 63 63 63 63 63 63 63 63 63 63 63 63 63 63 63 63 63 63 63 63 63 63 63 63 63 63 63 63 63 63 63 63 63 63 63 63 63)
    )
    (worldmap-spawnpoint
      (name "main")
      (x 12)
      (y 45)
    )
    (level
      (name "castledoor.stl")
      (x 32)
      (y 17)
      (sprite "images/worldmap/common/torch1.sprite")
    )
    (level
      (name "castledoor.stl")
      (x 33)
      (y 24)
      (sprite "images/worldmap/common/n_stone.sprite")
    )
    (level
      (name "castledoor.stl")
      (x 37)
      (y 21)
      (sprite "images/worldmap/common/torch.sprite")
    )
    (level
      (name "castledoor.stl")
      (x 38)
      (y 17)
      (sprite "images/worldmap/common/torch1.sprite")
    )
    (level
      (name "castledoor.stl")
      (x 37)
      (y 13)
      (sprite "images/worldmap/common/torch.sprite")
    )
    (level
      (name "key4.stl")
      (x 46)
      (y 46)
      (sprite "images/worldmap/forest/small_fire.sprite")
    )
    (level
      (name "key3.stl")
      (x 45)
      (y 46)
      (sprite "images/worldmap/forest/small_wood.sprite")
    )
    (level
      (name "key2.stl")
      (x 44)
      (y 46)
      (sprite "images/worldmap/forest/small_earth.sprite")
    )
    (level
      (name "key1.stl")
      (x 43)
      (y 46)
      (sprite "images/worldmap/forest/small_water.sprite")
    )
    (level
      (name "key5.stl")
      (x 47)
      (y 46)
      (sprite "images/worldmap/forest/small_air.sprite")
    )
    (level
      (name "christoph1.stl")
      (x 30)
      (y 46)
      (sprite "images/worldmap/forest/leveldots/sommer-1.sprite")
    )
    (level
      (name "christoph2.stl")
      (x 29)
      (y 46)
      (sprite "images/worldmap/forest/leveldots/sommer-2.sprite")
    )
    (level
      (name "christoph3.stl")
      (x 28)
      (y 46)
      (sprite "images/worldmap/forest/leveldots/sommer-3.sprite")
    )
    (level
      (name "christoph4.stl")
      (x 27)
      (y 46)
      (sprite "images/worldmap/forest/leveldots/sommer-4.sprite")
    )
    (level
      (name "christoph5.stl")
      (x 26)
      (y 46)
      (sprite "images/worldmap/forest/leveldots/sommer-5.sprite")
    )
    (level
      (name "christoph6.stl")
      (x 25)
      (y 46)
      (sprite "images/worldmap/forest/leveldots/sommer-6.sprite")
    )
    (level
      (name "owls_revenge.stl")
      (x 23)
      (y 46)
      (sprite "images/worldmap/forest/leveldots/sommer-revenge.sprite")
    )
    (level
      (name "forest1-grumbel.stl")
      (x 31)
      (y 46)
      (sprite "images/worldmap/forest/leveldots/grumbel-1.sprite")
    )
    (level
      (name "level1.stl")
      (x 32)
      (y 46)
      (sprite "images/worldmap/forest/leveldots/wansti-1.sprite")
    )
    (level
      (name "level2.stl")
      (x 33)
      (y 46)
      (sprite "images/worldmap/forest/leveldots/wansti-2.sprite")
    )
    (level
      (name "level4.stl")
      (x 34)
      (y 46)
      (sprite "images/worldmap/forest/leveldots/anubis-4.sprite")
    )
    (level
      (name "level5.stl")
      (x 35)
      (y 46)
      (sprite "images/worldmap/forest/leveldots/anubis-5.sprite")
    )
    (level
      (name "castledoor.stl")
      (x 37)
      (y 46)
      (sprite "images/worldmap/forest/leveldots/gwater-1.sprite")
    )
    (level
      (name "level6.stl")
      (x 36)
      (y 46)
      (sprite "images/worldmap/forest/leveldots/anubis-6.sprite")
    )
    (level
      (name "christoph7.stl")
      (x 24)
      (y 46)
      (sprite "images/worldmap/forest/leveldots/sommer-7.sprite")
    )
  )
  (tileset "images/worldmap.strf")
)
