(supertux-level
  (name (_ "Forest World"))
  (tileset "images/worldmap.strf")
  
  (sector
    (name "main")
    (music "music/forestmap.ogg")
    (tilemap
      (width 70)
      (height 50)
      (layer "interactive")
      (solid #t)
      (speed 1.000000)
      (tiles 743 743 743 429 430 431 432 743 743 743 742 742 742 742 742 742 742 742 742 742 742 742 742 742 737 410 410 410 410 410 410 748 748 748 748 748 748 748 748 748 748 410 410 410 410 410 687 563 563 563 563 559 559 559 563 559 559 559 559 559 559 559 559 559 559 559 559 559 559 673 743 743 437 438 439 440 441 442 443 743 742 742 742 742 742 742 742 742 742 742 742 742 742 742 737 410 410 410 410 410 410 410 748 748 748 748 748 748 748 748 748 410 410 410 410 694 687 563 563 563 563 563 559 559 558 559 558 558 558 563 558 558 558 559 558 559 558 559 559 559 743 445 446 447 448 449 450 451 452 743 743 743 743 742 742 742 742 742 742 742 742 742 742 742 737 410 410 410 410 410 410 410 410 410 410 748 748 748 748 748 748 748 410 410 410 557 687 563 563 563 563 563 559 559 558 559 558 559 558 563 558 559 558 559 558 559 558 559 559 559 453 454 455 456 457 458 459 460 461 743 743 743 743 742 742 742 742 742 742 742 742 735 733 733 736 410 410 410 410 410 410 410 410 410 410 410 410 748 748 748 748 748 748 552 553 693 687 563 563 563 563 563 559 559 558 563 558 558 558 563 558 558 558 559 558 558 558 673 559 559 462 463 464 465 466 467 468 469 470 743 743 743 743 742 742 742 742 742 742 742 742 737 748 410 410 410 410 410 748 748 748 410 410 410 410 410 748 748 748 748 840 841 842 555 556 410 687 563 563 563 563 559 559 559 558 563 563 563 558 559 558 559 558 559 559 559 558 559 559 559 471 472 473 474 475 476 477 478 479 743 743 743 743 742 742 499 500 501 502 742 742 737 410 410 410 410 410 410 410 410 897 898 410 862 863 864 865 748 748 848 849 850 851 410 410 410 687 563 563 673 673 673 673 673 558 563 673 673 558 559 558 558 558 559 559 673 558 559 559 559 480 481 482 483 484 485 486 487 488 743 743 743 743 738 743 508 509 510 511 742 735 736 748 748 410 801 802 803 804 805 906 907 870 871 872 873 874 748 856 857 858 859 860 748 410 693 687 563 563 563 673 673 673 673 673 673 673 673 673 559 559 559 563 563 673 673 563 563 559 559 743 743 743 743 493 494 495 496 497 743 743 743 743 738 516 517 518 519 520 735 736 410 748 410 809 810 811 812 813 814 839 869 879 880 881 882 883 897 898 866 867 748 748 748 694 410 690 689 563 563 673 673 673 673 673 560 673 673 673 673 673 673 673 673 673 673 563 563 563 563 743 743 743 743 743 503 504 489 743 743 743 743 743 738 525 526 527 528 735 736 410 410 748 410 818 819 820 821 822 823 839 410 888 889 890 891 748 906 907 748 748 897 898 862 863 864 865 690 689 673 673 673 563 563 673 560 560 560 560 560 560 560 560 560 560 560 560 560 563 563 743 743 743 743 743 738 738 738 738 738 738 738 738 738 743 742 498 742 737 410 410 410 825 826 827 828 829 912 830 410 402 406 406 406 406 406 406 406 406 405 410 906 907 871 872 873 874 693 690 689 673 673 560 560 560 560 560 563 563 563 563 563 563 563 563 563 673 560 560 560 743 743 743 743 743 738 743 743 738 738 476 477 478 479 743 742 759 765 750 751 405 410 834 835 836 837 838 912 402 406 413 908 410 410 410 410 410 410 410 404 405 410 879 880 881 882 883 694 693 687 673 673 560 569 570 571 572 573 574 559 563 563 563 563 563 563 563 563 563 563 743 743 743 743 743 738 743 738 738 743 485 486 487 488 743 742 771 742 742 756 404 405 843 844 845 846 847 402 413 167 168 169 170 171 172 173 174 175 176 177 409 410 888 889 890 891 693 685 683 686 673 576 563 578 579 580 581 582 583 559 563 563 563 563 563 563 563 563 563 563 743 743 743 743 743 738 738 738 743 493 494 495 496 497 743 743 771 735 733 736 410 404 406 406 407 406 406 413 721 180 181 182 183 184 185 186 187 188 189 190 404 406 406 406 405 748 685 686 563 563 673 673 586 587 588 589 590 591 592 559 563 563 563 563 563 563 563 563 563 563 743 743 743 743 743 738 738 743 743 743 503 504 743 743 743 761 775 737 694 748 897 898 748 869 409 897 898 410 900 193 194 195 196 197 198 199 200 201 202 203 204 897 898 410 409 693 687 559 563 563 563 594 595 596 597 598 599 599 599 559 563 563 563 563 563 563 563 563 563 563 743 743 743 743 743 738 743 743 743 743 743 743 759 765 765 770 743 740 741 739 906 907 748 869 409 906 907 410 899 206 207 208 209 210 211 212 213 214 215 216 217 906 907 410 404 406 700 701 712 711 563 602 603 604 605 606 559 559 559 560 560 563 563 563 563 563 563 563 563 563 743 743 743 743 743 743 743 743 759 765 765 765 775 743 743 763 765 764 735 736 410 410 748 869 409 410 869 410 861 219 220 221 222 223 224 225 226 227 228 229 230 231 410 897 898 748 705 706 560 715 563 611 612 613 614 615 560 673 560 560 560 563 563 563 563 563 563 563 563 563 743 743 743 743 743 743 743 761 775 743 743 743 428 429 430 431 432 763 750 751 406 406 406 406 408 410 410 869 855 232 233 234 235 236 237 238 239 240 241 242 243 244 716 906 907 748 693 707 560 715 599 599 599 599 607 608 609 560 560 560 560 563 563 563 563 563 563 563 563 563 551 429 430 431 432 743 743 771 489 468 435 436 437 438 439 440 441 442 443 756 897 898 897 898 404 405 410 410 854 245 246 247 248 249 250 251 252 253 254 255 256 257 677 410 748 748 748 707 563 715 563 559 599 599 616 617 618 619 563 563 560 563 563 563 563 563 563 563 563 563 437 438 439 440 441 442 443 771 433 489 444 445 446 447 448 449 450 451 452 737 906 907 906 907 410 409 410 410 853 258 259 260 261 262 263 264 265 266 267 268 269 270 676 410 693 693 685 686 563 717 712 711 599 624 625 626 627 628 630 631 632 633 637 563 563 563 563 563 563 563 446 447 448 449 450 451 452 771 489 468 453 454 455 456 457 458 459 460 461 740 741 741 741 739 410 409 410 410 852 271 272 273 274 275 276 277 278 279 280 281 282 283 675 897 898 557 687 563 673 560 563 715 599 563 634 635 560 638 639 640 641 642 563 563 563 563 563 563 563 563 455 456 457 458 459 460 461 771 743 743 462 463 464 465 466 467 468 469 470 743 743 742 498 737 410 409 897 898 933 284 285 286 287 288 289 290 291 292 293 294 295 296 667 906 907 694 687 563 563 563 563 717 712 711 673 673 601 647 648 649 650 651 563 563 563 563 563 563 563 563 464 465 466 427 427 743 743 763 765 767 471 472 473 474 475 742 742 759 767 743 759 765 765 750 751 408 906 907 832 297 298 299 300 301 302 303 304 305 306 307 308 309 666 410 748 694 707 563 563 673 673 673 559 715 563 673 560 656 657 658 659 563 563 560 560 563 563 563 563 563 473 474 475 427 427 743 743 743 743 771 480 481 482 483 484 759 768 775 763 765 775 744 744 426 756 404 405 410 831 310 311 312 313 314 315 316 317 318 319 320 321 322 665 410 685 683 686 561 622 673 564 601 601 715 563 563 563 563 601 601 560 560 560 560 560 643 563 563 563 563 482 483 484 505 427 743 743 743 743 771 761 765 765 765 768 775 742 742 742 743 744 489 735 733 736 410 409 410 824 323 324 325 326 327 328 329 330 331 332 333 334 335 629 410 687 576 569 570 571 572 573 574 576 717 711 601 601 563 601 601 601 560 560 563 563 643 563 563 563 563 743 512 513 514 515 743 743 743 743 762 775 499 500 501 502 742 742 505 506 743 744 744 737 557 410 410 409 557 816 336 337 338 339 340 341 342 343 344 345 346 347 348 620 410 707 559 578 579 580 581 582 583 601 601 715 601 601 601 601 630 631 632 633 563 563 643 563 563 563 563 743 521 522 523 524 743 743 743 743 771 507 508 509 510 511 512 513 514 515 743 744 735 736 410 410 410 404 405 815 349 350 351 352 353 354 355 356 357 358 359 360 361 726 685 686 586 587 588 589 590 591 592 710 712 718 712 712 711 638 639 640 641 642 643 563 563 563 563 563 563 529 530 531 532 533 743 743 743 743 771 516 517 518 519 520 521 522 523 524 735 733 736 869 862 863 864 865 409 800 362 363 364 365 366 367 368 369 370 371 372 373 374 725 687 594 595 596 597 598 599 710 712 719 630 631 632 633 715 647 648 649 650 651 563 563 563 563 563 563 563 538 539 540 541 743 743 743 743 743 771 525 526 527 528 529 530 531 532 533 737 410 410 870 871 872 873 874 409 808 376 377 378 379 380 381 382 383 384 385 386 387 388 724 687 602 603 604 605 606 708 719 623 638 639 640 641 642 715 656 657 658 659 652 563 563 563 563 563 563 563 547 548 549 550 743 743 743 743 743 763 768 764 536 537 538 539 540 541 743 740 739 410 879 880 881 882 883 409 807 389 390 391 392 393 394 395 396 397 3985 399 400 401 621 687 611 612 613 614 615 715 643 643 647 648 649 650 651 715 673 601 601 601 652 563 563 563 563 563 563 563 743 743 743 743 743 489 490 743 743 743 743 763 764 545 547 548 549 550 743 743 737 410 888 889 890 891 869 409 789 790 791 792 793 794 795 410 409 410 796 797 798 799 806 698 689 563 563 708 712 719 643 623 656 657 658 659 623 715 673 601 601 563 563 563 563 563 563 563 563 563 743 743 743 743 743 743 743 743 743 743 743 743 763 765 765 765 765 765 765 765 750 751 406 406 406 406 406 412 405 410 410 410 410 402 406 406 412 406 406 406 406 406 406 406 700 701 712 714 576 607 608 609 610 599 563 622 710 719 559 563 563 563 563 563 563 563 563 563 563 563 743 743 743 743 743 743 743 743 743 743 429 430 431 432 743 743 743 743 743 743 743 756 191 557 748 410 410 410 404 406 405 897 898 409 410 748 410 410 410 410 840 841 842 694 705 706 559 715 563 616 617 618 619 708 712 712 719 563 610 563 563 563 563 563 563 563 563 563 563 563 743 743 743 743 743 743 743 743 743 437 438 439 440 441 442 443 426 743 743 743 743 757 191 862 863 864 865 748 410 410 409 906 907 409 410 410 410 410 410 848 849 850 851 410 748 687 563 715 624 625 626 627 628 715 563 563 559 559 610 563 563 563 563 563 563 563 563 563 563 563 743 743 743 743 743 743 743 743 445 446 447 448 449 450 451 452 426 743 735 733 733 736 870 871 872 873 874 748 410 410 404 406 406 413 876 877 878 410 856 857 858 859 860 410 693 687 563 715 681 634 635 708 712 719 563 576 567 559 569 570 571 572 573 574 563 563 563 563 563 563 743 743 743 743 743 743 743 453 454 455 456 457 458 459 460 461 426 743 740 739 693 410 879 880 881 882 883 410 410 552 553 410 410 884 885 886 887 410 410 866 867 912 913 685 683 686 563 717 712 712 712 719 600 563 610 610 610 610 578 579 580 581 582 583 563 563 563 563 563 563 743 743 743 743 743 743 743 462 463 464 465 466 467 743 743 743 426 743 743 737 410 410 888 889 890 891 410 410 410 555 556 410 892 893 894 895 896 748 897 898 410 410 410 687 563 559 576 563 559 559 563 660 645 646 563 610 610 586 587 588 589 590 591 592 563 563 563 563 563 563 743 743 743 743 743 743 743 471 472 473 474 475 743 743 743 743 743 743 743 737 748 410 410 410 410 897 898 410 748 897 898 410 901 902 903 904 748 410 906 907 410 410 410 690 691 691 691 689 563 563 652 653 654 655 563 559 594 595 596 597 598 599 563 563 563 563 563 563 563 563 743 743 743 743 743 743 743 480 481 482 483 484 743 743 743 743 743 743 743 737 748 410 410 410 410 906 907 410 410 906 907 410 909 910 911 410 748 410 410 410 410 410 410 410 694 410 693 687 563 660 661 662 663 664 563 559 602 603 604 605 606 563 563 563 563 563 563 563 563 563 743 743 743 743 743 743 743 743 743 743 743 743 743 743 743 743 743 743 743 737 748 410 410 410 410 410 410 410 410 410 410 410 410 410 410 410 897 898 552 553 410 410 410 410 410 693 748 687 668 669 670 671 672 563 563 559 611 612 613 614 615 563 563 563 563 563 563 563 563 563 743 743 743 743 743 743 743 743 743 743 743 743 743 743 743 743 743 743 743 737 748 748 748 748 748 410 410 410 410 410 410 410 410 410 410 410 906 907 555 556 748 410 410 410 410 748 748 687 563 678 679 680 681 563 563 559 559 563 563 563 563 563 563 563 563 563 563 563 563 563 743 743 743 743 743 743 743 432 743 432 432 743 743 743 743 743 743 743 743 737 694 410 410 410 748 748 410 410 410 410 410 410 410 410 410 410 410 410 410 410 410 410 410 410 748 748 748 690 689 563 560 560 560 563 563 563 563 563 563 563 563 563 563 563 563 563 563 563 563 563 743 743 743 743 743 743 432 432 432 432 432 743 743 743 743 743 743 743 743 737 410 410 748 748 410 410 410 410 410 410 410 410 410 410 410 410 410 410 410 410 410 410 410 410 552 553 748 748 707 563 563 563 560 560 563 563 563 563 563 563 563 563 563 563 563 563 563 563 563 563 743 743 551 743 551 432 432 432 432 432 432 432 743 743 743 743 743 743 743 737 410 410 748 748 410 410 410 410 410 410 410 410 410 410 410 410 410 410 410 410 410 410 410 410 555 556 748 748 687 563 563 563 563 560 563 563 563 563 563 563 563 563 563 563 563 563 563 563 563 563 551 551 551 551 551 551 551 432 432 432 551 551 551 743 743 743 743 743 743 737 410 748 748 748 748 410 410 410 410 410 410 410 410 410 410 410 410 410 410 410 410 410 410 410 410 410 748 748 690 691 691 689 563 563 563 563 563 563 563 563 563 563 563 563 563 563 563 563 563 563 551 551 551 551 551 743 551 551 743 551 551 551 743 743 743 743 743 743 743 737 410 410 410 410 410 410 410 410 410 410 410 410 410 410 410 410 410 410 410 410 410 410 410 410 410 410 748 748 748 748 748 687 560 560 563 563 563 563 563 563 563 563 563 563 563 563 563 563 563 563 551 551 551 551 551 551 551 551 551 551 551 551 743 743 743 743 743 743 743 737 410 410 410 410 410 410 410 410 410 410 410 410 410 410 410 410 410 410 410 410 748 410 410 410 410 410 410 748 410 410 748 687 560 560 563 563 560 563 563 563 563 563 563 563 563 563 563 563 563 563 551 551 551 743 551 743 551 551 551 551 551 551 743 743 743 743 743 743 743 737 410 410 410 410 410 410 410 410 410 410 410 410 410 410 410 410 410 555 555 410 410 410 410 555 555 410 410 410 748 748 748 687 560 563 563 563 563 563 563 563 563 563 563 563 563 563 559 563 563 563 551 551 743 743 743 551 551 551 551 743 551 551 743 743 743 743 743 551 551 737 410 410 410 410 555 555 555 555 410 555 555 555 410 410 410 555 555 555 555 555 555 555 555 555 555 555 555 555 555 555 410 687 563 563 563 563 563 563 563 563 563 563 563 563 563 563 559 563 563 563 551 551 551 551 551 551 551 551 551 551 551 551 551 551 743 743 551 551 551 737 410 555 555 555 555 555 555 555 555 555 555 555 555 555 555 555 555 555 555 555 555 555 555 555 555 555 555 555 555 555 410 687 559 563 563 563 563 563 559 559 559 559 559 559 559 559 559 563 563 563 551 551 551 551 551 551 551 551 551 551 551 551 551 551 551 551 551 551 551 737 555 555 555 555 555 555 555 555 555 555 555 555 555 555 555 555 555 555 555 555 555 555 555 555 555 555 555 555 555 555 555 687 559 559 559 559 559 559 559 559 559 559 559 559 559 559 559 563 563 563)
    )
    (worldmap-spawnpoint
      (x 36)
      (y 27)
      (name "main")
    )
    (level
      (x 32)
      (y 17)
      (sprite "images/worldmap/common/torch1.sprite")
      (name "castledoor.stl")
    )
    (level
      (x 33)
      (y 24)
      (sprite "images/worldmap/common/n_stone.sprite")
      (name "castledoor.stl")
    )
    (level
      (x 37)
      (y 21)
      (sprite "images/worldmap/common/torch.sprite")
      (name "castledoor.stl")
    )
    (level
      (x 38)
      (y 17)
      (sprite "images/worldmap/common/torch1.sprite")
      (name "castledoor.stl")
    )
    (level
      (x 37)
      (y 13)
      (sprite "images/worldmap/common/torch.sprite")
      (name "castledoor.stl")
    )
    (level
      (x 53)
      (y 25)
      (sprite "images/worldmap/common/shroom.sprite")
      (name "level2.stl")
    )
    (level
      (x 7)
      (y 18)
      (sprite "images/worldmap/common/shroom.sprite")
      (name "christoph1.stl")
    )
    (level
      (x 16)
      (y 15)
      (sprite "images/worldmap/common/shroom.sprite")
      (name "christoph2.stl")
    )
  )
)

