(supertux-level
  (version 3)
  (name (_ "Antarctica 1"))
  (author "Bill Kendrick")
  (license "CC-BY-SA 4.0 International")
  (target-time 39)
  (allow-item-pocket "inherit")
  (icon "")
  (icon-locked "")
  (statistics
    (enable-coins #t)
    (enable-badguys #f)
    (enable-secrets #t)
  )
  (sector
    (name "main")
    (ambient-light
      (color 1 1 1)
    )
    (background
      (color 0.9999999 0.9999999 0.9999999)
      (scroll-speed-x -2)
      (speed 0)
      (image "/images/background/misc/clouds.png")
      (z-pos -230)
    )
    (background
      (color 0.9999999 0.9999999 0.9999999)
      (alignment "bottom")
      (speed 0)
      (speed-y 0.01)
      (image "/images/background/retro/arctis_skyline.png")
      (z-pos -220)
    )
    (background
      (color 1 1 1)
      (alignment "bottom")
      (speed 0.01)
      (image "/images/background/retro/arctis_icechunk.png")
      (z-pos -210)
    )
    (background
      (color 1 1 1)
      (alignment "bottom")
      (speed 0.5)
      (image "/images/background/retro/arctis_shore.png")
      (z-pos -200)
    )
    (background
      (color 1 1 1)
      (scroll-speed-x -0.1)
      (speed 0)
      (image "/images/background/misc/skybox.png")
      (z-pos -240)
    )
    (bonusblock
      (type "retro")
      (z-pos 51)
      (x 7872)
      (y 512)
    )
    (bonusblock
      (type "retro")
      (z-pos 51)
      (contents "retrogrow")
      (x 7968)
      (y 512)
    )
    (bonusblock
      (type "retro")
      (z-pos 51)
      (x 8960)
      (y 384)
    )
    (bonusblock
      (type "retro")
      (z-pos 51)
      (x 4768)
      (y 512)
    )
    (bonusblock
      (type "retro")
      (z-pos 51)
      (x 4672)
      (y 512)
    )
    (bonusblock
      (type "retro")
      (z-pos 51)
      (x 4672)
      (y 384)
    )
    (bonusblock
      (type "retro")
      (z-pos 51)
      (x 4576)
      (y 512)
    )
    (bonusblock
      (type "retro")
      (z-pos 51)
      (contents "retrostar")
      (x 4352)
      (y 512)
    )
    (bonusblock
      (type "retro")
      (z-pos 51)
      (x 4320)
      (y 512)
    )
    (bonusblock
      (type "retro")
      (z-pos 51)
      (x 4000)
      (y 384)
    )
    (bonusblock
      (type "retro")
      (z-pos 51)
      (contents "retrogrow")
      (x 3424)
      (y 512)
    )
    (bonusblock
      (type "retro")
      (z-pos 51)
      (x 864)
      (y 384)
    )
    (bonusblock
      (type "retro")
      (z-pos 51)
      (contents "retrogrow")
      (x 832)
      (y 512)
    )
    (bonusblock
      (type "retro")
      (z-pos 51)
      (x 896)
      (y 512)
    )
    (bonusblock
      (type "retro")
      (z-pos 51)
      (x 672)
      (y 512)
    )
    (bonusblock
      (type "retro")
      (z-pos 51)
      (count 5)
      (sprite "/images/objects/bonus_block/retro_brick.sprite")
      (x 4000)
      (y 512)
    )
    (bonusblock
      (type "retro")
      (z-pos 51)
      (count 5)
      (sprite "/images/objects/bonus_block/retro_brick.sprite")
      (x 3968)
      (y 384)
    )
    (bonusblock
      (type "retro")
      (z-pos 51)
      (count 5)
      (sprite "/images/objects/bonus_block/retro_brick.sprite")
      (x 3936)
      (y 384)
    )
    (bonusblock
      (type "retro")
      (z-pos 51)
      (count 5)
      (sprite "/images/objects/bonus_block/retro_brick.sprite")
      (x 3936)
      (y 384)
    )
    (bonusblock
      (type "retro")
      (z-pos 51)
      (count 5)
      (sprite "/images/objects/bonus_block/retro_brick.sprite")
      (x 3904)
      (y 384)
    )
    (bonusblock
      (type "retro")
      (z-pos 51)
      (count 5)
      (sprite "/images/objects/bonus_block/retro_brick.sprite")
      (x 3872)
      (y 384)
    )
    (bonusblock
      (type "retro")
      (z-pos 51)
      (count 5)
      (sprite "/images/objects/bonus_block/retro_brick.sprite")
      (x 3840)
      (y 384)
    )
    (bonusblock
      (type "retro")
      (z-pos 51)
      (count 5)
      (sprite "/images/objects/bonus_block/retro_brick.sprite")
      (x 3712)
      (y 384)
    )
    (bonusblock
      (type "retro")
      (z-pos 51)
      (count 5)
      (sprite "/images/objects/bonus_block/retro_brick.sprite")
      (x 3680)
      (y 384)
    )
    (bonusblock
      (type "retro")
      (z-pos 51)
      (count 5)
      (sprite "/images/objects/bonus_block/retro_brick.sprite")
      (x 3648)
      (y 384)
    )
    (bonusblock
      (type "retro")
      (z-pos 51)
      (count 5)
      (sprite "/images/objects/bonus_block/retro_brick.sprite")
      (x 3616)
      (y 384)
    )
    (bonusblock
      (type "retro")
      (z-pos 51)
      (count 5)
      (sprite "/images/objects/bonus_block/retro_brick.sprite")
      (x 3584)
      (y 384)
    )
    (bonusblock
      (type "retro")
      (z-pos 51)
      (count 5)
      (sprite "/images/objects/bonus_block/retro_brick.sprite")
      (x 3552)
      (y 384)
    )
    (bonusblock
      (type "retro")
      (z-pos 51)
      (count 5)
      (sprite "/images/objects/bonus_block/retro_brick.sprite")
      (x 3520)
      (y 384)
    )
    (bonusblock
      (type "retro")
      (z-pos 51)
      (count 5)
      (sprite "/images/objects/bonus_block/retro_brick.sprite")
      (x 3488)
      (y 384)
    )
    (brick
      (type "retro")
      (z-pos 51)
      (x 800)
      (y 512)
      (breakable #t)
    )
    (brick
      (type "retro")
      (z-pos 51)
      (x 864)
      (y 512)
      (breakable #t)
    )
    (brick
      (type "retro")
      (z-pos 51)
      (x 928)
      (y 512)
      (breakable #t)
    )
    (brick
      (type "retro")
      (z-pos 51)
      (x 3392)
      (y 512)
      (breakable #t)
    )
    (brick
      (type "retro")
      (z-pos 51)
      (x 3456)
      (y 512)
      (breakable #t)
    )
    (brick
      (type "retro")
      (z-pos 51)
      (x 7840)
      (y 512)
      (breakable #t)
    )
    (brick
      (type "retro")
      (z-pos 51)
      (x 7904)
      (y 512)
      (breakable #t)
    )
    (brick
      (type "retro")
      (z-pos 51)
      (x 7936)
      (y 512)
      (breakable #t)
    )
    (brick
      (type "retro")
      (z-pos 51)
      (x 8000)
      (y 512)
      (breakable #t)
    )
    (camera
      (name "Camera")
      (mode "normal")
    )
    (coin
      (type "retro")
      (z-pos 49)
      (x 9184)
      (y 512)
    )
    (coin
      (type "retro")
      (z-pos 49)
      (x 9248)
      (y 512)
    )
    (coin
      (type "retro")
      (z-pos 49)
      (x 9312)
      (y 512)
    )
    (coin
      (type "retro")
      (z-pos 49)
      (x 9376)
      (y 512)
    )
    (coin
      (type "retro")
      (z-pos 49)
      (x 5824)
      (y 608)
    )
    (coin
      (type "retro")
      (z-pos 49)
      (x 5760)
      (y 512)
    )
    (coin
      (type "retro")
      (z-pos 49)
      (x 5696)
      (y 416)
    )
    (coin
      (type "retro")
      (z-pos 49)
      (x 5632)
      (y 320)
    )
    (coin
      (type "retro")
      (z-pos 49)
      (x 5568)
      (y 288)
    )
    (coin
      (type "retro")
      (z-pos 49)
      (x 5472)
      (y 320)
    )
    (coin
      (type "retro")
      (z-pos 49)
      (x 5344)
      (y 384)
    )
    (coin
      (type "retro")
      (z-pos 49)
      (x 5248)
      (y 416)
    )
    (coin
      (type "retro")
      (z-pos 49)
      (x 5152)
      (y 448)
    )
    (coin
      (type "retro")
      (z-pos 49)
      (x 5056)
      (y 480)
    )
    (decal
      (z-pos -110)
      (sprite "/images/decal/misc/flag.sprite")
      (x 11744)
      (y 288)
    )
    (firefly
      (z-pos 0)
      (x 6448)
      (y 384)
    )
    (gradient
      (top_color 0.7999999 0.9 0.9999997)
      (bottom_color 0.82 0.8 0.98)
    )
    (jumpy
      (type "bag")
      (z-pos 50)
      (x 512)
      (y 576)
    )
    (leveltime
      (time 255)
    )
    (mriceblock
      (type "laptop")
      (z-pos 50)
      (direction "left")
      (x 4384)
      (y 608)
    )
    (mriceblock
      (type "laptop")
      (z-pos 50)
      (direction "left")
      (x 8512)
      (y 608)
    )
    (mriceblock
      (type "laptop")
      (z-pos 50)
      (direction "left")
      (x 9408)
      (y 512)
    )
    (music
      (file "/music/retro/classic.music")
    )
    (sequencetrigger
      (sequence "endsequence")
      (width 32)
      (height 608)
      (x 11488)
      (y 0)
    )
    (sequencetrigger
      (sequence "stoptux")
      (width 32)
      (height 608)
      (x 11808)
      (y 0)
    )
    (snowball
      (type "bsod")
      (z-pos 50)
      (direction "left")
      (x 1056)
      (y 608)
    )
    (snowball
      (type "bsod")
      (z-pos 50)
      (direction "left")
      (x 2240)
      (y 608)
    )
    (snowball
      (type "bsod")
      (z-pos 50)
      (direction "left")
      (x 2720)
      (y 608)
    )
    (snowball
      (type "bsod")
      (z-pos 50)
      (direction "left")
      (x 2784)
      (y 608)
    )
    (snowball
      (type "bsod")
      (z-pos 50)
      (direction "left")
      (x 2848)
      (y 608)
    )
    (snowball
      (type "bsod")
      (z-pos 50)
      (direction "left")
      (x 3616)
      (y 352)
    )
    (snowball
      (type "bsod")
      (z-pos 50)
      (direction "left")
      (x 4224)
      (y 608)
    )
    (snowball
      (type "bsod")
      (z-pos 50)
      (direction "left")
      (x 4288)
      (y 608)
    )
    (snowball
      (type "bsod")
      (z-pos 50)
      (direction "left")
      (x 4704)
      (y 608)
    )
    (snowball
      (type "bsod")
      (z-pos 50)
      (direction "left")
      (x 4768)
      (y 608)
    )
    (snowball
      (type "bsod")
      (z-pos 50)
      (direction "left")
      (x 5088)
      (y 512)
    )
    (snowball
      (type "bsod")
      (z-pos 50)
      (direction "left")
      (x 5184)
      (y 480)
    )
    (snowball
      (type "bsod")
      (z-pos 50)
      (direction "left")
      (x 5280)
      (y 448)
    )
    (snowball
      (type "bsod")
      (z-pos 50)
      (direction "left")
      (x 5376)
      (y 416)
    )
    (snowball
      (type "bsod")
      (z-pos 50)
      (direction "left")
      (x 5984)
      (y 608)
    )
    (snowball
      (type "bsod")
      (z-pos 50)
      (direction "left")
      (x 6048)
      (y 608)
    )
    (snowball
      (type "bsod")
      (z-pos 50)
      (direction "left")
      (x 6112)
      (y 608)
    )
    (snowball
      (type "bsod")
      (z-pos 50)
      (direction "left")
      (x 8032)
      (y 608)
    )
    (snowball
      (type "bsod")
      (z-pos 50)
      (direction "left")
      (x 8096)
      (y 608)
    )
    (snowball
      (type "bsod")
      (z-pos 50)
      (direction "left")
      (x 8672)
      (y 608)
    )
    (snowball
      (type "bsod")
      (z-pos 50)
      (direction "left")
      (x 8736)
      (y 608)
    )
    (snowball
      (type "bsod")
      (z-pos 50)
      (direction "left")
      (x 8800)
      (y 608)
    )
    (snowball
      (type "bsod")
      (z-pos 50)
      (direction "left")
      (x 9088)
      (y 608)
    )
    (snowball
      (type "bsod")
      (z-pos 50)
      (direction "left")
      (x 9152)
      (y 608)
    )
    (snowball
      (type "bsod")
      (z-pos 50)
      (direction "left")
      (x 9216)
      (y 608)
    )
    (snowball
      (type "bsod")
      (z-pos 50)
      (direction "left")
      (x 10464)
      (y 608)
    )
    (spawnpoint
      (name "main")
      (x 96)
      (y 576)
    )
    (tilemap
      (solid #t)
      (z-pos 0)
      (width 375)
      (height 25)
      (tiles -2982 0 4100 4101 -372 0 4100 4168 4158 -371 0 4100 4168 4163 4162 -370 0 4100 4168 4163 4000 4162 -334 0 -3 82 0 -3 82 -2 0 82 -25 0 4100 4168 4163 -2 4000 4162 -334 0 82 -3 0 82 0 82 -2 0 82 -24 0 4100 4168 4163 -3 4000 4162 -182 0 4100 4102 4101 -149 0 82 0 82 0 82 0 82 -2 0 82 -23 0 4100 4168 4163 -4 4000 4162 -179 0 4100 -2 4102 4168 4002 4158 -31 0 4100 -2 4102 4101 -16 0 4100 4101 -3 0 4100 4101 -91 0 82 0 82 0 82 0 82 -25 0 4100 4168 4163 -5 4000 4162 -89 0 4100 4102 4101 -17 0 4100 4102 4101 -64 0 4100 -2 4102 4168 -2 4001 4163 4000 4162 -30 0 4100 4168 -2 4001 4169 4101 -14 0 4100 4168 4158 -3 0 4157 4169 4101 -90 0 -3 82 0 -3 82 -2 0 82 -21 0 4100 4168 4163 -6 4000 4162 -76 0 4100 4102 4101 -10 0 4157 4001 4158 -17 0 4157 4002 4158 -61 0 4100 -2 4102 4168 4003 4001 4163 -4 4000 4162 -10 0 82 -18 0 4100 4168 4163 -2 4000 4164 4169 4101 -12 0 4100 4168 4163 4162 -3 0 4161 4164 4169 4101 -11 0 4100 4102 4101 -11 0 4100 4102 4101 -22 0 4100 4102 4101 -4 0 4100 -7 4102 4101 -4 0 4100 4102 4101 -46 0 4100 4168 4163 -7 4000 4162 -66 0 4100 4102 4101 -7 0 4157 4001 4158 -10 0 4161 4000 4162 -17 0 4161 4000 4162 -61 0 4157 -2 4001 4163 -7 4000 4162 -28 0 4100 4168 4163 -4 4000 4164 4169 4101 -10 0 4100 4168 4163 4000 4162 -3 0 4161 4000 4164 4169 4101 -10 0 4157 4001 4158 -11 0 4157 4001 4158 -22 0 4157 4002 4158 -4 0 4181 -7 4170 4182 -4 0 4157 4001 4158 -45 0 4100 4168 4163 -8 4000 4162 -66 0 4157 4001 4158 -7 0 4161 4000 4162 -10 0 4161 4000 4162 -17 0 4161 4000 4162 -61 0 4161 -6 4000 4078 -3 4000 4162 -27 0 4100 4168 4163 -6 4000 4164 4169 4101 -8 0 4100 4168 4163 -2 4000 4162 -3 0 4161 -2 4000 4164 4169 4101 -9 0 4161 4000 4162 -11 0 4161 4000 4162 -22 0 4161 4000 4162 -17 0 4161 4000 4162 -44 0 4100 4168 4163 -5 4000 4078 -3 4000 4160 -10 4102 4101 -5 0 -50 4102 4159 4000 4160 -7 4102 4159 4000 4160 -10 4102 4159 4000 4160 -17 4102 4159 4000 4160 -3 4102 4101 -3 0 4100 -12 4102 4101 -3 0 4100 -36 4102 4159 -10 4000 4162 -10 0 4100 -16 4102 4168 4163 -8 4000 4164 4169 -8 4102 4168 4163 -3 4000 4162 -3 0 4161 -3 4000 4164 4169 -9 4102 4159 4000 4160 -11 4102 4159 4000 4160 -22 4102 4159 4000 4160 -17 4102 4159 4000 4160 -44 4102 4168 4163 -10 4000 4164 -7 4001 4002 -2 4001 4158 -5 0 -2 4001 4002 4001 -2 4002 -26 4001 4002 -2 4001 4003 -2 4001 4003 4001 4002 -2 4001 -2 4002 -3 4001 4002 4001 4163 4000 4164 4003 4002 4001 4003 4001 4003 4001 4163 4000 4164 4002 4001 4003 -4 4001 4002 -2 4001 4163 4000 4164 4001 4002 4001 4002 4001 4002 -2 4001 4002 4001 4002 4003 4001 4003 4002 4003 4001 4163 4000 4164 -3 4001 4158 -3 0 4157 4001 -2 4002 -9 4001 4158 -3 0 4157 -4 4001 4002 4003 -9 4001 4002 -2 4001 4003 4002 4001 4002 4001 4002 4001 4003 -2 4001 4003 -2 4001 4002 -3 4001 4002 4163 -10 4000 4162 -10 0 4157 -2 4001 4003 4002 4001 4002 4001 4002 4001 4003 -6 4001 4163 -10 4000 4164 -8 4001 4163 -4 4000 4162 -3 0 4161 -4 4000 4164 4003 4001 4003 -4 4001 4002 4001 4163 4000 4164 4002 -9 4001 4002 4163 4000 4164 -2 4001 4003 -2 4001 4002 -3 4001 -2 4002 4001 4003 4001 4003 4001 4003 -3 4001 4002 4001 4163 4000 4164 4001 4003 -2 4001 4002 -3 4001 4003 -2 4001 4002 -5 4001 4163 4000 4164 -7 4001 4003 4002 4001 4003 4001 4003 4001 4003 -2 4001 -3 4002 -5 4001 -3 4002 -2 4001 4002 4001 4002 4001 4002 4001 4002 -7 4001 4163 -22 4000 4162 -5 0 -99 4000 4162 -3 0 4161 -12 4000 4162 -3 0 4161 -47 4000 4162 -10 0 4161 -41 4000 4162 -3 0 4161 -50 4000 4078 -92 4000 4162 -5 0 -9 4000 4078 -67 4000 4078 -21 4000 4162 -3 0 4161 -8 4000 4078 -3 4000 4162 -3 0 4161 -47 4000 4162 -10 0 4161 -22 4000 4078 -18 4000 4162 -3 0 4161 -143 4000 4162 -5 0 -99 4000 4162 -3 0 4161 -12 4000 4162 -3 0 4161 -47 4000 4162 -10 0 4161 -41 4000 4162 -3 0 4161 -25 4000 4078 -114 4000 4078 -2 4000 4162 -5 0 -62 4000 4078 -36 4000 4162 -3 0 4161 -12 4000 4162 -3 0 4161 -27 4000 4078 -19 4000 4162 -10 0 4161 -41 4000 4162 -3 0 4161 -91 4000 4078 -51 4000 4162 -5 0)
    )
    (tilemap
      (solid #f)
      (z-pos -100)
      (width 375)
      (height 25)
      (tiles -1131 0 85 86 87 88 -48 0 85 86 87 88 -98 0 85 86 87 88 -136 0 85 86 87 88 -68 0 85 86 87 -6 0 89 90 91 92 -48 0 89 90 91 92 -57 0 85 86 87 88 -37 0 89 90 91 92 -60 0 85 86 87 88 -72 0 89 90 91 92 -68 0 89 90 91 -119 0 89 90 91 92 -101 0 89 90 91 92 -169 0 85 86 87 88 -40 0 85 86 87 88 -71 0 85 86 87 88 -36 0 85 86 87 88 -103 0 85 86 87 88 -105 0 89 90 91 92 -40 0 89 90 91 92 -71 0 89 90 91 92 -36 0 89 90 91 92 -103 0 89 90 91 92 -119 0 85 86 87 88 -132 0 82 -97 0 85 86 87 88 -94 0 80 -42 0 89 90 91 92 -53 0 85 86 87 88 -79 0 85 86 87 88 -60 0 85 86 87 88 -26 0 89 90 91 92 -94 0 79 -99 0 89 90 91 92 -79 0 89 90 91 92 -60 0 89 90 91 92 -124 0 79 -5 0 85 -368 0 79 -5 0 89 -328 0 85 86 87 88 -25 0 85 86 87 88 -7 0 79 -334 0 89 90 91 92 -25 0 89 90 91 92 -7 0 79 -374 0 79 -374 0 79 -374 0 79 -374 0 79 -43 0 93 94 95 96 -18 0 93 94 -19 0 93 94 95 96 -122 0 93 94 95 96 -110 0 93 94 95 96 -20 0 93 94 95 96 -20 0 79 -9 0 93 94 95 96 -30 0 97 98 99 100 -18 0 97 98 -4 0 93 94 95 96 -11 0 97 98 99 100 -36 0 93 94 95 96 -82 0 97 98 99 100 -24 0 93 94 95 96 -18 0 93 94 95 96 -60 0 97 98 99 100 -20 0 97 98 99 100 -1902 0)
    )
    (tilemap
      (solid #f)
      (z-pos 100)
      (width 375)
      (height 25)
      (tiles -9375 0)
    )
    (tilemap
      (solid #t)
      (z-pos -1)
      (width 375)
      (height 25)
      (tiles -7494 0 2019 2140 2141 2142 2019 2140 -168 0 2019 2140 2141 2142 2019 2140 2141 2142 2019 2140 2141 2142 -189 0 -6 2020 -168 0 -12 2020 -189 0 -6 2020 -168 0 -12 2020 -189 0 -6 2020 -168 0 -12 2020 -189 0 -6 2020 -168 0 -12 2020 -189 0 -6 2020)
    )
  )
)
