(supertux-level
  (version 3)
  (name (_ "Long Office Nights"))
  (author "Carsten Wirtz")
  (license "CC-BY-SA 4.0 International")
  (target-time 45)
  (allow-item-pocket "inherit")
  (icon "")
  (icon-locked "")
  (statistics
    (enable-coins #t)
    (enable-badguys #f)
    (enable-secrets #t)
  )
  (sector
    (name "main")
    (ambient-light
      (color 0.7 0.8 1)
    )
    (background
      (color 0.3 0.4 0.6)
      (scroll-speed-x -0.1)
      (speed 0)
      (image "/images/background/misc/skybox.png")
      (z-pos -240)
    )
    (background
      (color 0.2 0.3 0.66)
      (alignment "bottom")
      (speed 0)
      (speed-y 0.01)
      (image "/images/background/retro/arctis_skyline.png")
      (z-pos -220)
    )
    (background
      (color 0.3 0.4 0.7)
      (alignment "bottom")
      (speed 0.01)
      (image "/images/background/retro/arctis_icechunk.png")
      (z-pos -210)
    )
    (background
      (color 0.5 0.6 0.8)
      (alignment "bottom")
      (speed 0.5)
      (image "/images/background/retro/arctis_shore.png")
      (z-pos -200)
    )
    (background
      (color 0.3 0.4 0.6)
      (scroll-speed-x -2)
      (speed 0)
      (image "/images/background/misc/clouds.png")
      (z-pos -230)
    )
    (bonusblock
      (type "retro")
      (z-pos 51)
      (x 8288)
      (y 768)
    )
    (bonusblock
      (type "retro")
      (z-pos 51)
      (x 8384)
      (y 768)
    )
    (bonusblock
      (type "retro")
      (z-pos 51)
      (contents "retrogrow")
      (x 8480)
      (y 768)
    )
    (bonusblock
      (type "retro")
      (z-pos 51)
      (count 5)
      (sprite "/images/objects/bonus_block/retro_brick.sprite")
      (x 10016)
      (y 768)
    )
    (bonusblock
      (type "retro")
      (z-pos 51)
      (x 11296)
      (y 672)
    )
    (bonusblock
      (type "retro")
      (z-pos 51)
      (x 11328)
      (y 672)
    )
    (bonusblock
      (type "retro")
      (z-pos 51)
      (x 800)
      (y 544)
    )
    (bonusblock
      (type "retro")
      (z-pos 51)
      (contents "retrogrow")
      (x 2304)
      (y 544)
    )
    (bonusblock
      (type "retro")
      (z-pos 51)
      (x 928)
      (y 544)
    )
    (bonusblock
      (type "retro")
      (z-pos 51)
      (x 1056)
      (y 544)
    )
    (bonusblock
      (type "retro")
      (z-pos 51)
      (x 1184)
      (y 544)
    )
    (bonusblock
      (type "retro")
      (z-pos 51)
      (x 928)
      (y 416)
    )
    (bonusblock
      (type "retro")
      (z-pos 51)
      (x 992)
      (y 288)
    )
    (bonusblock
      (type "retro")
      (z-pos 51)
      (x 1056)
      (y 416)
    )
    (bonusblock
      (type "retro")
      (z-pos 51)
      (x 3680)
      (y 672)
    )
    (bonusblock
      (type "retro")
      (z-pos 51)
      (x 3712)
      (y 672)
    )
    (bonusblock
      (type "retro")
      (z-pos 51)
      (x 3744)
      (y 672)
    )
    (bonusblock
      (type "retro")
      (z-pos 51)
      (x 3968)
      (y 672)
    )
    (bonusblock
      (type "retro")
      (z-pos 51)
      (x 4000)
      (y 672)
    )
    (bonusblock
      (type "retro")
      (z-pos 51)
      (x 4032)
      (y 672)
    )
    (bonusblock
      (type "retro")
      (z-pos 51)
      (contents "retrogrow")
      (x 5888)
      (y 384)
    )
    (brick
      (type "retro")
      (z-pos 51)
      (x 9088)
      (y 672)
      (breakable #t)
    )
    (brick
      (type "retro")
      (z-pos 51)
      (x 9120)
      (y 672)
      (breakable #t)
    )
    (brick
      (type "retro")
      (z-pos 51)
      (x 9152)
      (y 672)
      (breakable #t)
    )
    (brick
      (type "retro")
      (z-pos 51)
      (x 9312)
      (y 672)
      (breakable #t)
    )
    (brick
      (type "retro")
      (z-pos 51)
      (x 9344)
      (y 672)
      (breakable #t)
    )
    (brick
      (type "retro")
      (z-pos 51)
      (x 9376)
      (y 672)
      (breakable #t)
    )
    (brick
      (type "retro")
      (z-pos 51)
      (x 9472)
      (y 736)
      (breakable #t)
    )
    (brick
      (type "retro")
      (z-pos 51)
      (x 9568)
      (y 672)
      (breakable #t)
    )
    (brick
      (type "retro")
      (z-pos 51)
      (x 9600)
      (y 672)
      (breakable #t)
    )
    (brick
      (type "retro")
      (z-pos 51)
      (x 9632)
      (y 672)
      (breakable #t)
    )
    (brick
      (type "retro")
      (z-pos 51)
      (x 10432)
      (y 768)
      (breakable #t)
    )
    (brick
      (type "retro")
      (z-pos 51)
      (x 10464)
      (y 768)
      (breakable #t)
    )
    (brick
      (type "retro")
      (z-pos 51)
      (x 10496)
      (y 768)
      (breakable #t)
    )
    (brick
      (type "retro")
      (z-pos 51)
      (x 10528)
      (y 768)
      (breakable #t)
    )
    (brick
      (type "retro")
      (z-pos 51)
      (x 10624)
      (y 672)
      (breakable #t)
    )
    (brick
      (type "retro")
      (z-pos 51)
      (x 10656)
      (y 672)
      (breakable #t)
    )
    (brick
      (type "retro")
      (z-pos 51)
      (x 10688)
      (y 672)
      (breakable #t)
    )
    (brick
      (type "retro")
      (z-pos 51)
      (x 10720)
      (y 672)
      (breakable #t)
    )
    (brick
      (type "retro")
      (z-pos 51)
      (x 10752)
      (y 672)
      (breakable #t)
    )
    (brick
      (type "retro")
      (z-pos 51)
      (x 10784)
      (y 672)
      (breakable #t)
    )
    (brick
      (type "retro")
      (z-pos 51)
      (x 10816)
      (y 672)
      (breakable #t)
    )
    (brick
      (type "retro")
      (z-pos 51)
      (x 8320)
      (y 768)
      (breakable #t)
    )
    (brick
      (type "retro")
      (z-pos 51)
      (x 8352)
      (y 768)
      (breakable #t)
    )
    (brick
      (type "retro")
      (z-pos 51)
      (x 8416)
      (y 768)
      (breakable #t)
    )
    (brick
      (type "retro")
      (z-pos 51)
      (x 8448)
      (y 768)
      (breakable #t)
    )
    (brick
      (type "retro")
      (z-pos 51)
      (x 8512)
      (y 768)
      (breakable #t)
    )
    (brick
      (type "retro")
      (z-pos 51)
      (x 8544)
      (y 768)
      (breakable #t)
    )
    (brick
      (type "retro")
      (z-pos 51)
      (x 8224)
      (y 768)
      (breakable #t)
    )
    (brick
      (type "retro")
      (z-pos 51)
      (x 8256)
      (y 768)
      (breakable #t)
    )
    (brick
      (type "retro")
      (z-pos 51)
      (x 7200)
      (y 672)
      (breakable #t)
    )
    (brick
      (type "retro")
      (z-pos 51)
      (x 7232)
      (y 672)
      (breakable #t)
    )
    (brick
      (type "retro")
      (z-pos 51)
      (x 7264)
      (y 672)
      (breakable #t)
    )
    (brick
      (type "retro")
      (z-pos 51)
      (x 7296)
      (y 672)
      (breakable #t)
    )
    (brick
      (type "retro")
      (z-pos 51)
      (x 7360)
      (y 768)
      (breakable #t)
    )
    (brick
      (type "retro")
      (z-pos 51)
      (x 7392)
      (y 768)
      (breakable #t)
    )
    (brick
      (type "retro")
      (z-pos 51)
      (x 7424)
      (y 768)
      (breakable #t)
    )
    (brick
      (type "retro")
      (z-pos 51)
      (x 7456)
      (y 768)
      (breakable #t)
    )
    (brick
      (type "retro")
      (z-pos 51)
      (x 6240)
      (y 512)
      (breakable #t)
    )
    (brick
      (type "retro")
      (z-pos 51)
      (x 6272)
      (y 512)
      (breakable #t)
    )
    (brick
      (type "retro")
      (z-pos 51)
      (x 6304)
      (y 512)
      (breakable #t)
    )
    (brick
      (type "retro")
      (z-pos 51)
      (x 6336)
      (y 512)
      (breakable #t)
    )
    (brick
      (type "retro")
      (z-pos 51)
      (x 6368)
      (y 512)
      (breakable #t)
    )
    (brick
      (type "retro")
      (z-pos 51)
      (x 6400)
      (y 512)
      (breakable #t)
    )
    (brick
      (type "retro")
      (z-pos 51)
      (x 6432)
      (y 512)
      (breakable #t)
    )
    (brick
      (type "retro")
      (z-pos 51)
      (x 6464)
      (y 512)
      (breakable #t)
    )
    (brick
      (type "retro")
      (z-pos 51)
      (x 6496)
      (y 512)
      (breakable #t)
    )
    (brick
      (type "retro")
      (z-pos 51)
      (x 6496)
      (y 480)
      (breakable #t)
    )
    (brick
      (type "retro")
      (z-pos 51)
      (x 6496)
      (y 448)
      (breakable #t)
    )
    (brick
      (type "retro")
      (z-pos 51)
      (x 6496)
      (y 416)
      (breakable #t)
    )
    (brick
      (type "retro")
      (z-pos 51)
      (x 6496)
      (y 384)
      (breakable #t)
    )
    (brick
      (type "retro")
      (z-pos 51)
      (x 6464)
      (y 384)
      (breakable #t)
    )
    (brick
      (type "retro")
      (z-pos 51)
      (x 6432)
      (y 384)
      (breakable #t)
    )
    (brick
      (type "retro")
      (z-pos 51)
      (x 6400)
      (y 384)
      (breakable #t)
    )
    (brick
      (type "retro")
      (z-pos 51)
      (x 6368)
      (y 384)
      (breakable #t)
    )
    (brick
      (type "retro")
      (z-pos 51)
      (x 6336)
      (y 384)
      (breakable #t)
    )
    (brick
      (type "retro")
      (z-pos 51)
      (x 6304)
      (y 384)
      (breakable #t)
    )
    (brick
      (type "retro")
      (z-pos 51)
      (x 6272)
      (y 384)
      (breakable #t)
    )
    (brick
      (type "retro")
      (z-pos 51)
      (x 6240)
      (y 384)
      (breakable #t)
    )
    (brick
      (type "retro")
      (z-pos 51)
      (x 6240)
      (y 416)
      (breakable #t)
    )
    (brick
      (type "retro")
      (z-pos 51)
      (x 6240)
      (y 448)
      (breakable #t)
    )
    (brick
      (type "retro")
      (z-pos 51)
      (x 6240)
      (y 480)
      (breakable #t)
    )
    (camera
      (name "Camera")
      (mode "normal")
    )
    (coin
      (type "retro")
      (z-pos 49)
      (x 12736)
      (y 512)
    )
    (coin
      (type "retro")
      (z-pos 49)
      (x 12768)
      (y 512)
    )
    (coin
      (type "retro")
      (z-pos 49)
      (x 12800)
      (y 512)
    )
    (coin
      (type "retro")
      (z-pos 49)
      (x 12832)
      (y 512)
    )
    (coin
      (type "retro")
      (z-pos 49)
      (x 9184)
      (y 544)
    )
    (coin
      (type "retro")
      (z-pos 49)
      (x 9216)
      (y 544)
    )
    (coin
      (type "retro")
      (z-pos 49)
      (x 9248)
      (y 544)
    )
    (coin
      (type "retro")
      (z-pos 49)
      (x 9280)
      (y 544)
    )
    (coin
      (type "retro")
      (z-pos 49)
      (x 10656)
      (y 576)
    )
    (coin
      (type "retro")
      (z-pos 49)
      (x 10688)
      (y 576)
    )
    (coin
      (type "retro")
      (z-pos 49)
      (x 10720)
      (y 576)
    )
    (coin
      (type "retro")
      (z-pos 49)
      (x 10752)
      (y 576)
    )
    (coin
      (type "retro")
      (z-pos 49)
      (x 10784)
      (y 576)
    )
    (coin
      (type "retro")
      (z-pos 49)
      (x 6272)
      (y 416)
    )
    (coin
      (type "retro")
      (z-pos 49)
      (x 6304)
      (y 416)
    )
    (coin
      (type "retro")
      (z-pos 49)
      (x 6336)
      (y 416)
    )
    (coin
      (type "retro")
      (z-pos 49)
      (x 6368)
      (y 416)
    )
    (coin
      (type "retro")
      (z-pos 49)
      (x 6400)
      (y 416)
    )
    (coin
      (type "retro")
      (z-pos 49)
      (x 6432)
      (y 416)
    )
    (coin
      (type "retro")
      (z-pos 49)
      (x 6464)
      (y 416)
    )
    (coin
      (type "retro")
      (z-pos 49)
      (x 6272)
      (y 448)
    )
    (coin
      (type "retro")
      (z-pos 49)
      (x 6304)
      (y 448)
    )
    (coin
      (type "retro")
      (z-pos 49)
      (x 6336)
      (y 448)
    )
    (coin
      (type "retro")
      (z-pos 49)
      (x 6368)
      (y 448)
    )
    (coin
      (type "retro")
      (z-pos 49)
      (x 6400)
      (y 448)
    )
    (coin
      (type "retro")
      (z-pos 49)
      (x 6432)
      (y 448)
    )
    (coin
      (type "retro")
      (z-pos 49)
      (x 6464)
      (y 448)
    )
    (coin
      (type "retro")
      (z-pos 49)
      (x 6272)
      (y 480)
    )
    (coin
      (type "retro")
      (z-pos 49)
      (x 6304)
      (y 480)
    )
    (coin
      (type "retro")
      (z-pos 49)
      (x 6336)
      (y 480)
    )
    (coin
      (type "retro")
      (z-pos 49)
      (x 6368)
      (y 480)
    )
    (coin
      (type "retro")
      (z-pos 49)
      (x 6400)
      (y 480)
    )
    (coin
      (type "retro")
      (z-pos 49)
      (x 6432)
      (y 480)
    )
    (coin
      (type "retro")
      (z-pos 49)
      (x 6464)
      (y 480)
    )
    (coin
      (type "retro")
      (z-pos 49)
      (x 4896)
      (y 608)
    )
    (coin
      (type "retro")
      (z-pos 49)
      (x 4928)
      (y 608)
    )
    (coin
      (type "retro")
      (z-pos 49)
      (x 4960)
      (y 608)
    )
    (coin
      (type "retro")
      (z-pos 49)
      (x 4992)
      (y 608)
    )
    (coin
      (type "retro")
      (z-pos 49)
      (x 5024)
      (y 608)
    )
    (coin
      (type "retro")
      (z-pos 49)
      (x 5056)
      (y 608)
    )
    (decal
      (z-pos -110)
      (sprite "/images/decal/misc/flag.sprite")
      (x 13504)
      (y 576)
    )
    (gradient
      (top_color 0 0 0)
      (bottom_color 0 0 0.5)
    )
    (jumpy
      (type "bag")
      (z-pos 50)
      (x 12320)
      (y 640)
    )
    (jumpy
      (type "bag")
      (z-pos 50)
      (x 12544)
      (y 544)
    )
    (jumpy
      (type "bag")
      (z-pos 50)
      (x 9472)
      (y 608)
    )
    (jumpy
      (type "bag")
      (z-pos 50)
      (x 576)
      (y 544)
    )
    (jumpy
      (type "bag")
      (z-pos 50)
      (x 2096)
      (y 480)
    )
    (jumpy
      (type "bag")
      (z-pos 50)
      (x 4256)
      (y 640)
    )
    (jumpy
      (type "bag")
      (z-pos 50)
      (x 5568)
      (y 576)
    )
    (jumpy
      (type "bag")
      (z-pos 50)
      (x 5696)
      (y 544)
    )
    (jumpy
      (type "bag")
      (z-pos 50)
      (x 5824)
      (y 512)
    )
    (leveltime
      (time 255)
    )
    (mriceblock
      (type "laptop")
      (z-pos 50)
      (direction "left")
      (x 7904)
      (y 864)
    )
    (mriceblock
      (type "laptop")
      (z-pos 50)
      (direction "left")
      (x 10016)
      (y 864)
    )
    (mriceblock
      (type "laptop")
      (z-pos 50)
      (x 1680)
      (y 576)
    )
    (mriceblock
      (type "laptop")
      (z-pos 50)
      (x 1984)
      (y 640)
    )
    (mriceblock
      (type "laptop")
      (z-pos 50)
      (x 2848)
      (y 640)
    )
    (music
      (file "/music/retro/ice_music.music")
    )
    (sequencetrigger
      (sequence "endsequence")
      (width 32)
      (height 1216)
      (x 13248)
      (y -320)
    )
    (sequencetrigger
      (sequence "stoptux")
      (width 32)
      (height 1216)
      (x 13568)
      (y -320)
    )
    (snowball
      (type "bsod")
      (z-pos 50)
      (direction "left")
      (x 8416)
      (y 864)
    )
    (snowball
      (type "bsod")
      (z-pos 50)
      (direction "left")
      (x 8608)
      (y 864)
    )
    (snowball
      (type "bsod")
      (z-pos 50)
      (direction "left")
      (x 10784)
      (y 864)
    )
    (snowball
      (type "bsod")
      (z-pos 50)
      (x 1120)
      (y 640)
    )
    (snowball
      (type "bsod")
      (z-pos 50)
      (x 1216)
      (y 640)
    )
    (snowball
      (type "bsod")
      (z-pos 50)
      (x 3552)
      (y 768)
    )
    (snowball
      (type "bsod")
      (z-pos 50)
      (x 3712)
      (y 768)
    )
    (snowball
      (type "bsod")
      (z-pos 50)
      (x 3776)
      (y 768)
    )
    (snowball
      (type "bsod")
      (z-pos 50)
      (x 3488)
      (y 768)
    )
    (snowball
      (type "bsod")
      (z-pos 50)
      (x 6432)
      (y 640)
    )
    (spawnpoint
      (name "main")
      (x 96)
      (y 608)
    )
    (tilemap
      (solid #f)
      (z-pos -100)
      (name "Background")
      (width 430)
      (height 35)
      (tiles -3067 0 85 86 87 88 -426 0 89 90 91 92 -411 0 85 86 87 88 -142 0 85 86 87 88 -248 0 85 86 87 88 -28 0 89 90 91 92 -116 0 85 86 87 88 -22 0 89 90 91 92 -31 0 85 86 87 88 -213 0 89 90 91 92 -60 0 85 86 87 88 -75 0 85 86 87 88 -5 0 89 90 91 92 -57 0 89 90 91 92 -277 0 89 90 91 92 -75 0 89 90 91 92 -54 0 85 86 87 88 -74 0 85 86 87 88 -236 0 85 86 87 88 -21 0 85 86 87 88 -83 0 89 90 91 92 -74 0 89 90 91 92 -33 0 85 86 87 88 -199 0 89 90 91 92 -21 0 89 90 91 92 -115 0 85 86 87 88 -6 0 85 86 87 88 -55 0 85 86 87 88 -10 0 89 90 91 92 -57 0 85 86 87 88 -11 0 85 86 87 88 -132 0 85 86 87 88 -131 0 89 90 91 92 -6 0 89 90 91 92 -55 0 89 90 91 92 -41 0 85 86 87 88 -26 0 89 90 91 92 -11 0 89 90 91 92 -7 0 85 86 87 88 -121 0 89 90 91 92 -165 0 85 86 87 88 -76 0 89 90 91 92 -20 0 85 86 87 88 -28 0 89 90 91 92 -240 0 85 86 87 88 -46 0 89 90 91 92 -100 0 89 90 91 92 -38 0 80 -233 0 89 90 91 92 -192 0 79 -11 0 93 94 95 96 -35 0 93 94 95 96 -36 0 93 94 95 96 -111 0 93 94 95 96 -220 0 79 0 85 86 87 88 -6 0 97 98 99 100 -6 0 93 94 95 96 -25 0 97 98 99 100 -36 0 97 98 99 100 -111 0 97 98 99 100 -220 0 79 0 89 90 91 92 -424 0 79 -149 0 93 94 95 96 -276 0 79 -122 0 93 94 95 96 -303 0 79 -110 0 93 94 95 96 -8 0 97 98 99 100 -303 0 79 -429 0 79 -270 0 93 94 95 96 -30 0 93 94 95 96 -27 0 93 94 95 96 -90 0 79 -270 0 97 98 99 100 -22 0 93 94 95 96 -4 0 97 98 99 100 -27 0 97 98 99 100 -75 0 93 94 95 96 -11 0 79 -3016 0)
    )
    (tilemap
      (solid #f)
      (z-pos 100)
      (name "Foreground")
      (width 430)
      (height 35)
      (tiles -15050 0)
    )
    (tilemap
      (solid #t)
      (z-pos 0)
      (name "Interactive")
      (width 430)
      (height 35)
      (tiles -6633 0 4100 4102 4101 -423 0 4100 4102 4101 0 4157 4001 4169 4101 -308 0 4100 4101 -11 0 -3 44 -94 0 4100 4102 4101 0 4157 4001 4158 0 4161 4000 4164 4169 4101 -210 0 4100 -2 4102 4101 -80 0 4100 4101 -11 0 4157 4158 -11 0 -3 44 -90 0 4100 4102 4101 0 4157 4001 4158 0 4161 4000 4162 0 4161 -2 4000 4164 4169 4101 -207 0 4100 4102 4168 4002 4003 4158 -80 0 4157 4158 -11 0 4161 4162 -11 0 4100 4102 4101 -90 0 4157 4001 4158 0 4161 4000 4162 0 4161 4000 4162 0 4161 -3 4000 4164 4169 4101 -204 0 4100 4102 4168 4003 4163 -2 4000 4160 4101 -27 0 -52 4102 4159 4160 -11 4102 4159 4160 -11 4102 4168 4002 4169 -9 4102 4101 -62 0 4100 -4 4102 4101 -4 0 4100 -7 4102 4159 4000 4160 4102 4159 4000 4160 4102 4159 4000 4160 4102 4159 -4 4000 4164 4169 -16 4102 4101 -73 0 4100 4101 -110 0 4100 4102 4168 4001 4163 -4 4000 4164 4158 -27 0 -3 4001 4002 4001 4002 4001 4003 -10 4001 4002 4001 4003 -3 4001 4002 -2 4001 4002 -2 4001 4002 -2 4003 4002 -3 4001 4003 4002 -3 4001 4002 -8 4001 4002 4163 4164 -2 4003 -4 4001 -2 4002 -3 4001 4163 4164 -11 4001 4163 4000 4164 4001 4002 4001 4002 -3 4001 4002 4001 4158 -62 0 4157 4002 4003 4001 4002 4158 -4 0 4157 4002 -2 4001 4002 4001 4002 4001 4163 4000 4164 4002 4163 4000 4164 4003 4163 4000 4164 4001 4163 -5 4000 4164 4002 4001 -2 4003 4001 4003 -10 4001 4169 -5 4102 4101 -67 0 4181 4182 -108 0 4100 4102 4168 4003 4163 -7 4000 4162 -27 0 -12 4000 4078 -77 4000 4160 -2 4102 4101 -44 0 4100 -10 4102 4101 -3 0 4161 -4 4000 4162 -4 0 4161 -8 4000 4078 -5 4000 4078 -27 4000 4164 4003 -2 4001 4002 4001 4169 -2 4102 4101 -61 0 4100 4101 -109 0 4100 4102 4168 4001 4163 -9 4000 4162 -27 0 -82 4000 4078 -7 4000 4164 -2 4001 4158 -38 0 4100 4102 4101 -3 0 4157 -3 4001 -2 4003 4001 4002 4001 -2 4002 4158 -3 0 4161 -4 4000 4162 -4 0 4161 -48 4000 4164 -2 4001 4169 -3 4102 4101 -57 0 4181 4182 -30 0 4100 4101 -5 0 4100 4101 -67 0 4100 -2 4102 4168 4001 4163 -11 4000 4162 -27 0 -93 4000 4162 -5 0 4100 -28 4102 4101 -3 0 4157 4002 4158 -3 0 4161 -10 4000 4162 -3 0 4161 -2 4000 4078 4000 4162 -4 0 4161 -51 4000 4164 4003 -2 4001 4169 4102 4101 -52 0 4100 4101 -32 0 4100 4168 4158 -5 0 4157 4169 4101 -33 0 4100 -2 4102 4101 -28 0 4100 4168 4001 4002 4163 -7 4000 4078 -5 4000 4162 -27 0 -93 4000 4162 -5 0 4157 -2 4001 -2 4002 4001 -2 4002 -10 4001 4003 -2 4001 4002 4001 4003 -5 4001 4158 -3 0 4161 4000 4162 -3 0 4161 -10 4000 4162 -3 0 4161 -2 4000 4078 4000 4162 -4 0 4161 -55 4000 4164 4001 4158 -29 0 4100 4101 -21 0 4181 4182 -31 0 4100 4168 4163 4162 -5 0 4161 4164 4169 4101 -26 0 4100 -2 4102 4101 -2 0 4181 -2 4170 4182 -2 0 4100 -2 4102 4101 -20 0 4100 4102 4168 4163 -16 4000 4160 4101 -26 0 -32 4000 4078 -60 4000 4162 -5 0 4103 4079 4166 -22 4000 4167 -3 4079 4165 -3 0 4161 4000 4162 -3 0 4161 -10 4000 4162 -3 0 4161 -4 4000 4162 -4 0 4161 4000 4078 -55 4000 4162 -29 0 4157 4158 -53 0 4100 4168 4163 4000 4162 -5 0 4161 4000 4164 4169 4101 -25 0 4181 4171 4170 4182 -8 0 4181 4171 4170 4182 -18 0 4100 4102 4168 4001 4163 -17 4000 4164 4158 -26 0 -27 4000 4078 -65 4000 4162 -7 0 4103 4080 4166 -19 4000 4167 4165 -7 0 4161 4000 4162 -3 0 4161 -10 4000 4162 -3 0 4161 -4 4000 4162 -4 0 4161 -38 4000 4078 -18 4000 4160 -2 4102 4101 -9 0 4100 -16 4102 4159 4160 -22 4102 4101 -7 0 4100 -22 4102 4168 4163 -2 4000 4160 -5 4102 4159 -2 4000 4164 4169 -22 4102 4101 -20 0 4100 -15 4102 4168 4001 4163 -20 4000 4160 -20 4102 4101 -5 0 -93 4000 4162 -9 0 4161 -5 4000 4167 4080 -3 4079 4081 -2 4079 4166 -5 4000 4162 -8 0 4161 4000 4162 -3 0 4161 -10 4000 4162 -3 0 4161 -4 4000 4162 -4 0 4161 -57 4000 4164 -2 4001 4158 -9 0 4157 -2 4001 4003 4001 -3 4002 -2 4001 4002 4001 4002 4001 4002 4001 4002 4163 4164 -3 4001 4002 -3 4001 4002 -2 4001 4003 4002 4003 -4 4001 4002 4001 4002 4001 4003 4158 -7 0 4157 -9 4001 4002 4003 -3 4001 -2 4003 -6 4001 4163 -3 4000 4164 4002 4001 4002 4001 4003 4163 -3 4000 4164 -3 4002 4001 4002 -6 4001 4002 -6 4001 4002 4001 -2 4002 4158 -20 0 4157 -3 4001 4002 -2 4001 -8 4002 4003 4163 -22 4000 4164 -2 4001 4002 -3 4001 -2 4002 -2 4001 4003 4001 4003 4001 4003 4001 4002 -2 4001 4003 4158 -5 0 -93 4000 4162 -9 0 4161 -4 4000 4167 4165 -7 0 4103 4166 -4 4000 4162 -8 0 4161 4000 4162 -3 0 4161 -10 4000 4162 -3 0 4161 -4 4000 4162 -4 0 4161 -58 4000 4078 4000 4162 -9 0 4103 4166 -34 4000 4167 -4 4079 4165 -7 0 4103 4166 -56 4000 4167 4080 4165 -20 0 4103 -2 4079 4166 -54 4000 4167 4079 4165 -5 0 -22 4000 4078 -70 4000 4162 -9 0 4161 -4 4000 4162 -9 0 4161 -4 4000 4162 -8 0 4161 4000 4162 -3 0 4161 -10 4000 4162 -3 0 4161 -4 4000 4162 -4 0 4161 -60 4000 4162 -10 0 4103 -2 4079 4166 -30 4000 4167 4165 -13 0 4103 -3 4079 4166 -10 4000 4078 -40 4000 4167 4165 -25 0 4103 4166 -52 4000 4167 4165 -7 0 -93 4000 4162 -9 0 4161 -4 4000 4162 -9 0 4161 -4 4000 4162 -8 0 4161 4000 4162 -3 0 4161 -10 4000 4162 -3 0 4161 -4 4000 4162 -4 0 4161 -60 4000 4162 -13 0 4161 -6 4000 4167 -16 4079 4166 -6 4000 4162 -18 0 4161 -10 4000 4167 -28 4079 4166 -11 4000 4162 -27 0 4161 -52 4000 4162 -8 0 -32 4000 4078 -60 4000 4162 -9 0 4161 -4 4000 4162 -9 0 4161 -4 4000 4162 -8 0 4161 4000 4162 -3 0 4161 -10 4000 4162 -3 0 4161 -4 4000 4162 -4 0 4161 -60 4000 4162 -13 0 4161 -5 4000 4167 4165 -16 0 4103 4166 -5 4000 4162 -18 0 4161 -9 4000 4167 4165 -28 0 4103 4166 -10 4000 4162 -27 0 4161 -52 4000 4162 -8 0 -51 4000 4078 -41 4000 4162 -9 0 4161 -4 4000 4162 -9 0 4161 -4 4000 4162 -8 0 4161 4000 4162 -3 0 4161 -10 4000 4162 -3 0 4161 -4 4000 4162 -4 0 4161 -12 4000 4078 -47 4000 4162 -13 0 4161 -5 4000 4162 -18 0 4161 4000 4078 -3 4000 4162 -18 0 4161 -9 4000 4162 -30 0 4161 -10 4000 4162 -27 0 4161 -50 4000 4078 4000 4162 -8 0 -8 4000 4078 -84 4000 4162 -9 0 4161 -4 4000 4162 -9 0 4161 -4 4000 4162 -8 0 4161 4000 4162 -3 0 4161 -10 4000 4162 -3 0 4161 -4 4000 4162 -4 0 4161 -19 4000 4078 -40 4000 4162 -13 0 4161 -5 4000 4162 -18 0 4161 -5 4000 4162 -18 0 4161 -9 4000 4162 -30 0 4161 -10 4000 4162 -27 0 4161 -52 4000 4162 -8 0)
    )
    (tilemap
      (solid #t)
      (z-pos -101)
      (width 430)
      (height 35)
      (tiles -12464 0 2019 2140 2141 2142 2019 2140 -270 0 2019 2140 2141 2142 2019 2140 2141 2142 2019 2140 2141 2142 2019 2140 2141 -56 0 2019 2140 2141 2142 2019 2140 2141 2142 2019 2140 2141 2142 2019 2140 2141 2142 2019 2140 2141 2142 2019 2140 2141 2142 2019 2140 2141 -54 0 -8 2020 -224 0 2019 2140 2141 2142 2019 2140 2141 2142 2019 2140 2019 2140 2141 2142 2019 -30 0 -20 2020 -51 0 -29 2020 -52 0 -9 2020 -224 0 -15 2020 -6 0 -18 2020 -6 0 -20 2020 -10 0 -30 2020 -11 0 -29 2020 -52 0 -9 2020 -224 0 -15 2020 -5 0 -20 2020 -5 0 -20 2020 -9 0 -32 2020 -10 0 -29 2020 -52 0 -9 2020 -224 0 -15 2020 -5 0 -20 2020 -5 0 -20 2020 -9 0 -32 2020 -10 0 -29 2020 -52 0 -9 2020 -224 0 -15 2020 -5 0 -20 2020 -5 0 -20 2020 -9 0 -32 2020 -10 0 -29 2020 -52 0 -9 2020)
    )
  )
)
