(supertux-level
  (version 3)
  (name (_ "Where Is Everyone?"))
  (author "Carsten Wirtz")
  (license "CC-BY-SA 4.0 International")
  (suppress-pause-menu #t)
  (icon "")
  (icon-locked "")
  (sector
    (name "main")
    (init-script "Tux.deactivate();")
    (ambient-light
      (color 0.9 0.86 0.85)
    )
    (background
      (color 1 1 1)
      (speed 0)
      (fill #t)
      (image "/images/background/misc/vignette.png")
      (z-pos 200)
    )
    (camera
      (name "Camera")
      (mode "manual")
    )
    (decal
      (solid #t)
      (action "big-idle-right")
      (z-pos 50)
      (sprite "/images/creatures/tux/tux.sprite")
      (x 800)
      (y 448)
    )
    (gradient
      (top_color 0 0 0)
      (bottom_color 1 0 0)
    )
    (music
      (file "/music/retro/theme_old.music")
    )
    (spawnpoint
      (name "main")
      (x 144)
      (y 672)
    )
    (textscroller
      (file "/levels/revenge_in_redmond/outro.txt")
      (speed 40)
      (x-offset 0)
    )
    (tilemap
      (solid #f)
      (z-pos -100)
      (width 45)
      (height 25)
      (tiles
      0 0 0 0 0 0 0 0 0 0 0 0 0 0 0 0 0 0 0 0 0 0 0 0 0 0 0 0 0 0 0 0 0 0 0 0 0 0 0 0 0 0 0 0 0
      0 0 0 0 0 0 0 0 0 0 0 0 0 0 0 0 0 0 0 0 0 0 0 0 0 0 0 0 0 0 0 0 0 0 0 0 0 0 0 0 0 0 0 0 0
      0 0 0 0 0 0 0 0 0 0 0 0 0 0 0 0 0 0 0 0 0 0 0 0 0 0 0 0 0 0 0 0 0 0 0 0 0 0 0 0 0 0 0 0 0
      0 0 0 0 0 0 0 0 0 0 0 0 0 0 0 0 0 0 0 0 0 0 0 0 0 0 0 0 0 0 0 0 0 0 0 0 0 0 0 0 0 0 0 0 0
      0 0 0 0 0 0 0 0 0 0 0 0 0 0 0 0 0 0 0 0 0 0 0 0 0 0 0 0 0 0 0 0 0 0 0 0 0 0 0 0 0 0 0 0 0
      0 0 0 0 0 0 0 0 0 0 0 0 0 0 0 0 0 0 0 0 0 0 0 0 0 0 0 0 0 0 0 0 0 0 0 0 0 0 0 0 0 0 0 0 0
      0 0 0 0 0 0 0 0 0 0 0 0 0 0 0 0 0 0 0 0 0 0 0 0 0 0 0 0 0 0 0 0 0 0 0 0 0 0 0 0 0 0 0 0 0
      0 0 0 0 0 0 0 0 0 0 0 0 0 0 0 0 0 0 0 0 0 0 0 0 0 0 0 0 0 0 0 0 0 0 0 0 0 0 0 0 0 0 0 0 0
      0 0 5144 3277 5146 5144 3277 5146 5144 3277 5146 5144 3277 5146 5144 3277 5146 5144 3277 5146 5144 3277 5146 5144 3277 5146 5144 3277 5146 5144 3277 5146 5144 3277 5146 0 0 0 0 0 0 0 0 0 0
      0 0 5144 3277 5146 5144 3277 5146 5144 3277 5146 5144 3277 5146 5144 3277 5146 5144 3277 5146 5144 3277 5146 5144 3277 5146 5144 3277 5146 5144 3277 5146 5144 3277 5146 0 0 0 0 0 0 0 0 0 0
      0 0 5144 3277 5146 5144 3277 5146 5144 3277 5146 5144 3277 5146 5144 3277 5146 5144 3277 5146 5144 3277 5146 5144 3277 5146 5144 3277 5146 5144 3277 5146 5144 3277 5146 0 0 0 3280 3277 3277 3277 3277 3277 3277
      0 0 5144 3277 5146 5144 3277 5146 5144 3277 5146 5144 3277 5146 5144 3277 5146 5144 3277 5146 5144 3277 5146 5144 3277 5146 5144 3277 5146 5144 3277 5146 5144 3277 5146 0 0 0 3280 3277 3277 3277 3277 3277 3277
      0 0 5144 3277 5146 5144 3277 5146 5144 3277 5146 5144 3277 5146 5144 3277 5146 5144 3277 5146 5144 3277 5146 5144 3277 5146 5144 3277 5146 5144 3277 5146 5144 3277 5146 0 0 0 3280 3277 3277 3277 3277 3277 3277
      0 0 5144 3277 5146 5144 3277 5146 5144 3277 5146 5144 3277 5146 5144 3277 5146 5144 3277 5146 5144 3277 5146 5144 3277 5146 5144 3277 5146 5144 3277 5146 5144 3277 5146 0 0 0 0 0 0 0 0 0 0
      0 0 5144 3277 5146 5144 3277 5146 5144 3277 5146 5144 3277 5146 5144 3277 5146 5144 3277 5146 5144 3277 5146 5144 3277 5146 5144 3277 5146 5144 3277 5146 5144 3277 5146 0 0 0 0 0 0 0 0 0 0
      0 0 5144 3277 5146 5144 3277 5146 5144 3277 5146 5144 3277 5146 5144 3277 5146 5144 3277 5146 5144 3277 5146 5144 3277 5146 5144 3277 5146 5144 3277 5146 5144 3277 5146 0 0 0 0 0 0 0 0 0 0
      0 0 0 0 0 0 0 0 0 0 0 0 0 0 0 0 0 0 0 0 0 0 0 0 0 0 0 0 0 0 0 0 0 0 0 0 0 0 0 0 0 0 0 0 0
      0 0 0 0 0 0 0 0 0 0 0 0 0 0 0 0 0 0 0 0 0 0 0 0 0 0 0 0 0 0 0 0 0 0 0 0 0 0 0 0 0 0 0 0 0
      0 0 0 0 0 0 0 0 0 0 0 0 0 0 0 0 0 0 0 0 0 0 0 0 0 0 0 0 0 0 0 0 0 0 0 0 0 0 0 0 0 0 0 0 0
      0 0 0 0 0 0 0 0 0 0 0 0 0 0 0 0 0 0 0 0 0 0 0 0 0 0 0 0 0 0 0 0 0 0 0 0 0 0 0 0 0 0 0 0 0
      0 0 0 0 0 0 0 0 0 0 0 0 0 0 0 0 0 0 0 0 0 0 0 0 0 0 0 0 0 0 0 0 0 0 0 0 0 0 0 0 0 0 0 0 0
      0 0 0 0 0 0 0 0 0 0 0 0 0 0 0 0 0 0 0 0 0 0 0 0 0 0 0 0 0 0 0 0 0 0 0 0 0 0 0 0 0 0 0 0 0
      0 0 0 0 0 0 0 0 0 0 0 0 0 0 0 0 0 0 0 0 0 0 0 0 0 0 0 0 0 0 0 0 0 0 0 0 0 0 0 0 0 0 0 0 0
      0 0 0 0 0 0 0 0 0 0 0 0 0 0 0 0 0 0 0 0 0 0 0 0 0 0 0 0 0 0 0 0 0 0 0 0 0 0 0 0 0 0 0 0 0
      0 0 0 0 0 0 0 0 0 0 0 0 0 0 0 0 0 0 0 0 0 0 0 0 0 0 0 0 0 0 0 0 0 0 0 0 0 0 0 0 0 0 0 0 0
      )
    )
    (tilemap
      (solid #f)
      (z-pos 100)
      (width 45)
      (height 25)
      (tiles
      0 0 0 0 0 0 0 0 0 0 0 0 0 0 0 0 0 0 0 0 0 0 0 0 0 0 0 0 0 0 0 0 0 0 0 0 0 0 0 0 0 0 0 0 0
      0 0 0 0 0 0 0 0 0 0 0 0 0 0 0 0 0 0 0 0 0 0 0 0 0 0 0 0 0 0 0 0 0 0 0 0 0 0 0 0 0 0 0 0 0
      0 0 0 0 0 0 0 0 0 0 0 0 0 0 0 0 0 0 0 0 0 0 0 0 0 0 0 0 0 0 0 0 0 0 0 0 0 0 0 0 0 0 0 0 0
      0 0 0 0 0 0 0 0 0 0 0 0 0 0 0 0 0 0 0 0 0 0 0 0 0 0 0 0 0 0 0 0 0 0 0 0 0 0 0 0 0 0 0 0 0
      0 0 0 0 0 0 0 0 0 0 0 0 0 0 0 0 0 0 0 0 0 0 0 0 0 0 0 0 0 0 0 0 0 0 0 0 0 0 0 0 0 0 0 0 0
      0 0 0 0 0 0 0 0 0 0 0 0 0 0 0 0 0 0 0 0 0 0 0 0 0 0 0 0 0 0 0 0 0 0 0 0 0 0 0 0 0 0 0 0 0
      0 0 0 0 0 0 0 0 0 0 0 0 0 0 0 0 0 0 0 0 0 0 0 0 0 0 0 0 0 0 0 0 0 0 0 0 0 0 0 0 0 0 0 0 0
      0 0 0 0 0 0 0 0 0 0 0 0 0 0 0 0 0 0 0 0 0 0 0 0 0 0 0 0 0 0 0 0 0 0 0 0 0 0 0 0 0 0 0 0 0
      0 0 0 0 0 0 0 0 0 0 0 0 0 0 0 0 0 0 0 0 0 0 0 0 0 0 0 0 0 0 0 0 0 0 0 0 0 0 0 0 0 0 0 0 0
      0 0 0 0 0 0 0 0 0 0 0 0 0 0 0 0 0 0 0 0 0 0 0 0 0 0 0 0 0 0 0 0 0 0 0 0 0 0 0 0 0 0 0 0 0
      0 0 0 0 0 0 0 0 0 0 0 0 0 0 0 0 0 0 0 0 0 0 0 0 0 0 0 0 0 0 0 0 0 0 0 0 0 0 0 0 0 0 0 0 0
      0 0 0 0 0 0 0 0 0 0 0 0 0 0 0 0 0 0 0 0 0 0 0 0 0 0 0 0 0 0 0 0 0 0 0 0 0 0 0 0 0 0 0 0 0
      0 0 0 0 0 0 0 0 0 0 0 0 0 0 0 0 0 0 0 0 0 0 0 0 0 0 0 0 0 0 0 0 0 0 0 0 0 0 0 0 0 0 0 0 0
      0 0 0 0 0 0 0 0 0 0 0 0 0 0 0 0 0 0 0 0 0 0 0 0 0 0 0 0 0 0 0 0 0 0 0 0 0 0 0 0 0 0 0 0 0
      0 0 0 0 0 0 0 0 0 0 0 0 0 0 0 0 0 0 0 0 0 0 0 0 0 0 0 0 0 0 0 0 0 0 0 0 0 0 0 0 0 0 0 0 0
      0 0 0 0 0 0 0 0 0 0 0 0 0 0 0 0 0 0 0 0 0 0 0 0 0 0 0 0 0 0 0 0 0 0 0 0 0 0 0 0 0 0 0 0 0
      0 0 0 0 0 0 0 0 0 0 0 0 0 0 0 0 0 0 0 0 0 0 0 0 0 0 0 0 0 0 0 0 0 0 0 0 0 0 0 0 0 0 0 0 0
      0 0 0 0 0 0 0 0 0 0 0 0 0 0 0 0 0 0 0 0 0 0 0 0 0 0 0 0 0 0 0 0 0 0 0 0 0 0 0 0 0 0 0 0 0
      0 0 0 0 0 0 0 0 0 0 0 0 0 0 0 0 0 0 0 0 0 0 0 0 0 0 0 0 0 0 0 0 0 0 0 0 0 0 0 0 0 0 0 0 0
      0 0 0 0 0 0 0 0 0 0 0 0 0 0 0 0 0 0 0 0 0 0 0 0 0 0 0 0 0 0 0 0 0 0 0 0 0 0 0 0 0 0 0 0 0
      0 0 0 64 64 64 64 0 0 0 0 0 0 0 0 0 0 0 0 0 0 0 0 0 0 0 0 0 0 0 0 0 0 0 0 0 0 0 0 0 0 0 0 0 0
      0 0 0 64 64 64 64 0 0 0 0 0 0 0 0 0 0 0 0 0 0 0 0 0 0 0 0 0 0 0 0 0 0 0 0 0 0 0 0 0 0 0 0 0 0
      0 0 0 64 64 64 64 0 0 0 0 0 0 0 0 0 0 0 0 0 0 0 0 0 0 0 0 0 0 0 0 0 0 0 0 0 0 0 0 0 0 0 0 0 0
      0 0 0 64 64 64 64 0 0 0 0 0 0 0 0 0 0 0 0 0 0 0 0 0 0 0 0 0 0 0 0 0 0 0 0 0 0 0 0 0 0 0 0 0 0
      0 0 0 0 0 0 0 0 0 0 0 0 0 0 0 0 0 0 0 0 0 0 0 0 0 0 0 0 0 0 0 0 0 0 0 0 0 0 0 0 0 0 0 0 0
      )
    )
    (tilemap
      (solid #t)
      (z-pos 0)
      (width 45)
      (height 25)
      (tiles
      64 64 64 64 64 64 64 64 64 64 64 64 64 64 64 64 64 64 64 64 64 64 64 64 64 64 64 64 64 64 64 64 64 64 64 64 64 64 64 64 64 64 64 64 64
      64 64 64 64 64 64 64 64 64 64 64 64 64 64 64 64 64 64 64 64 64 64 64 64 64 64 64 64 64 64 64 64 64 64 64 64 64 64 64 64 64 64 64 64 64
      64 64 64 64 64 64 64 64 64 64 64 64 64 64 64 64 64 64 64 64 64 64 64 64 64 64 64 64 64 64 64 64 64 64 64 64 64 64 64 64 64 64 64 64 64
      64 64 64 64 64 64 64 64 64 64 64 64 64 64 64 64 64 64 64 64 64 64 64 64 64 64 64 64 64 64 64 64 64 64 64 64 64 64 64 64 64 64 64 64 64
      64 64 64 64 64 64 64 64 64 64 64 64 64 64 64 64 64 64 64 64 64 64 64 64 64 64 64 64 64 64 64 64 64 64 64 64 64 64 64 64 64 64 64 64 64
      64 64 64 64 64 64 64 64 64 64 64 64 64 64 64 64 64 64 64 64 64 64 64 64 64 64 64 64 64 64 64 64 64 64 64 64 64 64 64 64 64 64 64 64 64
      64 64 64 64 64 64 64 64 64 64 64 64 64 64 64 64 64 64 64 64 64 64 64 64 64 64 64 64 64 64 64 64 64 64 64 64 64 64 64 64 64 64 64 64 64
      66 66 66 66 66 66 66 66 66 66 66 66 66 66 66 66 66 66 66 66 66 66 66 66 66 66 66 66 66 66 66 66 66 66 66 66 66 3519 64 64 64 64 64 64 64
      0 0 0 0 0 0 0 0 0 0 0 0 0 0 0 0 0 0 0 0 0 0 0 0 0 0 0 0 0 0 0 0 0 0 0 0 0 5128 64 64 64 64 64 64 64
      0 0 0 0 0 0 0 0 0 0 0 0 0 0 0 0 0 0 0 0 0 0 0 0 0 0 0 0 0 0 0 0 0 0 0 0 0 67 66 66 66 66 66 66 66
      0 0 0 0 0 0 0 0 0 0 0 0 0 0 0 0 0 0 0 0 0 0 0 0 0 0 0 0 0 0 0 0 0 0 0 0 0 0 0 0 0 0 0 0 0
      0 0 0 0 0 0 0 0 0 0 0 0 0 0 0 0 0 0 0 0 0 0 0 0 0 0 0 0 0 0 0 0 0 0 0 0 0 0 0 0 0 0 0 0 0
      0 0 0 0 0 0 0 0 0 0 0 0 0 0 0 0 0 0 0 0 0 0 0 0 0 0 0 0 0 0 0 0 0 0 0 0 0 0 0 0 0 0 0 0 0
      0 0 0 0 0 0 0 0 0 0 0 0 0 0 0 0 1809 1812 0 0 0 0 1809 1812 0 0 0 0 1809 1812 0 0 0 0 0 0 68 65 65 65 65 65 65 65 65
      0 0 0 0 0 0 0 0 0 0 0 0 0 0 0 0 1810 1813 0 0 0 0 1810 1813 0 0 0 0 1810 1813 0 0 0 0 0 0 5128 64 64 64 64 64 64 64 64
      0 0 0 0 0 0 0 0 0 0 0 0 0 0 0 0 1811 1814 0 0 0 0 1811 1814 0 0 0 0 1811 1814 0 0 0 0 0 0 5128 64 64 64 64 64 64 64 64
      65 65 65 65 65 65 65 65 65 65 65 65 65 65 65 65 65 65 65 65 65 65 65 65 65 65 65 65 65 65 65 65 65 65 65 65 64 64 64 64 64 64 64 64 64
      64 64 64 64 64 64 64 64 64 64 64 64 64 64 64 64 64 64 64 64 64 64 64 64 64 64 64 64 64 64 64 64 64 64 64 64 64 64 64 64 64 64 64 64 64
      64 64 64 64 64 64 64 64 64 64 64 64 64 64 64 64 64 64 64 64 64 64 64 64 64 64 64 64 64 64 64 64 64 64 64 64 64 64 64 64 64 64 64 64 64
      64 64 64 64 64 64 64 64 64 64 64 64 64 64 64 64 64 64 64 64 64 64 64 64 64 64 64 64 64 64 64 64 64 64 64 64 64 64 64 64 64 64 64 64 64
      64 64 64 64 64 64 64 64 64 64 64 64 64 64 64 64 64 64 64 64 64 64 64 64 64 64 64 64 64 64 64 64 64 64 64 64 64 64 64 64 64 64 64 64 64
      64 64 64 64 0 0 64 64 64 64 64 64 64 64 64 64 64 64 64 64 64 64 64 64 64 64 64 64 64 64 64 64 64 64 64 64 64 64 64 64 64 64 64 64 64
      64 64 64 64 0 0 64 64 64 64 64 64 64 64 64 64 64 64 64 64 64 64 64 64 64 64 64 64 64 64 64 64 64 64 64 64 64 64 64 64 64 64 64 64 64
      64 64 64 64 64 64 64 64 64 64 64 64 64 64 64 64 64 64 64 64 64 64 64 64 64 64 64 64 64 64 64 64 64 64 64 64 64 64 64 64 64 64 64 64 64
      64 64 64 64 64 64 64 64 64 64 64 64 64 64 64 64 64 64 64 64 64 64 64 64 64 64 64 64 64 64 64 64 64 64 64 64 64 64 64 64 64 64 64 64 64
      )
    )
    (tilemap
      (solid #f)
      (tint 0.8 0.25 0.25)
      (alpha 0.5)
      (z-pos -200)
      (width 45)
      (height 25)
      (tiles
      0 0 0 0 0 0 0 0 0 0 0 0 0 0 0 0 0 0 0 0 0 0 0 0 0 0 0 0 0 0 0 0 0 0 0 0 0 0 0 0 0 0 0 0 0
      0 0 0 0 0 0 0 0 0 0 0 0 0 0 0 0 0 0 0 0 0 0 0 0 0 0 0 0 0 0 0 0 0 0 0 0 0 0 0 0 0 0 0 0 0
      0 0 0 0 0 0 0 0 0 0 0 0 0 0 0 0 0 0 0 0 0 0 0 0 0 0 0 0 0 0 0 0 0 0 0 0 0 0 0 0 0 0 0 0 0
      0 0 0 0 0 0 0 0 0 0 0 0 0 0 0 0 0 0 0 0 0 0 0 0 0 0 0 0 0 0 0 0 0 0 0 0 0 0 0 0 0 0 0 0 0
      3277 3277 3277 3277 3277 3277 3277 3277 3277 3277 3277 3277 3277 3277 3277 3277 3277 3277 3277 3277 3277 3277 3277 3277 3277 3277 3277 3277 3277 3277 3277 3277 3277 3277 3277 3277 3277 3277 3277 3277 3277 3277 3277 3277 3277
      3277 3277 3277 3277 3277 3277 3277 3277 3277 3277 3277 3277 3277 3277 3277 3277 3277 3277 3277 3277 3277 3277 3277 3277 3277 3277 3277 3277 3277 3277 3277 3277 3277 3277 3277 3277 3277 3277 3277 3277 3277 3277 3277 3277 3277
      3277 3277 3277 3277 3277 3277 3277 3277 3277 3277 3277 3277 3277 3277 3277 3277 3277 3277 3277 3277 3277 3277 3277 3277 3277 3277 3277 3277 3277 3277 3277 3277 3277 3277 3277 3277 3277 3277 3277 3277 3277 3277 3277 3277 3277
      3277 3277 3277 3277 3277 3277 3277 3277 3277 3277 3277 3277 3277 3277 3277 3277 3277 3277 3277 3277 3277 3277 3277 3277 3277 3277 3277 3277 3277 3277 3277 3277 3277 3277 3277 3277 3277 3277 3277 3277 3277 3277 3277 3277 3277
      3277 3277 3277 3277 3277 3277 3277 3277 3277 3277 3277 3277 3277 3277 3277 3277 3277 3277 3277 3277 3277 3277 3277 3277 3277 3277 3277 3277 3277 3277 3277 3277 3277 3277 3277 3277 3277 3277 3277 3277 3277 3277 3277 3277 3277
      3277 3277 3277 3277 3277 3277 3277 3277 3277 3277 3277 3277 3277 3277 3277 3277 3277 3277 3277 3277 3277 3277 3277 3277 3277 3277 3277 3277 3277 3277 3277 3277 3277 3277 3277 3277 3277 3277 3277 3277 3277 3277 3277 3277 3277
      3277 3277 3277 3277 3277 3277 3277 3277 3277 3277 3277 3277 3277 3277 3277 3277 3277 3277 3277 3277 3277 3277 3277 3277 3277 3277 3277 3277 3277 3277 3277 3277 3277 3277 3277 3277 3277 3277 3277 3277 3277 3277 3277 3277 3277
      3277 3277 3277 3277 3277 3277 3277 3277 3277 3277 3277 3277 3277 3277 3277 3277 3277 3277 3277 3277 3277 3277 3277 3277 3277 3277 3277 3277 3277 3277 3277 3277 3277 3277 3277 3277 3277 3277 3277 3277 3277 3277 3277 3277 3277
      3277 3277 3277 3277 3277 3277 3277 3277 3277 3277 3277 3277 3277 3277 3277 3277 3277 3277 3277 3277 3277 3277 3277 3277 3277 3277 3277 3277 3277 3277 3277 3277 3277 3277 3277 3277 3277 3277 3277 3277 3277 3277 3277 3277 3277
      3277 3277 3277 3277 3277 3277 3277 3277 3277 3277 3277 3277 3277 3277 3277 3277 3277 3277 3277 3277 3277 3277 3277 3277 3277 3277 3277 3277 3277 3277 3277 3277 3277 3277 3277 3277 3277 3277 3277 3277 3277 3277 3277 3277 3277
      3277 3277 3277 3277 3277 3277 3277 3277 3277 3277 3277 3277 3277 3277 3277 3277 3277 3277 3277 3277 3277 3277 3277 3277 3277 3277 3277 3277 3277 3277 3277 3277 3277 3277 3277 3277 3277 3277 3277 3277 3277 3277 3277 3277 3277
      3277 3277 3277 3277 3277 3277 3277 3277 3277 3277 3277 3277 3277 3277 3277 3277 3277 3277 3277 3277 3277 3277 3277 3277 3277 3277 3277 3277 3277 3277 3277 3277 3277 3277 3277 3277 3277 3277 3277 3277 3277 3277 3277 3277 3277
      3277 3277 3277 3277 3277 3277 3277 3277 3277 3277 3277 3277 3277 3277 3277 3277 3277 3277 3277 3277 3277 3277 3277 3277 3277 3277 3277 3277 3277 3277 3277 3277 3277 3277 3277 3277 3277 3277 3277 3277 3277 3277 3277 3277 3277
      3277 3277 3277 3277 3277 3277 3277 3277 3277 3277 3277 3277 3277 3277 3277 3277 3277 3277 3277 3277 3277 3277 3277 3277 3277 3277 3277 3277 3277 3277 3277 3277 3277 3277 3277 3277 3277 3277 3277 3277 3277 3277 3277 3277 3277
      3277 3277 3277 3277 3277 3277 3277 3277 3277 3277 3277 3277 3277 3277 3277 3277 3277 3277 3277 3277 3277 3277 3277 3277 3277 3277 3277 3277 3277 3277 3277 3277 3277 3277 3277 3277 3277 3277 3277 3277 3277 3277 3277 3277 3277
      3277 3277 3277 3277 3277 3277 3277 3277 3277 3277 3277 3277 3277 3277 3277 3277 3277 3277 3277 3277 3277 3277 3277 3277 3277 3277 3277 3277 3277 3277 3277 3277 3277 3277 3277 3277 3277 3277 3277 3277 3277 3277 3277 3277 3277
      3277 3277 3277 3277 3277 3277 3277 3277 3277 3277 3277 3277 3277 3277 3277 3277 3277 3277 3277 3277 3277 3277 3277 3277 3277 3277 3277 3277 3277 3277 3277 3277 3277 3277 3277 3277 3277 3277 3277 3277 3277 3277 3277 3277 3277
      3277 3277 3277 3277 3277 3277 3277 3277 3277 3277 3277 3277 3277 3277 3277 3277 3277 3277 3277 3277 3277 3277 3277 3277 3277 3277 3277 3277 3277 3277 3277 3277 3277 3277 3277 3277 3277 3277 3277 3277 3277 3277 3277 3277 3277
      3277 3277 3277 3277 3277 3277 3277 3277 3277 3277 3277 3277 3277 3277 3277 3277 3277 3277 3277 3277 3277 3277 3277 3277 3277 3277 3277 3277 3277 3277 3277 3277 3277 3277 3277 3277 3277 3277 3277 3277 3277 3277 3277 3277 3277
      0 0 0 0 0 0 0 0 0 0 0 0 0 0 0 0 0 0 0 0 0 0 0 0 0 0 0 0 0 0 0 0 0 0 0 0 0 0 0 0 0 0 0 0 0
      0 0 0 0 0 0 0 0 0 0 0 0 0 0 0 0 0 0 0 0 0 0 0 0 0 0 0 0 0 0 0 0 0 0 0 0 0 0 0 0 0 0 0 0 0
      )
    )
    (tilemap
      (solid #f)
      (tint 0.5 0.5 0.5)
      (z-pos -50)
      (width 45)
      (height 25)
      (tiles
      0 0 0 0 0 0 0 0 0 0 0 0 0 0 0 0 0 0 0 0 0 0 0 0 0 0 0 0 0 0 0 0 0 0 0 0 0 0 0 0 0 0 0 0 0
      0 0 0 0 0 0 0 0 0 0 0 0 0 0 0 0 0 0 0 0 0 0 0 0 0 0 0 0 0 0 0 0 0 0 0 0 0 0 0 0 0 0 0 0 0
      0 0 0 0 0 0 0 0 0 0 0 0 0 0 0 0 0 0 0 0 0 0 0 0 0 0 0 0 0 0 0 0 0 0 0 0 0 0 0 0 0 0 0 0 0
      0 0 0 0 0 0 0 0 0 0 0 0 0 0 0 0 0 0 0 0 0 0 0 0 0 0 0 0 0 0 0 0 0 0 0 0 0 0 0 0 0 0 0 0 0
      0 0 0 0 0 0 0 0 0 0 0 0 0 0 0 0 0 0 0 0 0 0 0 0 0 0 0 0 0 0 0 0 0 0 0 0 0 0 0 0 0 0 0 0 0
      0 0 0 0 0 0 0 0 0 0 0 0 0 0 0 0 0 0 0 0 0 0 0 0 0 0 0 0 0 0 0 0 0 0 0 0 0 0 0 0 0 0 0 0 0
      0 0 0 0 0 0 0 0 0 0 0 0 0 0 0 0 0 0 0 0 0 0 0 0 0 0 0 0 0 0 0 0 0 0 0 0 0 0 0 0 0 0 0 0 0
      0 0 0 0 0 0 0 0 0 0 0 0 0 0 0 0 0 0 0 0 0 0 0 0 0 0 0 0 0 0 0 0 0 0 0 0 0 0 0 0 0 0 0 0 0
      0 0 0 47 0 0 47 0 0 47 0 0 47 0 0 47 0 0 47 0 0 47 0 0 47 0 0 47 0 0 47 0 0 47 0 0 0 0 0 0 0 0 0 0 0
      0 0 0 47 0 0 47 0 0 47 0 0 47 0 0 47 0 0 47 0 0 47 0 0 47 0 0 47 0 0 47 0 0 47 0 0 0 0 0 0 0 0 0 0 0
      0 0 0 47 0 0 47 0 0 47 0 0 47 0 0 47 0 0 47 0 0 47 0 0 47 0 0 47 0 0 47 0 0 47 0 0 0 0 0 0 0 0 0 0 0
      0 0 0 47 0 0 47 0 0 47 0 0 47 0 0 47 0 0 47 0 0 47 0 0 47 0 0 47 0 0 47 0 0 47 0 0 0 0 0 0 0 0 0 0 0
      0 0 0 47 0 0 47 0 0 47 0 0 47 0 0 47 0 0 47 0 0 47 0 0 47 0 0 47 0 0 47 0 0 47 0 0 0 0 0 0 0 0 0 0 0
      0 0 0 47 0 0 47 0 0 47 0 0 47 0 0 47 0 0 47 0 0 47 0 0 47 0 0 47 0 0 47 0 0 47 0 0 0 0 0 0 0 0 0 0 0
      0 0 0 47 0 0 47 0 0 47 0 0 47 0 0 47 0 0 47 0 0 47 0 0 47 0 0 47 0 0 47 0 0 47 0 0 0 0 0 0 0 0 0 0 0
      0 0 0 47 0 0 47 0 0 47 0 0 47 0 0 47 0 0 47 0 0 47 0 0 47 0 0 47 0 0 47 0 0 47 0 0 0 0 0 0 0 0 0 0 0
      0 0 0 0 0 0 0 0 0 0 0 0 0 0 0 0 0 0 0 0 0 0 0 0 0 0 0 0 0 0 0 0 0 0 0 0 0 0 0 0 0 0 0 0 0
      0 0 0 0 0 0 0 0 0 0 0 0 0 0 0 0 0 0 0 0 0 0 0 0 0 0 0 0 0 0 0 0 0 0 0 0 0 0 0 0 0 0 0 0 0
      0 0 0 0 0 0 0 0 0 0 0 0 0 0 0 0 0 0 0 0 0 0 0 0 0 0 0 0 0 0 0 0 0 0 0 0 0 0 0 0 0 0 0 0 0
      0 0 0 0 0 0 0 0 0 0 0 0 0 0 0 0 0 0 0 0 0 0 0 0 0 0 0 0 0 0 0 0 0 0 0 0 0 0 0 0 0 0 0 0 0
      0 0 0 0 0 0 0 0 0 0 0 0 0 0 0 0 0 0 0 0 0 0 0 0 0 0 0 0 0 0 0 0 0 0 0 0 0 0 0 0 0 0 0 0 0
      0 0 0 0 0 0 0 0 0 0 0 0 0 0 0 0 0 0 0 0 0 0 0 0 0 0 0 0 0 0 0 0 0 0 0 0 0 0 0 0 0 0 0 0 0
      0 0 0 0 0 0 0 0 0 0 0 0 0 0 0 0 0 0 0 0 0 0 0 0 0 0 0 0 0 0 0 0 0 0 0 0 0 0 0 0 0 0 0 0 0
      0 0 0 0 0 0 0 0 0 0 0 0 0 0 0 0 0 0 0 0 0 0 0 0 0 0 0 0 0 0 0 0 0 0 0 0 0 0 0 0 0 0 0 0 0
      0 0 0 0 0 0 0 0 0 0 0 0 0 0 0 0 0 0 0 0 0 0 0 0 0 0 0 0 0 0 0 0 0 0 0 0 0 0 0 0 0 0 0 0 0
      )
    )
  )
)
