(supertux-level
  (version 3)
  (name (_ "Where Is Everyone?"))
  (author "SuperTux Player")
  (license "CC-BY-SA 4.0 International")
  (suppress-pause-menu #t)
  (icon "")
  (icon-locked "")
  (sector
    (name "main")
    (init-script "Tux.deactivate();")
    (ambient-light
      (color 0.9 0.86 0.85)
    )
    (background
      (color 1 1 1)
      (speed 0)
      (fill #t)
      (target "lightmap")
      (image "/images/background/misc/vignette.png")
      (z-pos 250)
    )
    (camera
      (name "Camera")
      (mode "manual")
    )
    (decal
      (solid #t)
      (action "big-idle-right")
      (sprite "/images/creatures/tux/tux.sprite")
      (x 800)
      (y 352)
    )
    (gradient
      (top_color 0 0 0)
      (bottom_color 1 0 0)
    )
    (music
      (file "/music/retro/theme_old.music")
    )
    (spawnpoint
      (name "main")
      (x 144)
      (y 672)
    )
    (textscroller
      (file "/levels/revenge_in_redmond/outro.txt")
      (speed 40)
      (x-offset 0)
    )
    (tilemap
      (solid #f)
      (z-pos -100)
      (width 45)
      (height 25)
      (tiles
      0 0 0 0 0 0 0 0 0 0 0 0 0 0 0 0 0 0 0 0 0 0 0 0 0 0 0 0 0 0 0 0 0 0 0 0 0 0 0 0 0 0 0 0 0
      0 0 0 0 0 0 0 0 0 0 0 0 0 0 0 0 0 0 0 0 0 0 0 0 0 0 0 0 0 0 0 0 0 0 0 0 0 0 0 0 0 0 0 0 0
      0 0 0 0 0 0 0 0 0 0 0 0 0 0 0 0 0 0 0 0 0 0 0 0 0 0 0 0 0 0 0 0 0 0 0 0 0 0 0 0 0 0 0 0 0
      0 0 0 0 0 0 0 0 0 0 0 0 0 0 0 0 0 0 0 0 0 0 0 0 0 0 0 0 0 0 0 0 0 0 0 0 0 0 0 0 0 0 0 0 0
      0 0 0 0 0 0 0 0 0 0 0 0 0 0 0 0 0 0 0 0 0 0 0 0 0 0 0 0 0 0 0 0 0 0 0 0 0 0 0 0 0 0 0 0 0
      0 0 3277 3278 3279 3277 3278 3279 3277 3278 3279 3277 3278 3279 3277 3278 3279 3277 3278 3279 3277 3278 3279 3277 3278 3279 3277 3278 3279 3277 3278 3279 3277 3278 3279 0 0 0 0 0 0 0 0 0 0
      0 0 3277 3278 3279 3277 3278 3279 3277 3278 3279 3277 3278 3279 3277 3278 3279 3277 3278 3279 3277 3278 3279 3277 3278 3279 3277 3278 3279 3277 3278 3279 3277 3278 3279 0 0 0 0 0 0 0 0 0 0
      0 0 3277 3278 3279 3277 3278 3279 3277 3278 3279 3277 3278 3279 3277 3278 3279 3277 3278 3279 3277 3278 3279 3277 3278 3279 3277 3278 3279 3277 3278 3279 3277 3278 3279 0 0 0 3585 3278 3278 3278 3278 3278 3278
      0 0 3277 3278 3279 3277 3278 3279 3277 3278 3279 3277 3278 3279 3277 3278 3279 3277 3278 3279 3277 3278 3279 3277 3278 3279 3277 3278 3279 3277 3278 3279 3277 3278 3279 0 0 0 3585 3278 3278 3278 3278 3278 3278
      0 0 3277 3278 3279 3277 3278 3279 3277 3278 3279 3277 3278 3279 3277 3278 3279 3277 3278 3279 3277 3278 3279 3277 3278 3279 3277 3278 3279 3277 3278 3279 3277 3278 3279 0 0 0 3585 3278 3278 3278 3278 3278 3278
      0 0 3277 3278 3279 3277 3278 3279 3277 3278 3279 3277 3278 3279 3277 3278 3279 3277 3278 3279 3277 3278 3279 3277 3278 3279 3277 3278 3279 3277 3278 3279 3277 3278 3279 0 0 0 0 0 0 0 0 0 0
      0 0 3277 3278 3279 3277 3278 3279 3277 3278 3279 3277 3278 3279 3277 3278 3279 3277 3278 3279 3277 3278 3279 3277 3278 3279 3277 3278 3279 3277 3278 3279 3277 3278 3279 0 0 0 0 0 0 0 0 0 0
      0 0 3277 3278 3279 3277 3278 3279 3277 3278 3279 3277 3278 3279 3277 3278 3279 3277 3278 3279 3277 3278 3279 3277 3278 3279 3277 3278 3279 3277 3278 3279 3277 3278 3279 0 0 0 0 0 0 0 0 0 0
      0 0 0 0 0 0 0 0 0 0 0 0 0 0 0 0 0 0 0 0 0 0 0 0 0 0 0 0 0 0 0 0 0 0 0 0 0 0 0 0 0 0 0 0 0
      0 0 0 0 0 0 0 0 0 0 0 0 0 0 0 0 0 0 0 0 0 0 0 0 0 0 0 0 0 0 0 0 0 0 0 0 0 0 0 0 0 0 0 0 0
      0 0 0 0 0 0 0 0 0 0 0 0 0 0 0 0 0 0 0 0 0 0 0 0 0 0 0 0 0 0 0 0 0 0 0 0 0 0 0 0 0 0 0 0 0
      0 0 0 0 0 0 0 0 0 0 0 0 0 0 0 0 0 0 0 0 0 0 0 0 0 0 0 0 0 0 0 0 0 0 0 0 0 0 0 0 0 0 0 0 0
      0 0 0 0 0 0 0 0 0 0 0 0 0 0 0 0 0 0 0 0 0 0 0 0 0 0 0 0 0 0 0 0 0 0 0 0 0 0 0 0 0 0 0 0 0
      0 0 0 0 0 0 0 0 0 0 0 0 0 0 0 0 0 0 0 0 0 0 0 0 0 0 0 0 0 0 0 0 0 0 0 0 0 0 0 0 0 0 0 0 0
      0 0 0 0 0 0 0 0 0 0 0 0 0 0 0 0 0 0 0 0 0 0 0 0 0 0 0 0 0 0 0 0 0 0 0 0 0 0 0 0 0 0 0 0 0
      0 0 0 0 0 0 0 0 0 0 0 0 0 0 0 0 0 0 0 0 0 0 0 0 0 0 0 0 0 0 0 0 0 0 0 0 0 0 0 0 0 0 0 0 0
      0 0 0 0 0 0 0 0 0 0 0 0 0 0 0 0 0 0 0 0 0 0 0 0 0 0 0 0 0 0 0 0 0 0 0 0 0 0 0 0 0 0 0 0 0
      0 0 0 0 0 0 0 0 0 0 0 0 0 0 0 0 0 0 0 0 0 0 0 0 0 0 0 0 0 0 0 0 0 0 0 0 0 0 0 0 0 0 0 0 0
      0 0 0 0 0 0 0 0 0 0 0 0 0 0 0 0 0 0 0 0 0 0 0 0 0 0 0 0 0 0 0 0 0 0 0 0 0 0 0 0 0 0 0 0 0
      0 0 0 0 0 0 0 0 0 0 0 0 0 0 0 0 0 0 0 0 0 0 0 0 0 0 0 0 0 0 0 0 0 0 0 0 0 0 0 0 0 0 0 0 0
      )
    )
    (tilemap
      (solid #f)
      (z-pos 100)
      (width 45)
      (height 25)
      (tiles
      0 0 0 0 0 0 0 0 0 0 0 0 0 0 0 0 0 0 0 0 0 0 0 0 0 0 0 0 0 0 0 0 0 0 0 0 0 0 0 0 0 0 0 0 0
      0 0 0 0 0 0 0 0 0 0 0 0 0 0 0 0 0 0 0 0 0 0 0 0 0 0 0 0 0 0 0 0 0 0 0 0 0 0 0 0 0 0 0 0 0
      0 0 0 0 0 0 0 0 0 0 0 0 0 0 0 0 0 0 0 0 0 0 0 0 0 0 0 0 0 0 0 0 0 0 0 0 0 0 0 0 0 0 0 0 0
      0 0 0 0 0 0 0 0 0 0 0 0 0 0 0 0 0 0 0 0 0 0 0 0 0 0 0 0 0 0 0 0 0 0 0 0 0 0 0 0 0 0 0 0 0
      0 0 0 0 0 0 0 0 0 0 0 0 0 0 0 0 0 0 0 0 0 0 0 0 0 0 0 0 0 0 0 0 0 0 0 0 0 0 0 0 0 0 0 0 0
      0 0 0 0 0 0 0 0 0 0 0 0 0 0 0 0 0 0 0 0 0 0 0 0 0 0 0 0 0 0 0 0 0 0 0 0 0 0 0 0 0 0 0 0 0
      0 0 0 0 0 0 0 0 0 0 0 0 0 0 0 0 0 0 0 0 0 0 0 0 0 0 0 0 0 0 0 0 0 0 0 0 0 0 0 0 0 0 0 0 0
      0 0 0 0 0 0 0 0 0 0 0 0 0 0 0 0 0 0 0 0 0 0 0 0 0 0 0 0 0 0 0 0 0 0 0 0 0 0 0 0 0 0 0 0 0
      0 0 0 0 0 0 0 0 0 0 0 0 0 0 0 0 0 0 0 0 0 0 0 0 0 0 0 0 0 0 0 0 0 0 0 0 0 0 0 0 0 0 0 0 0
      0 0 0 0 0 0 0 0 0 0 0 0 0 0 0 0 0 0 0 0 0 0 0 0 0 0 0 0 0 0 0 0 0 0 0 0 0 0 0 0 0 0 0 0 0
      0 0 0 0 0 0 0 0 0 0 0 0 0 0 0 0 0 0 0 0 0 0 0 0 0 0 0 0 0 0 0 0 0 0 0 0 0 0 0 0 0 0 0 0 0
      0 0 0 0 0 0 0 0 0 0 0 0 0 0 0 0 0 0 0 0 0 0 0 0 0 0 0 0 0 0 0 0 0 0 0 0 0 0 0 0 0 0 0 0 0
      0 0 0 0 0 0 0 0 0 0 0 0 0 0 0 0 0 0 0 0 0 0 0 0 0 0 0 0 0 0 0 0 0 0 0 0 0 0 0 0 0 0 0 0 0
      0 0 0 0 0 0 0 0 0 0 0 0 0 0 0 0 0 0 0 0 0 0 0 0 0 0 0 0 0 0 0 0 0 0 0 0 0 0 0 0 0 0 0 0 0
      0 0 0 0 0 0 0 0 0 0 0 0 0 0 0 0 0 0 0 0 0 0 0 0 0 0 0 0 0 0 0 0 0 0 0 0 0 0 0 0 0 0 0 0 0
      0 0 0 0 0 0 0 0 0 0 0 0 0 0 0 0 0 0 0 0 0 0 0 0 0 0 0 0 0 0 0 0 0 0 0 0 0 0 0 0 0 0 0 0 0
      0 0 0 0 0 0 0 0 0 0 0 0 0 0 0 0 0 0 0 0 0 0 0 0 0 0 0 0 0 0 0 0 0 0 0 0 0 0 0 0 0 0 0 0 0
      0 0 0 0 0 0 0 0 0 0 0 0 0 0 0 0 0 0 0 0 0 0 0 0 0 0 0 0 0 0 0 0 0 0 0 0 0 0 0 0 0 0 0 0 0
      0 0 0 0 0 0 0 0 0 0 0 0 0 0 0 0 0 0 0 0 0 0 0 0 0 0 0 0 0 0 0 0 0 0 0 0 0 0 0 0 0 0 0 0 0
      0 0 0 0 0 0 0 0 0 0 0 0 0 0 0 0 0 0 0 0 0 0 0 0 0 0 0 0 0 0 0 0 0 0 0 0 0 0 0 0 0 0 0 0 0
      0 0 0 64 64 64 64 0 0 0 0 0 0 0 0 0 0 0 0 0 0 0 0 0 0 0 0 0 0 0 0 0 0 0 0 0 0 0 0 0 0 0 0 0 0
      0 0 0 64 64 64 64 0 0 0 0 0 0 0 0 0 0 0 0 0 0 0 0 0 0 0 0 0 0 0 0 0 0 0 0 0 0 0 0 0 0 0 0 0 0
      0 0 0 64 64 64 64 0 0 0 0 0 0 0 0 0 0 0 0 0 0 0 0 0 0 0 0 0 0 0 0 0 0 0 0 0 0 0 0 0 0 0 0 0 0
      0 0 0 64 64 64 64 0 0 0 0 0 0 0 0 0 0 0 0 0 0 0 0 0 0 0 0 0 0 0 0 0 0 0 0 0 0 0 0 0 0 0 0 0 0
      0 0 0 64 64 64 64 0 0 0 0 0 0 0 0 0 0 0 0 0 0 0 0 0 0 0 0 0 0 0 0 0 0 0 0 0 0 0 0 0 0 0 0 0 0
      )
    )
    (tilemap
      (solid #t)
      (z-pos 0)
      (width 45)
      (height 25)
      (tiles
      64 64 64 64 64 64 64 64 64 64 64 64 64 64 64 64 64 64 64 64 64 64 64 64 64 64 64 64 64 64 64 64 64 64 64 64 64 64 64 64 64 64 64 64 64
      64 64 64 64 64 64 64 64 64 64 64 64 64 64 64 64 64 64 64 64 64 64 64 64 64 64 64 64 64 64 64 64 64 64 64 64 64 64 64 64 64 64 64 64 64
      64 64 64 64 64 64 64 64 64 64 64 64 64 64 64 64 64 64 64 64 64 64 64 64 64 64 64 64 64 64 64 64 64 64 64 64 64 64 64 64 64 64 64 64 64
      64 64 64 64 64 64 64 64 64 64 64 64 64 64 64 64 64 64 64 64 64 64 64 64 64 64 64 64 64 64 64 64 64 64 64 64 64 64 64 64 64 64 64 64 64
      66 66 66 66 66 66 66 66 66 66 66 66 66 66 66 66 66 66 66 66 66 66 66 66 66 66 66 66 66 66 66 66 66 66 66 66 66 3520 64 64 64 64 64 64 64
      0 0 0 0 0 0 0 0 0 0 0 0 0 0 0 0 0 0 0 0 0 0 0 0 0 0 0 0 0 0 0 0 0 0 0 0 0 68 64 64 64 64 64 64 64
      0 0 0 0 0 0 0 0 0 0 0 0 0 0 0 0 0 0 0 0 0 0 0 0 0 0 0 0 0 0 0 0 0 0 0 0 0 67 66 66 66 66 66 66 66
      0 0 0 0 0 0 0 0 0 0 0 0 0 0 0 0 0 0 0 0 0 0 0 0 0 0 0 0 0 0 0 0 0 0 0 0 0 0 0 0 0 0 0 0 0
      0 0 0 0 0 0 0 0 0 0 0 0 0 0 0 0 0 0 0 0 0 0 0 0 0 0 0 0 0 0 0 0 0 0 0 0 0 0 0 0 0 0 0 0 0
      0 0 0 0 0 0 0 0 0 0 0 0 0 0 0 0 0 0 0 0 0 0 0 0 0 0 0 0 0 0 0 0 0 0 0 0 0 0 0 0 0 0 0 0 0
      0 0 0 0 0 0 0 0 0 0 0 0 0 0 0 0 1809 1812 0 0 0 0 1809 1812 0 0 0 0 1809 1812 0 0 0 0 0 0 489 65 65 65 65 65 65 65 65
      0 0 0 0 0 0 0 0 0 0 0 0 0 0 0 0 1810 1813 0 0 0 0 1810 1813 0 0 0 0 1810 1813 0 0 0 0 0 0 68 64 64 64 64 64 64 64 64
      0 0 0 0 0 0 0 0 0 0 0 0 0 0 0 0 1811 1814 0 0 0 0 1811 1814 0 0 0 0 1811 1814 0 0 0 0 0 0 68 64 64 64 64 64 64 64 64
      65 65 65 65 65 65 65 65 65 65 65 65 65 65 65 65 65 65 65 65 65 65 65 65 65 65 65 65 65 65 65 65 65 65 65 65 64 64 64 64 64 64 64 64 64
      64 64 64 64 64 64 64 64 64 64 64 64 64 64 64 64 64 64 64 64 64 64 64 64 64 64 64 64 64 64 64 64 64 64 64 64 64 64 64 64 64 64 64 64 64
      64 64 64 64 64 64 64 64 64 64 64 64 64 64 64 64 64 64 64 64 64 64 64 64 64 64 64 64 64 64 64 64 64 64 64 64 64 64 64 64 64 64 64 64 64
      64 64 64 64 64 64 64 64 64 64 64 64 64 64 64 64 64 64 64 64 64 64 64 64 64 64 64 64 64 64 64 64 64 64 64 64 64 64 64 64 64 64 64 64 64
      64 64 64 64 64 64 64 64 64 64 64 64 64 64 64 64 64 64 64 64 64 64 64 64 64 64 64 64 64 64 64 64 64 64 64 64 64 64 64 64 64 64 64 64 64
      64 64 64 64 64 64 64 64 64 64 64 64 64 64 64 64 64 64 64 64 64 64 64 64 64 64 64 64 64 64 64 64 64 64 64 64 64 64 64 64 64 64 64 64 64
      64 64 64 64 64 64 64 64 64 64 64 64 64 64 64 64 64 64 64 64 64 64 64 64 64 64 64 64 64 64 64 64 64 64 64 64 64 64 64 64 64 64 64 64 64
      64 64 64 64 64 64 64 64 64 64 64 64 64 64 64 64 64 64 64 64 64 64 64 64 64 64 64 64 64 64 64 64 64 64 64 64 64 64 64 64 64 64 64 64 64
      64 64 64 64 0 0 64 64 64 64 64 64 64 64 64 64 64 64 64 64 64 64 64 64 64 64 64 64 64 64 64 64 64 64 64 64 64 64 64 64 64 64 64 64 64
      64 64 64 64 0 0 64 64 64 64 64 64 64 64 64 64 64 64 64 64 64 64 64 64 64 64 64 64 64 64 64 64 64 64 64 64 64 64 64 64 64 64 64 64 64
      64 64 64 64 64 64 64 64 64 64 64 64 64 64 64 64 64 64 64 64 64 64 64 64 64 64 64 64 64 64 64 64 64 64 64 64 64 64 64 64 64 64 64 64 64
      64 64 64 64 64 64 64 64 64 64 64 64 64 64 64 64 64 64 64 64 64 64 64 64 64 64 64 64 64 64 64 64 64 64 64 64 64 64 64 64 64 64 64 64 64
      )
    )
    (tilemap
      (solid #f)
      (tint 0.8 0.25 0.25)
      (alpha 0.5)
      (z-pos -200)
      (width 45)
      (height 25)
      (tiles
      0 0 0 0 0 0 0 0 0 0 0 0 0 0 0 0 0 0 0 0 0 0 0 0 0 0 0 0 0 0 0 0 0 0 0 0 0 0 0 0 0 0 0 0 0
      3278 3278 3278 3278 3278 3278 3278 3278 3278 3278 3278 3278 3278 3278 3278 3278 3278 3278 3278 3278 3278 3278 3278 3278 3278 3278 3278 3278 3278 3278 3278 3278 3278 3278 3278 3278 3278 3278 3278 3278 3278 3278 3278 3278 3278
      3278 3278 3278 3278 3278 3278 3278 3278 3278 3278 3278 3278 3278 3278 3278 3278 3278 3278 3278 3278 3278 3278 3278 3278 3278 3278 3278 3278 3278 3278 3278 3278 3278 3278 3278 3278 3278 3278 3278 3278 3278 3278 3278 3278 3278
      3278 3278 3278 3278 3278 3278 3278 3278 3278 3278 3278 3278 3278 3278 3278 3278 3278 3278 3278 3278 3278 3278 3278 3278 3278 3278 3278 3278 3278 3278 3278 3278 3278 3278 3278 3278 3278 3278 3278 3278 3278 3278 3278 3278 3278
      3278 3278 3278 3278 3278 3278 3278 3278 3278 3278 3278 3278 3278 3278 3278 3278 3278 3278 3278 3278 3278 3278 3278 3278 3278 3278 3278 3278 3278 3278 3278 3278 3278 3278 3278 3278 3278 3278 3278 3278 3278 3278 3278 3278 3278
      3278 3278 3278 3278 3278 3278 3278 3278 3278 3278 3278 3278 3278 3278 3278 3278 3278 3278 3278 3278 3278 3278 3278 3278 3278 3278 3278 3278 3278 3278 3278 3278 3278 3278 3278 3278 3278 3278 3278 3278 3278 3278 3278 3278 3278
      3278 3278 3278 3278 3278 3278 3278 3278 3278 3278 3278 3278 3278 3278 3278 3278 3278 3278 3278 3278 3278 3278 3278 3278 3278 3278 3278 3278 3278 3278 3278 3278 3278 3278 3278 3278 3278 3278 3278 3278 3278 3278 3278 3278 3278
      3278 3278 3278 3278 3278 3278 3278 3278 3278 3278 3278 3278 3278 3278 3278 3278 3278 3278 3278 3278 3278 3278 3278 3278 3278 3278 3278 3278 3278 3278 3278 3278 3278 3278 3278 3278 3278 3278 3278 3278 3278 3278 3278 3278 3278
      3278 3278 3278 3278 3278 3278 3278 3278 3278 3278 3278 3278 3278 3278 3278 3278 3278 3278 3278 3278 3278 3278 3278 3278 3278 3278 3278 3278 3278 3278 3278 3278 3278 3278 3278 3278 3278 3278 3278 3278 3278 3278 3278 3278 3278
      3278 3278 3278 3278 3278 3278 3278 3278 3278 3278 3278 3278 3278 3278 3278 3278 3278 3278 3278 3278 3278 3278 3278 3278 3278 3278 3278 3278 3278 3278 3278 3278 3278 3278 3278 3278 3278 3278 3278 3278 3278 3278 3278 3278 3278
      3278 3278 3278 3278 3278 3278 3278 3278 3278 3278 3278 3278 3278 3278 3278 3278 3278 3278 3278 3278 3278 3278 3278 3278 3278 3278 3278 3278 3278 3278 3278 3278 3278 3278 3278 3278 3278 3278 3278 3278 3278 3278 3278 3278 3278
      3278 3278 3278 3278 3278 3278 3278 3278 3278 3278 3278 3278 3278 3278 3278 3278 3278 3278 3278 3278 3278 3278 3278 3278 3278 3278 3278 3278 3278 3278 3278 3278 3278 3278 3278 3278 3278 3278 3278 3278 3278 3278 3278 3278 3278
      3278 3278 3278 3278 3278 3278 3278 3278 3278 3278 3278 3278 3278 3278 3278 3278 3278 3278 3278 3278 3278 3278 3278 3278 3278 3278 3278 3278 3278 3278 3278 3278 3278 3278 3278 3278 3278 3278 3278 3278 3278 3278 3278 3278 3278
      3278 3278 3278 3278 3278 3278 3278 3278 3278 3278 3278 3278 3278 3278 3278 3278 3278 3278 3278 3278 3278 3278 3278 3278 3278 3278 3278 3278 3278 3278 3278 3278 3278 3278 3278 3278 3278 3278 3278 3278 3278 3278 3278 3278 3278
      3278 3278 3278 3278 3278 3278 3278 3278 3278 3278 3278 3278 3278 3278 3278 3278 3278 3278 3278 3278 3278 3278 3278 3278 3278 3278 3278 3278 3278 3278 3278 3278 3278 3278 3278 3278 3278 3278 3278 3278 3278 3278 3278 3278 3278
      3278 3278 3278 3278 3278 3278 3278 3278 3278 3278 3278 3278 3278 3278 3278 3278 3278 3278 3278 3278 3278 3278 3278 3278 3278 3278 3278 3278 3278 3278 3278 3278 3278 3278 3278 3278 3278 3278 3278 3278 3278 3278 3278 3278 3278
      3278 3278 3278 3278 3278 3278 3278 3278 3278 3278 3278 3278 3278 3278 3278 3278 3278 3278 3278 3278 3278 3278 3278 3278 3278 3278 3278 3278 3278 3278 3278 3278 3278 3278 3278 3278 3278 3278 3278 3278 3278 3278 3278 3278 3278
      3278 3278 3278 3278 3278 3278 3278 3278 3278 3278 3278 3278 3278 3278 3278 3278 3278 3278 3278 3278 3278 3278 3278 3278 3278 3278 3278 3278 3278 3278 3278 3278 3278 3278 3278 3278 3278 3278 3278 3278 3278 3278 3278 3278 3278
      3278 3278 3278 3278 3278 3278 3278 3278 3278 3278 3278 3278 3278 3278 3278 3278 3278 3278 3278 3278 3278 3278 3278 3278 3278 3278 3278 3278 3278 3278 3278 3278 3278 3278 3278 3278 3278 3278 3278 3278 3278 3278 3278 3278 3278
      3278 3278 3278 3278 3278 3278 3278 3278 3278 3278 3278 3278 3278 3278 3278 3278 3278 3278 3278 3278 3278 3278 3278 3278 3278 3278 3278 3278 3278 3278 3278 3278 3278 3278 3278 3278 3278 3278 3278 3278 3278 3278 3278 3278 3278
      3278 3278 3278 3278 3278 3278 3278 3278 3278 3278 3278 3278 3278 3278 3278 3278 3278 3278 3278 3278 3278 3278 3278 3278 3278 3278 3278 3278 3278 3278 3278 3278 3278 3278 3278 3278 3278 3278 3278 3278 3278 3278 3278 3278 3278
      3278 3278 3278 3278 3278 3278 3278 3278 3278 3278 3278 3278 3278 3278 3278 3278 3278 3278 3278 3278 3278 3278 3278 3278 3278 3278 3278 3278 3278 3278 3278 3278 3278 3278 3278 3278 3278 3278 3278 3278 3278 3278 3278 3278 3278
      3278 3278 3278 3278 3278 3278 3278 3278 3278 3278 3278 3278 3278 3278 3278 3278 3278 3278 3278 3278 3278 3278 3278 3278 3278 3278 3278 3278 3278 3278 3278 3278 3278 3278 3278 3278 3278 3278 3278 3278 3278 3278 3278 3278 3278
      3278 3278 3278 3278 3278 3278 3278 3278 3278 3278 3278 3278 3278 3278 3278 3278 3278 3278 3278 3278 3278 3278 3278 3278 3278 3278 3278 3278 3278 3278 3278 3278 3278 3278 3278 3278 3278 3278 3278 3278 3278 3278 3278 3278 3278
      3278 3278 3278 3278 3278 3278 3278 3278 3278 3278 3278 3278 3278 3278 3278 3278 3278 3278 3278 3278 3278 3278 3278 3278 3278 3278 3278 3278 3278 3278 3278 3278 3278 3278 3278 3278 3278 3278 3278 3278 3278 3278 3278 3278 3278
      )
    )
    (tilemap
      (solid #f)
      (tint 0.5 0.5 0.5)
      (z-pos -50)
      (width 45)
      (height 25)
      (tiles
      0 0 0 0 0 0 0 0 0 0 0 0 0 0 0 0 0 0 0 0 0 0 0 0 0 0 0 0 0 0 0 0 0 0 0 0 0 0 0 0 0 0 0 0 0
      0 0 0 0 0 0 0 0 0 0 0 0 0 0 0 0 0 0 0 0 0 0 0 0 0 0 0 0 0 0 0 0 0 0 0 0 0 0 0 0 0 0 0 0 0
      0 0 0 0 0 0 0 0 0 0 0 0 0 0 0 0 0 0 0 0 0 0 0 0 0 0 0 0 0 0 0 0 0 0 0 0 0 0 0 0 0 0 0 0 0
      0 0 0 0 0 0 0 0 0 0 0 0 0 0 0 0 0 0 0 0 0 0 0 0 0 0 0 0 0 0 0 0 0 0 0 0 0 0 0 0 0 0 0 0 0
      0 0 0 0 0 0 0 0 0 0 0 0 0 0 0 0 0 0 0 0 0 0 0 0 0 0 0 0 0 0 0 0 0 0 0 0 0 0 0 0 0 0 0 0 0
      0 0 0 47 0 0 47 0 0 47 0 0 47 0 0 47 0 0 47 0 0 47 0 0 47 0 0 47 0 0 47 0 0 47 0 0 0 0 0 0 0 0 0 0 0
      0 0 0 47 0 0 47 0 0 47 0 0 47 0 0 47 0 0 47 0 0 47 0 0 47 0 0 47 0 0 47 0 0 47 0 0 0 0 0 0 0 0 0 0 0
      0 0 0 47 0 0 47 0 0 47 0 0 47 0 0 47 0 0 47 0 0 47 0 0 47 0 0 47 0 0 47 0 0 47 0 0 0 0 0 0 0 0 0 0 0
      0 0 0 47 0 0 47 0 0 47 0 0 47 0 0 47 0 0 47 0 0 47 0 0 47 0 0 47 0 0 47 0 0 47 0 0 0 0 0 0 0 0 0 0 0
      0 0 0 47 0 0 47 0 0 47 0 0 47 0 0 47 0 0 47 0 0 47 0 0 47 0 0 47 0 0 47 0 0 47 0 0 0 0 0 0 0 0 0 0 0
      0 0 0 47 0 0 47 0 0 47 0 0 47 0 0 47 0 0 47 0 0 47 0 0 47 0 0 47 0 0 47 0 0 47 0 0 0 0 0 0 0 0 0 0 0
      0 0 0 47 0 0 47 0 0 47 0 0 47 0 0 47 0 0 47 0 0 47 0 0 47 0 0 47 0 0 47 0 0 47 0 0 0 0 0 0 0 0 0 0 0
      0 0 0 47 0 0 47 0 0 47 0 0 47 0 0 47 0 0 47 0 0 47 0 0 47 0 0 47 0 0 47 0 0 47 0 0 0 0 0 0 0 0 0 0 0
      0 0 0 0 0 0 0 0 0 0 0 0 0 0 0 0 0 0 0 0 0 0 0 0 0 0 0 0 0 0 0 0 0 0 0 0 0 0 0 0 0 0 0 0 0
      0 0 0 0 0 0 0 0 0 0 0 0 0 0 0 0 0 0 0 0 0 0 0 0 0 0 0 0 0 0 0 0 0 0 0 0 0 0 0 0 0 0 0 0 0
      0 0 0 0 0 0 0 0 0 0 0 0 0 0 0 0 0 0 0 0 0 0 0 0 0 0 0 0 0 0 0 0 0 0 0 0 0 0 0 0 0 0 0 0 0
      0 0 0 0 0 0 0 0 0 0 0 0 0 0 0 0 0 0 0 0 0 0 0 0 0 0 0 0 0 0 0 0 0 0 0 0 0 0 0 0 0 0 0 0 0
      0 0 0 0 0 0 0 0 0 0 0 0 0 0 0 0 0 0 0 0 0 0 0 0 0 0 0 0 0 0 0 0 0 0 0 0 0 0 0 0 0 0 0 0 0
      0 0 0 0 0 0 0 0 0 0 0 0 0 0 0 0 0 0 0 0 0 0 0 0 0 0 0 0 0 0 0 0 0 0 0 0 0 0 0 0 0 0 0 0 0
      0 0 0 0 0 0 0 0 0 0 0 0 0 0 0 0 0 0 0 0 0 0 0 0 0 0 0 0 0 0 0 0 0 0 0 0 0 0 0 0 0 0 0 0 0
      0 0 0 0 0 0 0 0 0 0 0 0 0 0 0 0 0 0 0 0 0 0 0 0 0 0 0 0 0 0 0 0 0 0 0 0 0 0 0 0 0 0 0 0 0
      0 0 0 0 0 0 0 0 0 0 0 0 0 0 0 0 0 0 0 0 0 0 0 0 0 0 0 0 0 0 0 0 0 0 0 0 0 0 0 0 0 0 0 0 0
      0 0 0 0 0 0 0 0 0 0 0 0 0 0 0 0 0 0 0 0 0 0 0 0 0 0 0 0 0 0 0 0 0 0 0 0 0 0 0 0 0 0 0 0 0
      0 0 0 0 0 0 0 0 0 0 0 0 0 0 0 0 0 0 0 0 0 0 0 0 0 0 0 0 0 0 0 0 0 0 0 0 0 0 0 0 0 0 0 0 0
      0 0 0 0 0 0 0 0 0 0 0 0 0 0 0 0 0 0 0 0 0 0 0 0 0 0 0 0 0 0 0 0 0 0 0 0 0 0 0 0 0 0 0 0 0
      )
    )
  )
)
