(supertux-level
  (version 3)
  (name (_ "Who Is This Gown?"))
  (author "Carsten Wirtz")
  (license "CC-BY-SA 4.0 International")
  (target-time 43)
  (allow-item-pocket "inherit")
  (icon "")
  (icon-locked "")
  (statistics
    (enable-coins #t)
    (enable-badguys #f)
    (enable-secrets #t)
  )
  (sector
    (name "main")
    (init-script "Camera.set_scale(1.1);")
    (ambient-light
      (color 0.8 0.82 0.9)
    )
    (background
      (color 0.8 0.8 0.8)
      (speed 0.5)
      (image-top "/images/background/retro/cave_wall.png")
      (image "/images/background/retro/cave_wall.png")
      (image-bottom "/images/background/retro/cave_wall.png")
      (z-pos -250)
    )
    (background
      (color 1 1 1)
      (speed 0.7)
      (image-top "/images/background/retro/cave_wood.png")
      (image "/images/background/retro/cave_wood.png")
      (image-bottom "/images/background/retro/cave_wood.png")
      (z-pos -200)
    )
    (background
      (color 1 1 1)
      (speed 0)
      (fill #t)
      (target "lightmap")
      (image "/images/background/misc/vignette.png")
    )
    (bonusblock
      (type "retro")
      (z-pos 51)
      (x 8576)
      (y 448)
    )
    (bonusblock
      (type "retro")
      (z-pos 51)
      (x 8608)
      (y 448)
    )
    (bonusblock
      (type "retro")
      (z-pos 51)
      (x 8640)
      (y 448)
    )
    (bonusblock
      (type "retro")
      (z-pos 51)
      (x 7296)
      (y 672)
    )
    (bonusblock
      (type "retro")
      (z-pos 51)
      (x 7296)
      (y 544)
    )
    (bonusblock
      (type "retro")
      (z-pos 51)
      (x 5568)
      (y 800)
    )
    (bonusblock
      (type "retro")
      (z-pos 51)
      (contents "retrogrow")
      (x 5536)
      (y 800)
    )
    (bonusblock
      (type "retro")
      (z-pos 51)
      (x 5952)
      (y 736)
    )
    (bonusblock
      (type "retro")
      (z-pos 51)
      (x 6144)
      (y 704)
    )
    (bonusblock
      (type "retro")
      (z-pos 51)
      (x 6336)
      (y 736)
    )
    (bonusblock
      (type "retro")
      (z-pos 51)
      (x 4320)
      (y 512)
    )
    (bonusblock
      (type "retro")
      (z-pos 51)
      (x 4256)
      (y 512)
    )
    (bonusblock
      (type "retro")
      (z-pos 51)
      (x 4192)
      (y 512)
    )
    (bonusblock
      (type "retro")
      (z-pos 51)
      (contents "retrostar")
      (x 4416)
      (y 832)
    )
    (bonusblock
      (type "retro")
      (z-pos 51)
      (x 2656)
      (y 480)
    )
    (bonusblock
      (type "retro")
      (z-pos 51)
      (x 2624)
      (y 480)
    )
    (bonusblock
      (type "retro")
      (z-pos 51)
      (x 2560)
      (y 480)
    )
    (bonusblock
      (type "retro")
      (z-pos 51)
      (x 2592)
      (y 480)
    )
    (bonusblock
      (type "retro")
      (z-pos 51)
      (x 1792)
      (y 480)
    )
    (bonusblock
      (type "retro")
      (z-pos 51)
      (x 1824)
      (y 480)
    )
    (bonusblock
      (type "retro")
      (z-pos 51)
      (x 1856)
      (y 480)
    )
    (bonusblock
      (type "retro")
      (z-pos 51)
      (x 1760)
      (y 480)
    )
    (bonusblock
      (type "retro")
      (z-pos 51)
      (count 5)
      (sprite "/images/objects/bonus_block/retro_brick.sprite")
      (x 2208)
      (y 1056)
    )
    (bonusblock
      (type "retro")
      (z-pos 51)
      (contents "1up")
      (x 11104)
      (y 336)
    )
    (bonusblock
      (type "retro")
      (z-pos 51)
      (contents "retrogrow")
      (x 1056)
      (y 512)
    )
    (brick
      (type "retro")
      (z-pos 51)
      (x 7264)
      (y 672)
      (breakable #t)
    )
    (brick
      (type "retro")
      (z-pos 51)
      (x 7328)
      (y 672)
      (breakable #t)
    )
    (brick
      (type "retro")
      (z-pos 51)
      (x 4224)
      (y 512)
      (breakable #t)
    )
    (brick
      (type "retro")
      (z-pos 51)
      (x 4288)
      (y 512)
      (breakable #t)
    )
    (brick
      (type "retro")
      (z-pos 51)
      (x 2528)
      (y 480)
      (breakable #t)
    )
    (brick
      (type "retro")
      (z-pos 51)
      (x 2688)
      (y 480)
      (breakable #t)
    )
    (camera
      (name "Camera")
      (mode "normal")
    )
    (coin
      (type "retro")
      (z-pos 49)
      (x 1408)
      (y 544)
    )
    (coin
      (type "retro")
      (z-pos 49)
      (x 1472)
      (y 544)
    )
    (coin
      (type "retro")
      (z-pos 49)
      (x 1536)
      (y 544)
    )
    (coin
      (type "retro")
      (z-pos 49)
      (x 1600)
      (y 544)
    )
    (coin
      (type "retro")
      (z-pos 49)
      (x 3520)
      (y 736)
    )
    (coin
      (type "retro")
      (z-pos 49)
      (x 3488)
      (y 736)
    )
    (coin
      (type "retro")
      (z-pos 49)
      (x 3488)
      (y 768)
    )
    (coin
      (type "retro")
      (z-pos 49)
      (x 3520)
      (y 768)
    )
    (coin
      (type "retro")
      (z-pos 49)
      (x 3584)
      (y 768)
    )
    (coin
      (type "retro")
      (z-pos 49)
      (x 3584)
      (y 736)
    )
    (coin
      (type "retro")
      (z-pos 49)
      (x 3616)
      (y 736)
    )
    (coin
      (type "retro")
      (z-pos 49)
      (x 3616)
      (y 768)
    )
    (coin
      (type "retro")
      (z-pos 49)
      (x 3616)
      (y 832)
    )
    (coin
      (type "retro")
      (z-pos 49)
      (x 3584)
      (y 832)
    )
    (coin
      (type "retro")
      (z-pos 49)
      (x 3520)
      (y 832)
    )
    (coin
      (type "retro")
      (z-pos 49)
      (x 3552)
      (y 832)
    )
    (coin
      (type "retro")
      (z-pos 49)
      (x 3488)
      (y 832)
    )
    (coin
      (type "retro")
      (z-pos 49)
      (x 3488)
      (y 864)
    )
    (coin
      (type "retro")
      (z-pos 49)
      (x 3488)
      (y 896)
    )
    (coin
      (type "retro")
      (z-pos 49)
      (x 3520)
      (y 896)
    )
    (coin
      (type "retro")
      (z-pos 49)
      (x 3552)
      (y 896)
    )
    (coin
      (type "retro")
      (z-pos 49)
      (x 3584)
      (y 896)
    )
    (coin
      (type "retro")
      (z-pos 49)
      (x 3616)
      (y 896)
    )
    (coin
      (type "retro")
      (z-pos 49)
      (x 3616)
      (y 864)
    )
    (coin
      (type "retro")
      (z-pos 49)
      (x 7904)
      (y 704)
    )
    (coin
      (type "retro")
      (z-pos 49)
      (x 7936)
      (y 704)
    )
    (coin
      (type "retro")
      (z-pos 49)
      (x 7968)
      (y 704)
    )
    (coin
      (type "retro")
      (z-pos 49)
      (x 8160)
      (y 640)
    )
    (coin
      (type "retro")
      (z-pos 49)
      (x 8192)
      (y 640)
    )
    (coin
      (type "retro")
      (z-pos 49)
      (x 8224)
      (y 640)
    )
    (coin
      (type "retro")
      (z-pos 49)
      (x 11008)
      (y 320)
    )
    (coin
      (type "retro")
      (z-pos 49)
      (x 11040)
      (y 352)
    )
    (coin
      (type "retro")
      (z-pos 49)
      (x 11072)
      (y 384)
    )
    (coin
      (type "retro")
      (z-pos 49)
      (x 11104)
      (y 416)
    )
    (coin
      (type "retro")
      (z-pos 49)
      (x 11136)
      (y 384)
    )
    (coin
      (type "retro")
      (z-pos 49)
      (x 11168)
      (y 352)
    )
    (coin
      (type "retro")
      (z-pos 49)
      (x 11200)
      (y 320)
    )
    (coin
      (type "retro")
      (z-pos 49)
      (x 11200)
      (y 288)
    )
    (coin
      (type "retro")
      (z-pos 49)
      (x 11168)
      (y 256)
    )
    (coin
      (type "retro")
      (z-pos 49)
      (x 11136)
      (y 256)
    )
    (coin
      (type "retro")
      (z-pos 49)
      (x 11104)
      (y 288)
    )
    (coin
      (type "retro")
      (z-pos 49)
      (x 11072)
      (y 256)
    )
    (coin
      (type "retro")
      (z-pos 49)
      (x 11040)
      (y 256)
    )
    (coin
      (type "retro")
      (z-pos 49)
      (x 11008)
      (y 288)
    )
    (coin
      (type "retro")
      (z-pos 49)
      (x 1664)
      (y 544)
    )
    (coin
      (type "retro")
      (z-pos 49)
      (x 2560)
      (y 1056)
    )
    (coin
      (type "retro")
      (z-pos 49)
      (x 2624)
      (y 1056)
    )
    (coin
      (type "retro")
      (z-pos 49)
      (x 2688)
      (y 1056)
    )
    (coin
      (type "retro")
      (z-pos 49)
      (x 2752)
      (y 1056)
    )
    (coin
      (type "retro")
      (z-pos 49)
      (x 2816)
      (y 1056)
    )
    (coin
      (type "retro")
      (z-pos 49)
      (x 96)
      (y 608)
    )
    (coin
      (type "retro")
      (z-pos 49)
      (x 128)
      (y 608)
    )
    (coin
      (type "retro")
      (z-pos 49)
      (x 160)
      (y 608)
    )
    (coin
      (type "retro")
      (z-pos 49)
      (x 192)
      (y 608)
    )
    (coin
      (type "retro")
      (z-pos 49)
      (x 224)
      (y 608)
    )
    (coin
      (type "retro")
      (z-pos 49)
      (x 256)
      (y 608)
    )
    (coin
      (type "retro")
      (z-pos 49)
      (x 288)
      (y 608)
    )
    (coin
      (type "retro")
      (z-pos 49)
      (x 320)
      (y 608)
    )
    (coin
      (type "retro")
      (z-pos 49)
      (x 352)
      (y 608)
    )
    (coin
      (type "retro")
      (z-pos 49)
      (x 384)
      (y 608)
    )
    (coin
      (type "retro")
      (z-pos 49)
      (x 416)
      (y 608)
    )
    (coin
      (type "retro")
      (z-pos 49)
      (x 448)
      (y 608)
    )
    (coin
      (type "retro")
      (z-pos 49)
      (x 480)
      (y 608)
    )
    (coin
      (type "retro")
      (z-pos 49)
      (x 512)
      (y 608)
    )
    (coin
      (type "retro")
      (z-pos 49)
      (x 544)
      (y 608)
    )
    (coin
      (type "retro")
      (z-pos 49)
      (x 576)
      (y 608)
    )
    (coin
      (type "retro")
      (z-pos 49)
      (x 608)
      (y 608)
    )
    (coin
      (type "retro")
      (z-pos 49)
      (x 640)
      (y 608)
    )
    (coin
      (type "retro")
      (z-pos 49)
      (x 672)
      (y 608)
    )
    (coin
      (type "retro")
      (z-pos 49)
      (x 704)
      (y 608)
    )
    (coin
      (type "retro")
      (z-pos 49)
      (x 736)
      (y 608)
    )
    (coin
      (type "retro")
      (z-pos 49)
      (x 768)
      (y 608)
    )
    (coin
      (type "retro")
      (z-pos 49)
      (x 800)
      (y 608)
    )
    (coin
      (type "retro")
      (z-pos 49)
      (x 832)
      (y 608)
    )
    (coin
      (type "retro")
      (z-pos 49)
      (x 864)
      (y 608)
    )
    (coin
      (type "retro")
      (z-pos 49)
      (x 896)
      (y 608)
    )
    (coin
      (type "retro")
      (z-pos 49)
      (x 928)
      (y 608)
    )
    (coin
      (type "retro")
      (z-pos 49)
      (x 3296)
      (y 544)
    )
    (coin
      (type "retro")
      (z-pos 49)
      (x 3328)
      (y 544)
    )
    (coin
      (type "retro")
      (z-pos 49)
      (x 3392)
      (y 544)
    )
    (coin
      (type "retro")
      (z-pos 49)
      (x 3424)
      (y 544)
    )
    (decal
      (z-pos -120)
      (sprite "/images/decal/retro/title_old.sprite")
      (x 10672)
      (y 16)
    )
    (decal
      (z-pos 10)
      (sprite "/images/decal/retro/penny_old.png")
      (x 11168)
      (y 416)
    )
    (decal
      (z-pos 10)
      (sprite "/images/decal/retro/tux_old.png")
      (x 11040)
      (y 416)
    )
    (decal
      (z-pos -110)
      (sprite "/images/decal/misc/flag.sprite")
      (x 9248)
      (y 256)
    )
    (firefly
      (z-pos 0)
      (x 5312)
      (y 736)
    )
    (invisible_block
      (type "retro")
      (z-pos 51)
      (x 8608)
      (y 320)
    )
    (invisible_block
      (type "retro")
      (z-pos 51)
      (x 8608)
      (y 192)
    )
    (jumpy
      (type "bag")
      (z-pos 50)
      (x 4096)
      (y 832)
    )
    (jumpy
      (type "bag")
      (z-pos 50)
      (x 4736)
      (y 576)
    )
    (jumpy
      (type "bag")
      (z-pos 50)
      (x 6048)
      (y 832)
    )
    (jumpy
      (type "bag")
      (z-pos 50)
      (x 6240)
      (y 832)
    )
    (jumpy
      (type "bag")
      (z-pos 50)
      (x 5024)
      (y 640)
    )
    (jumpy
      (type "bag")
      (z-pos 50)
      (x 3184)
      (y 480)
    )
    (jumpy
      (type "bag")
      (z-pos 50)
      (x 3536)
      (y 480)
    )
    (leveltime
      (time 255)
    )
    (mriceblock
      (type "laptop")
      (z-pos 50)
      (direction "left")
      (x 4416)
      (y 608)
    )
    (mriceblock
      (type "laptop")
      (z-pos 50)
      (direction "left")
      (x 5696)
      (y 896)
    )
    (mriceblock
      (type "laptop")
      (z-pos 50)
      (direction "left")
      (x 7392)
      (y 768)
    )
    (music
      (file "/music/retro/cave_old.music")
    )
    (path
      (name "gen16513141143178496197520")
      (path
        (mode "oneshot")
        (adapt_speed #f)
        (node
          (x 9728)
          (y 32)
        )
      )
    )
    (secretarea
      (width 704)
      (height 448)
      (x 10592)
      (y 32)
    )
    (secretarea
      (width 880)
      (height 80)
      (x 96)
      (y 560)
    )
    (sequencetrigger
      (sequence "stoptux")
      (width 32)
      (height 160)
      (x 9952)
      (y 416)
    )
    (sequencetrigger
      (sequence "endsequence")
      (width 32)
      (height 352)
      (x 9312)
      (y 224)
    )
    (snowball
      (type "bsod")
      (z-pos 50)
      (direction "left")
      (x 1952)
      (y 576)
    )
    (snowball
      (type "bsod")
      (z-pos 50)
      (direction "left")
      (x 2752)
      (y 576)
    )
    (snowball
      (type "bsod")
      (z-pos 50)
      (direction "left")
      (x 5856)
      (y 896)
    )
    (snowball
      (type "bsod")
      (z-pos 50)
      (direction "left")
      (x 5792)
      (y 896)
    )
    (snowball
      (type "bsod")
      (z-pos 50)
      (direction "left")
      (x 7520)
      (y 896)
    )
    (snowball
      (type "bsod")
      (z-pos 50)
      (direction "left")
      (x 7456)
      (y 896)
    )
    (snowball
      (type "bsod")
      (z-pos 50)
      (direction "left")
      (x 8576)
      (y 544)
    )
    (snowball
      (type "bsod")
      (z-pos 50)
      (x 2656)
      (y 576)
    )
    (snowball
      (type "bsod")
      (z-pos 50)
      (x 800)
      (y 512)
    )
    (snowball
      (type "bsod")
      (z-pos 50)
      (x 736)
      (y 512)
    )
    (snowball
      (type "bsod")
      (z-pos 50)
      (x 672)
      (y 512)
    )
    (spawnpoint
      (name "main")
      (x 96)
      (y 416)
    )
    (tilemap
      (solid #f)
      (z-pos -100)
      (width 355)
      (height 42)
      (tiles -330 0 4210 -3 4211 4212 -324 0 4210 -25 4211 4224 -2 2035 4213 4220 -324 0 4214 -28 2035 4216 -325 0 4214 -28 2035 4216 -325 0 4214 -28 2035 4216 -1021 0 80 -354 0 79 -354 0 79 -354 0 79 -354 0 79 -354 0 79 -354 0 79 -13 0 4210 -8 4211 -33 0 93 94 95 96 -295 0 79 -13 0 4214 -8 2035 -33 0 97 98 99 100 -20 0 93 94 95 96 -271 0 79 -13 0 4214 -8 2035 -57 0 97 98 99 100 -248 0 93 94 95 96 -19 0 79 -13 0 4214 -8 2035 -309 0 97 98 99 100 -19 0 79 -13 0 4214 -8 2035 -93 0 93 94 95 96 -49 0 93 94 95 96 -2248 0 93 94 95 96 -208 0 93 94 95 96 -351 0 97 98 99 100 -471 0 93 94 95 96 -323 0 93 94 95 96 -24 0 97 98 99 100 -268 0 93 94 95 96 -1351 0 93 94 95 96 -351 0 97 98 99 100 -18 0 93 94 95 96 -2759 0)
    )
    (tilemap
      (solid #f)
      (z-pos 100)
      (width 355)
      (height 42)
      (tiles -307 0 5175 -22 36 5176 -331 0 38 -22 36 43 -331 0 38 -22 36 43 -331 0 38 -22 36 43 -331 0 5161 -22 36 5162 -331 0 5168 -22 36 5169 -2461 0 5175 -5 36 -349 0 38 -5 36 -349 0 38 -5 36 -44 0 5169 -2 37 39 -301 0 38 -5 36 -44 0 -3 36 5162 -301 0 38 -5 36 -44 0 -3 36 5169 -301 0 5161 -5 36 -44 0 -28 36 43 -276 0 5168 -5 36 -44 0 -28 36 5162 -326 0 -28 36 5169 -7779 0)
    )
    (tilemap
      (handle
        (scale_x 0)
        (scale_y 0)
        (offset_x 0)
        (offset_y 0)
      )
      (solid #f)
      (z-pos -110)
      (path-ref "gen16513141143178496197520")
      (width 30)
      (height 17)
      (tiles 212 -28 0 -2 212 -28 0 -2 212 -28 0 212 213 -28 0 213 -240 0 211 -29 0 212 -29 0 212 -29 0 212 -29 0 213 -29 0)
    )
    (tilemap
      (solid #f)
      (tint 0.5 0.5 0.55)
      (z-pos -110)
      (width 355)
      (height 42)
      (tiles -277 0 38 -3 36 43 -350 0 38 -3 36 43 -350 0 38 -3 36 43 -350 0 38 -3 36 43 -350 0 38 -3 36 43 -705 0 38 -3 36 43 -350 0 38 -3 36 43 -350 0 38 -3 36 43 -175 0 33 -3 32 -171 0 38 -3 36 43 -175 0 38 -2 36 37 -2 36 43 -168 0 38 -3 36 43 -175 0 38 -5 36 43 -37 0 38 -3 36 43 -126 0 38 -3 36 43 -175 0 38 -5 36 43 -37 0 38 -3 36 43 -126 0 38 -3 36 43 -175 0 38 -5 36 43 -37 0 38 -3 36 43 -126 0 38 -3 36 43 -175 0 38 -5 36 43 -37 0 38 -3 36 43 -4 0 38 -3 36 43 -117 0 38 -3 36 43 -175 0 38 -5 36 43 -37 0 38 -3 36 43 -4 0 38 -3 36 43 -297 0 38 -5 36 43 -37 0 38 -3 36 43 -4 0 38 -3 36 43 -4 0 38 -3 36 43 -288 0 38 -5 36 43 -37 0 38 -3 36 43 -4 0 38 -3 36 43 -4 0 38 -3 36 43 -288 0 38 -2 36 41 -2 36 43 -37 0 38 -3 36 43 -4 0 38 -3 36 43 -4 0 38 -3 36 43 -332 0 38 -3 36 43 -4 0 38 -3 36 43 -4 0 38 -3 36 43 -233 0 38 -2 36 43 -6 0 38 -2 36 43 -19 0 38 -2 36 43 -62 0 38 -3 36 43 -4 0 38 -3 36 43 -4 0 38 -3 36 43 -233 0 38 -2 36 43 -6 0 38 -2 36 43 -19 0 38 -2 36 43 -42 0 38 -3 36 43 -5 0 38 -3 36 43 -5 0 38 -3 36 43 -4 0 38 -3 36 43 -4 0 38 -3 36 43 -233 0 38 -2 36 43 -6 0 38 -2 36 43 -19 0 38 -2 36 43 -42 0 38 -3 36 43 -5 0 38 -3 36 43 -14 0 38 -3 36 43 -4 0 38 -3 36 43 -233 0 38 -2 36 43 -6 0 38 -2 36 43 -19 0 38 -2 36 43 -42 0 38 -3 36 43 -5 0 38 -3 36 43 -14 0 38 -3 36 43 -4 0 38 -3 36 43 -233 0 38 -2 36 43 -6 0 38 -2 36 43 -19 0 38 -2 36 43 -42 0 38 -3 36 43 -5 0 38 -3 36 43 -23 0 38 -3 36 43 -233 0 38 -2 36 43 -6 0 38 -2 36 43 -19 0 38 -2 36 43 -42 0 38 -3 36 43 -5 0 38 -3 36 43 -23 0 38 -3 36 43 -233 0 38 -2 36 43 -6 0 38 -2 36 43 -19 0 38 -2 36 43 -42 0 38 -3 36 43 -5 0 38 -3 36 43 -340 0 38 -3 36 43 -5 0 38 -3 36 43 -340 0 38 -3 36 43 -5 0 38 -3 36 43 -340 0 38 -3 36 43 -5 0 38 -3 36 43 -340 0 38 -3 36 43 -5 0 38 -3 36 43 -4119 0)
    )
    (tilemap
      (solid #t)
      (z-pos 0)
      (width 355)
      (height 42)
      (tiles -2 36 43 -6 0 38 -120 36 43 -5 0 38 -13 36 43 -4 0 38 -3 36 43 -4 0 38 -59 36 43 -7 0 38 -29 36 43 -14 0 40 -75 41 5175 -3 36 43 -6 0 38 -120 36 43 -5 0 38 -13 36 43 -4 0 38 -3 36 43 -4 0 38 -59 36 43 -7 0 38 -29 36 43 -41 0 27 -28 28 29 -19 0 38 -3 36 43 -6 0 38 -120 36 43 -5 0 38 -13 36 43 -4 0 38 -3 36 43 -4 0 38 -59 36 43 -7 0 38 -29 36 43 -90 0 38 -3 36 43 -6 0 38 -120 36 43 -5 0 38 -13 36 43 -4 0 38 -3 36 43 -4 0 38 -59 36 43 -7 0 38 -29 36 43 -90 0 38 -3 36 43 -6 0 38 -120 36 43 -5 0 38 -13 36 43 -4 0 38 -3 36 43 -4 0 38 -59 36 43 -7 0 38 -29 36 43 -14 0 33 -3 32 34 -3 0 33 34 -3 0 33 -42 32 34 -19 0 38 -3 36 43 -6 0 38 -120 36 43 -5 0 38 -13 36 43 -4 0 38 -3 36 43 -4 0 38 -59 36 43 -7 0 38 -29 36 43 -14 0 35 -3 37 39 -3 0 35 39 -3 0 35 -42 37 39 -19 0 38 -3 36 43 -6 0 38 -120 36 43 -5 0 38 -13 36 43 -4 0 38 -3 36 43 -4 0 38 -59 36 43 -7 0 38 -25 36 5176 -3 41 42 -14 0 40 -3 41 42 -3 0 40 42 -3 0 40 -9 41 5175 -32 36 5162 32 34 -17 0 38 -3 36 43 -6 0 38 -120 36 43 -5 0 38 -13 36 43 -4 0 38 -3 36 43 -4 0 38 -59 36 43 -7 0 38 -25 36 43 -41 0 38 -32 36 5169 37 39 -17 0 38 -3 36 43 -6 0 38 -64 36 5176 -18 41 5175 -36 36 43 -5 0 38 -13 36 43 -4 0 38 -3 36 43 -4 0 38 -59 36 43 -7 0 38 -25 36 43 -41 0 38 -32 36 5176 41 42 -17 0 38 -3 36 43 -6 0 40 -37 41 5175 -26 36 43 -18 0 40 -2 41 5175 -33 36 43 -5 0 38 -13 36 43 -4 0 38 -3 36 43 -4 0 38 -59 36 43 -7 0 38 -21 36 5176 -3 41 42 -41 0 40 5175 -31 36 43 -3 0 33 34 -14 0 38 -3 36 43 -44 0 40 -15 41 5175 -8 36 5176 41 42 -21 0 40 -20 41 5175 -10 36 5176 41 42 -5 0 40 41 5175 -11 36 43 -4 0 38 -3 36 43 -4 0 38 -59 36 43 -7 0 38 -21 36 43 -46 0 40 5175 -30 36 43 -3 0 35 39 -14 0 38 -3 36 43 -60 0 38 -8 36 43 -44 0 40 5175 -9 36 43 -9 0 38 -11 36 43 -4 0 38 -3 36 43 -4 0 38 -59 36 43 -7 0 38 -21 36 43 -47 0 40 5175 -29 36 43 -3 0 40 42 -14 0 38 -3 36 43 -60 0 40 -4 41 5175 36 5176 41 42 -45 0 40 -9 41 42 -9 0 40 -11 41 42 -4 0 38 -3 36 43 -4 0 38 -59 36 43 -7 0 38 -17 36 5176 -3 41 42 -48 0 40 -8 41 5175 -20 36 43 -6 0 33 34 -11 0 38 -3 36 43 -65 0 38 36 43 -84 0 38 -3 36 43 -4 0 38 -59 36 43 -7 0 38 -17 36 43 -53 0 27 -6 28 29 38 -20 36 43 -6 0 35 39 -11 0 38 -3 36 5162 -2 32 34 -62 0 38 36 43 -31 0 33 -5 32 34 -46 0 40 -3 41 42 -4 0 38 -55 36 5176 -3 41 42 -7 0 40 -10 41 5175 -6 36 43 -26 0 33 -3 32 34 -30 0 38 -20 36 5162 -6 32 5161 5162 -11 32 5161 -3 36 7264 -2 121 120 -3 0 33 34 -57 0 38 36 43 -31 0 119 -5 121 120 -55 0 38 -51 36 5176 -3 41 42 -22 0 40 -6 41 42 -26 0 35 -3 37 39 -30 0 38 -20 36 5169 -6 37 5168 5169 -11 37 5168 -3 36 43 0 33 -4 32 5154 5155 -19 32 34 -5 0 33 -3 32 34 -27 0 38 36 43 -25 0 33 34 -15 0 33 34 -49 0 40 -9 41 5175 -37 36 5176 -3 41 42 -60 0 38 -3 36 43 -30 0 38 -44 36 43 0 35 -4 37 5168 5169 -19 37 39 -5 0 35 -3 37 5155 34 -26 0 38 36 43 -24 0 33 5154 39 -15 0 35 5155 34 -58 0 40 5175 -32 36 5176 -3 41 42 -52 0 33 -7 32 34 -3 0 38 -3 36 43 -3 0 33 -26 32 5161 -44 36 43 0 40 -25 41 42 -5 0 38 -3 36 5169 5155 -20 32 34 -5 0 38 36 43 -5 0 33 -10 32 34 -5 0 33 32 5154 5168 5162 -15 32 5161 5169 5155 32 34 -57 0 40 -32 41 42 -56 0 35 -7 37 39 -3 0 38 -3 36 43 -3 0 35 -26 37 5168 -44 36 5162 -33 32 5161 -4 36 5169 -20 37 39 -5 0 38 36 43 -5 0 35 -10 37 39 -5 0 35 37 5168 36 5169 -15 37 5168 36 5169 37 39 -8 0 33 -13 32 34 -122 0 33 32 5161 -7 36 43 -3 0 38 -3 36 43 -3 0 38 -71 36 5169 -33 37 5168 -6 36 5176 -18 41 42 -5 0 38 36 43 -5 0 40 -10 41 42 -5 0 38 -23 36 43 -8 0 35 -13 37 39 -122 0 35 37 5168 -7 36 43 -3 0 38 -3 36 43 -3 0 38 -111 36 5176 42 -24 0 38 36 43 -22 0 38 -13 36 5176 -9 41 42 -8 0 40 -13 41 42 -5 0 33 -3 32 34 -103 0 33 -3 32 34 -2 0 33 32 5161 -9 36 43 -3 0 38 -3 36 43 -3 0 38 -110 36 5176 42 -23 0 33 32 5161 36 5162 32 34 -20 0 38 -13 36 43 -38 0 35 -3 37 39 -103 0 35 -3 37 39 -2 0 35 37 5168 -9 36 43 -3 0 38 -3 36 43 -3 0 38 -110 36 43 -24 0 119 5184 5168 36 5169 5183 120 -20 0 38 -13 36 43 -13 0 33 34 -23 0 38 -3 36 43 -4 0 33 -3 32 34 -86 0 33 -3 32 34 -3 0 38 -3 36 43 -2 0 38 -11 36 43 -3 0 38 -3 36 43 -3 0 38 -110 36 43 -25 0 40 5175 36 5176 42 -21 0 38 -13 36 43 -13 0 35 39 -23 0 38 -3 36 43 -4 0 35 -3 37 39 -64 0 33 -7 32 34 -13 0 35 -3 37 39 -3 0 38 -3 36 43 -2 0 38 -11 36 43 -3 0 38 -3 36 43 -3 0 38 -110 36 43 -26 0 38 36 43 -22 0 38 -13 36 43 -13 0 40 42 -23 0 38 -3 36 43 -4 0 38 -3 36 43 -4 0 33 -3 32 34 -22 0 33 32 34 -30 0 119 -7 121 120 -4 0 33 -3 32 34 -4 0 38 -3 36 43 -3 0 38 -3 36 43 -2 0 38 -11 36 43 -3 0 38 -3 36 43 -3 0 38 -110 36 43 -5 0 33 -20 32 5161 36 5162 -16 32 34 -5 0 38 -13 36 43 -38 0 38 -3 36 43 -4 0 38 -3 36 43 -4 0 35 -3 37 5155 34 -15 0 33 32 34 -3 0 35 37 39 -3 0 33 32 34 -14 0 33 -4 32 34 -17 0 35 -3 37 39 -4 0 38 -3 36 43 -3 0 38 -3 36 43 -2 0 38 -11 36 43 -3 0 38 -3 36 43 -3 0 38 -110 36 43 -5 0 35 -20 37 5168 36 5169 -16 37 39 -5 0 38 -13 36 43 -8 0 33 34 -28 0 38 -3 36 43 -4 0 38 -3 36 43 -4 0 38 -3 36 5169 5155 34 -14 0 35 37 39 -3 0 38 36 43 -3 0 35 37 39 -14 0 35 -4 37 39 -17 0 38 -3 36 43 -4 0 38 -3 36 43 -3 0 38 -3 36 43 -2 0 38 -11 36 43 -3 0 38 -3 36 43 -3 0 38 -110 36 43 -5 0 40 -39 41 42 -5 0 38 -13 36 43 -8 0 35 39 -28 0 38 -3 36 43 -4 0 38 -3 36 43 -4 0 38 -4 36 5169 5155 -14 32 5161 36 5162 -3 32 5161 36 5162 -3 32 5161 36 5162 -8 32 34 -5 0 38 -4 36 5162 -17 32 5161 -3 36 43 -4 0 38 -3 36 43 -3 0 38 -3 36 43 -2 0 38 -11 36 43 -3 0 38 -3 36 43 -3 0 38 -110 36 43 -51 0 38 -13 36 5162 -8 32 5161 5162 -12 32 34 -5 0 33 -3 32 34 -5 0 38 -3 36 43 -4 0 38 -3 36 43 -4 0 38 -5 36 5169 -14 37 5168 36 5169 -3 37 5168 36 5169 -3 37 5168 36 5169 -8 37 39 -5 0 38 -4 36 5169 -17 37 5168 -3 36 43 -4 0 38 -3 36 43 -3 0 38 -3 36 43 -2 0 38 -11 36 43 -3 0 38 -3 36 43 -3 0 38 -110 36 5162 32 34 -47 0 33 32 5161 -13 36 5169 -8 37 5168 5169 -12 37 39 -5 0 35 -3 37 39 -5 0 38 -3 36 43 -4 0 38 -3 36 43 -4 0 38 -43 36 43 -5 0 38 -26 36 43 -4 0 38 -3 36 43 -3 0 38 -3 36 43 -2 0 38 -11 36 43 -3 0 38 -3 36 43 -3 0 38 -110 36 5169 5183 120 -47 0 119 5184 5168 -36 36 43 -5 0 38 -3 36 43 -5 0 38 -3 36 43 -4 0 38 -3 36 43 -4 0 38 -43 36 43 -5 0 38 -26 36 43 -4 0 38 -3 36 43 -3 0 38 -3 36 43 -2 0 38 -11 36 43 -3 0 38 -3 36 43 -3 0 38 -110 36 5176 42 -49 0 40 5175 -36 36 43 -5 0 38 -3 36 43 -5 0 38 -3 36 43 -4 0 38 -3 36 43 -4 0 38 -43 36 43 -5 0 38 -26 36 43 -4 0 38 -3 36 43 -3 0 38 -3 36 43 -2 0 38 -11 36 43 -3 0 38 -3 36 43 -3 0 38 -110 36 43 -51 0 38 -36 36 43 -5 0 38 -3 36 43 -5 0 38 -3 36 43 -4 0 38 -3 36 43 -4 0 38 -43 36 43 -5 0 38 -26 36 43 -4 0 38 -3 36 43 -3 0 38 -3 36 43 -2 0 38 -11 36 43 -3 0 38 -3 36 43 -3 0 38 -110 36 5162 -20 32 34 -13 0 33 -16 32 5161 -36 36 43 -5 0 38 -3 36 43 -5 0 38 -3 36 43 -4 0 38 -3 36 43 -4 0 38 -43 36 43 -5 0 38 -26 36 43 -4 0 38 -3 36 43 -3 0 38 -3 36 43 -2 0 38 -11 36 43 -3 0 38 -3 36 43 -3 0 38 -110 36 5169 -20 37 39 -13 0 35 -16 37 5168 -36 36 43 -5 0 38 -3 36 43 -5 0 38 -3 36 43 -4 0 38 -3 36 43 -4 0 38 -43 36 43 -5 0 38 -26 36 43 -4 0 38 -3 36 43 -3 0 38 -3 36 43 -2 0 38 -11 36 43 -3 0 38 -3 36 43 -3 0 38 -131 36 43 -5 0 33 32 34 -5 0 38 -53 36 43 -5 0 38 -3 36 43 -5 0 38 -3 36 43 -4 0 38 -3 36 43 -4 0 38 -43 36 43 -5 0 38 -26 36 43 -4 0 38 -3 36 43 -3 0 38 -3 36 43 -2 0 38 -11 36 43 -3 0 38 -3 36 43 -3 0 38 -131 36 43 -5 0 35 37 39 -5 0 38 -53 36 43 -5 0 38 -3 36 43 -5 0 38 -3 36 43 -4 0 38 -3 36 43 -4 0 38 -43 36 43 -5 0 38 -26 36 43 -4 0 38 -3 36 43 -3 0 38 -3 36 43 -2 0 38 -11 36 43 -3 0 38 -3 36 43 -3 0 38 -131 36 43 -5 0 38 36 43 -5 0 38 -53 36 43 -5 0 38 -3 36 43 -5 0 38 -3 36 43 -4 0 38 -3 36 43 -4 0 38 -43 36 43 -5 0 38 -26 36 43 -4 0 38 -3 36 43 -3 0 38 -3 36 43 -2 0 38 -11 36 43 -3 0 38 -3 36 43 -3 0 38 -131 36 43 -5 0 38 36 43 -5 0 38 -53 36 43 -5 0 38 -3 36 43 -5 0 38 -3 36 43 -4 0 38 -3 36 43 -4 0 38 -43 36 43 -5 0 38 -26 36 43 -4 0 38 -3 36 43 -3 0 38 -3 36 43 -2 0 38 -11 36 43 -3 0 38 -3 36 43 -3 0 38 -131 36 43 -5 0 38 36 43 -5 0 38 -53 36 43 -5 0 38 -3 36 43 -5 0 38 -3 36 43 -4 0 38 -3 36 43 -4 0 38 -43 36 43 -5 0 38 -26 36 43 -4 0 38 -3 36 43 -3 0 38 -3 36 43 -2 0 38 -11 36 43 -3 0 38 -3 36 43 -3 0 38 -131 36 43 -5 0 38 36 43 -5 0 38 -53 36 43 -5 0 38 -3 36 43 -5 0 38 -3 36 43 -4 0 38 -3 36 43 -4 0 38 -43 36 43 -5 0 38 -26 36 43 -4 0 38 -3 36 43 -3 0 38 -3 36 43 -2 0 38 -11 36 43 -3 0 38 -3 36 43 -3 0 38 -69 36)
    )
  )
)
