(supertux-level
  (version 3)
  (name (_ "Revenge in Redmond"))
  (author "alex")
  (license "CC-BY-SA 4.0 International")
  (sector
    (name "main")
    (ambient-light
      (color 1 1 1)
    )
    (decal
      (z-pos 10)
      (sprite "/images/worldmap/shared/castle.png")
      (x 448)
      (y 224)
    )
    (decal
      (z-pos -10)
      (sprite "/images/decal/retro/map.png")
      (x 352)
      (y 224)
    )
    (decal
      (sprite "/images/background/nightsky/nightsky_top.png")
      (x 0)
      (y 544)
    )
    (decal
      (sprite "/images/background/nightsky/nightsky_top.png")
      (x 800)
      (y 544)
    )
    (decal
      (sprite "/images/background/nightsky/nightsky_top.png")
      (x 992)
      (y -32)
    )
    (decal
      (sprite "/images/background/nightsky/nightsky_top.png")
      (x -448)
      (y -32)
    )
    (decal
      (sprite "/images/background/nightsky/nightsky_top.png")
      (x 224)
      (y -384)
    )
    (level
      (level "nostalgia.stl")
      (x 29)
      (y 11)
    )
    (level
      (level "its_been_ages.stl")
      (x 25)
      (y 13)
    )
    (level
      (level "long_office_nights.stl")
      (x 20)
      (y 14)
    )
    (level
      (level "deep_cave.stl")
      (x 13)
      (y 11)
    )
    (level
      (level "redmond_headquarters.stl")
      (x 15)
      (y 9)
    )
    (level
      (level "retro_age.stl")
      (x 16)
      (y 13)
    )
    (music
      (file "/music/retro/worldmap_old.music")
    )
    (tilemap
      (solid #t)
      (z-pos 0)
      (width 40)
      (height 25)
      (tiles
      102 102 102 102 102 102 103 9 9 9 9 0 0 107 108 108 108 108 108 108 108 108 109 0 0 0 0 0 0 9 9 9 9 9 9 9 9 9 9 9
      105 105 105 105 105 105 112 103 9 9 9 0 0 0 0 0 0 0 0 0 0 0 0 0 0 0 101 102 102 102 103 9 9 101 102 102 102 102 102 103
      105 105 105 105 105 105 105 112 103 9 9 0 0 0 101 102 102 102 102 102 102 102 102 102 102 102 113 105 105 105 112 102 102 113 105 105 105 105 105 112
      105 105 105 105 105 105 105 105 112 103 9 0 0 101 113 105 105 105 105 105 105 105 105 105 105 105 105 105 105 105 105 105 105 105 105 105 105 105 105 105
      105 105 105 105 105 105 105 105 105 112 102 102 102 113 105 105 105 114 105 105 105 105 105 105 105 105 105 105 105 105 105 105 105 105 105 105 105 105 105 105
      105 105 105 105 105 105 105 105 105 105 105 105 105 105 105 105 105 105 105 105 105 105 105 105 105 105 105 105 105 105 105 110 108 108 111 105 105 105 105 105
      105 105 105 105 105 105 110 108 108 108 111 105 105 105 105 105 105 105 105 105 105 105 105 105 105 105 105 105 105 105 105 106 9 9 107 108 108 108 108 108
      105 105 105 105 110 108 109 9 9 9 107 0 0 0 0 0 0 0 0 0 0 0 0 0 0 0 0 0 0 0 0 109 9 9 9 9 9 9 9 9
      108 108 108 108 109 9 9 9 9 9 9 0 0 0 0 0 0 0 0 0 0 9 0 0 0 0 0 0 0 0 0 9 9 9 9 9 9 9 9 9
      9 9 9 9 9 9 9 9 9 9 9 9 9 10 20 20 23 9 9 9 9 9 9 9 9 9 9 9 9 19 9 9 9 9 9 9 9 9 9 9
      9 9 9 9 9 101 102 102 103 9 9 9 9 21 9 9 9 9 9 9 9 9 9 9 9 9 9 9 9 21 9 9 9 9 9 9 9 9 9 9
      9 9 9 9 9 104 114 110 109 9 9 9 9 21 9 9 9 9 9 9 9 9 9 9 9 9 9 9 9 21 9 9 9 9 9 9 9 9 9 9
      9 9 9 9 9 107 108 109 9 9 9 9 9 21 9 9 9 9 9 9 9 9 9 9 9 9 9 9 10 15 9 9 9 9 101 103 9 9 9 9
      9 9 9 9 9 9 9 9 9 9 9 9 9 14 20 20 20 20 11 9 9 9 9 10 20 20 20 20 15 9 9 9 9 9 107 109 9 9 9 9
      9 9 9 9 9 9 9 9 9 9 9 9 9 9 9 9 9 9 14 20 20 20 20 15 9 9 9 9 9 9 9 9 9 9 9 9 9 9 9 9
      9 9 9 9 9 9 9 9 9 9 9 9 0 0 0 0 0 0 0 9 9 9 9 0 0 0 0 0 0 9 9 9 9 9 9 9 9 9 9 9
      102 102 102 102 103 9 9 9 9 101 102 9 9 9 0 0 0 0 0 0 0 0 0 0 9 9 9 9 9 9 9 103 9 9 9 9 9 9 9 9
      105 105 105 105 112 102 102 102 102 113 105 105 105 114 105 105 105 105 105 105 105 105 105 105 105 105 105 105 105 105 105 112 102 102 103 9 9 9 101 102
      105 105 105 105 105 105 105 105 105 105 105 105 105 105 105 105 105 105 105 105 105 105 110 108 108 108 108 108 108 111 105 105 105 105 112 102 102 102 113 105
      105 105 105 105 105 105 105 105 105 105 105 105 105 105 105 105 105 105 105 105 105 110 109 9 101 102 102 102 103 104 105 105 105 114 105 105 105 105 105 105
      105 105 105 105 105 105 105 105 105 105 105 105 105 105 105 105 105 105 105 105 105 112 102 102 113 105 105 105 112 113 105 105 105 105 105 105 105 105 105 105
      105 105 105 105 105 105 105 105 110 108 108 108 108 108 108 108 108 108 108 108 111 105 105 110 108 108 108 111 105 110 108 111 105 105 105 105 105 105 105 105
      105 105 105 105 105 110 108 108 109 9 9 9 9 9 9 9 9 9 9 9 107 108 108 109 9 9 9 107 108 109 9 104 105 105 105 105 105 105 105 105
      105 105 105 105 105 106 9 101 102 102 102 102 102 102 102 103 9 9 9 9 9 9 9 9 9 9 9 9 9 101 102 113 105 105 105 105 105 105 105 105
      105 105 105 105 105 106 9 104 105 105 105 105 114 105 105 112 102 102 102 103 9 9 9 9 9 9 9 9 9 104 105 105 105 105 105 105 105 105 105 105
      )
    )
    (tilemap
      (solid #f)
      (z-pos -100)
      (name "water")
      (width 40)
      (height 25)
      (tiles
      1 1 1 1 1 1 1 1 1 1 1 1 1 1 1 1 1 1 1 1 1 1 1 1 1 1 1 1 1 1 1 1 1 1 1 1 1 1 1 1
      1 1 1 1 1 1 1 1 1 1 1 1 1 1 1 1 1 1 1 1 1 1 1 1 1 1 1 1 1 1 1 1 1 1 1 1 1 1 1 1
      1 1 1 1 1 1 1 1 1 1 1 1 1 1 1 1 1 1 1 1 1 1 1 1 1 1 1 1 1 1 1 1 1 1 1 1 1 1 1 1
      1 1 1 1 1 1 1 1 1 1 1 1 1 1 1 1 1 1 1 1 1 1 1 1 1 1 1 1 1 1 1 1 1 1 1 1 1 1 1 1
      1 1 1 1 1 1 1 1 1 1 1 1 1 1 1 1 1 1 1 1 1 1 1 1 1 1 1 1 1 1 1 1 1 1 1 1 1 1 1 1
      1 1 1 1 1 1 1 1 1 1 1 1 1 1 1 1 1 1 1 1 1 1 1 1 1 1 1 1 1 1 1 1 1 1 1 1 1 1 1 1
      1 1 1 1 1 1 1 1 1 1 1 1 1 1 1 1 1 1 1 1 1 1 1 1 1 1 1 1 1 1 1 1 1 1 1 1 1 1 1 1
      1 1 1 1 1 1 1 1 1 1 1 1 1 1 1 1 1 1 1 1 1 1 1 1 1 1 1 1 1 1 1 1 1 1 1 1 1 1 1 1
      1 1 1 1 1 1 1 1 1 1 1 1 1 1 1 1 1 1 1 1 1 1 1 1 1 1 1 1 1 1 1 1 1 1 1 1 1 1 1 1
      1 1 1 1 1 1 1 1 1 1 1 1 1 1 1 1 1 1 1 1 1 1 1 1 1 1 1 1 1 1 1 1 1 1 1 1 1 1 1 1
      1 1 1 1 1 1 1 1 1 1 1 1 1 1 1 1 1 1 1 1 1 1 1 1 1 1 1 1 1 1 1 1 1 1 1 1 1 1 1 1
      1 1 1 1 1 1 1 1 1 1 1 1 1 1 1 1 1 1 1 1 1 1 1 1 1 1 1 1 1 1 1 1 1 1 1 1 1 1 1 1
      1 1 1 1 1 1 1 1 1 1 1 1 1 1 1 1 1 1 1 1 1 1 1 1 1 1 1 1 1 1 1 1 1 1 1 1 1 1 1 1
      1 1 1 1 1 1 1 1 1 1 1 1 1 1 1 1 1 1 1 1 1 1 1 1 1 1 1 1 1 1 1 1 1 1 1 1 1 1 1 1
      1 1 1 1 1 1 1 1 1 1 1 1 1 1 1 1 1 1 1 1 1 1 1 1 1 1 1 1 1 1 1 1 1 1 1 1 1 1 1 1
      1 1 1 1 1 1 1 1 1 1 1 1 1 1 1 1 1 1 1 1 1 1 1 1 1 1 1 1 1 1 1 1 1 1 1 1 1 1 1 1
      1 1 1 1 1 1 1 1 1 1 1 1 1 1 1 1 1 1 1 1 1 1 1 1 1 1 1 1 1 1 1 1 1 1 1 1 1 1 1 1
      1 1 1 1 1 1 1 1 1 1 1 1 1 1 1 1 1 1 1 1 1 1 1 1 1 1 1 1 1 1 1 1 1 1 1 1 1 1 1 1
      1 1 1 1 1 1 1 1 1 1 1 1 1 1 1 1 1 1 1 1 1 1 1 1 1 1 1 1 1 1 1 1 1 1 1 1 1 1 1 1
      1 1 1 1 1 1 1 1 1 1 1 1 1 1 1 1 1 1 1 1 1 1 1 1 1 1 1 1 1 1 1 1 1 1 1 1 1 1 1 1
      1 1 1 1 1 1 1 1 1 1 1 1 1 1 1 1 1 1 1 1 1 1 1 1 1 1 1 1 1 1 1 1 1 1 1 1 1 1 1 1
      1 1 1 1 1 1 1 1 1 1 1 1 1 1 1 1 1 1 1 1 1 1 1 1 1 1 1 1 1 1 1 1 1 1 1 1 1 1 1 1
      1 1 1 1 1 1 1 1 1 1 1 1 1 1 1 1 1 1 1 1 1 1 1 1 1 1 1 1 1 1 1 1 1 1 1 1 1 1 1 1
      1 1 1 1 1 1 1 1 1 1 1 1 1 1 1 1 1 1 1 1 1 1 1 1 1 1 1 1 1 1 1 1 1 1 1 1 1 1 1 1
      1 1 1 1 1 1 1 1 1 1 1 1 1 1 1 1 1 1 1 1 1 1 1 1 1 1 1 1 1 1 1 1 1 1 1 1 1 1 1 1
      )
    )
    (tilemap
      (solid #f)
      (z-pos 10)
      (name "decal")
      (width 40)
      (height 25)
      (tiles
      162 162 162 162 162 162 162 162 162 162 162 162 162 162 162 162 162 162 162 162 162 162 162 162 162 162 162 162 162 162 162 162 162 162 162 162 162 162 162 162
      162 162 162 162 162 162 162 162 162 162 162 162 162 162 162 162 162 162 162 162 162 162 162 162 162 162 162 162 162 162 162 162 162 162 162 162 162 162 162 162
      162 162 162 162 162 162 162 162 162 162 162 162 162 162 162 162 162 162 162 162 162 162 162 162 162 162 162 162 162 162 162 162 162 162 162 162 162 162 162 162
      162 162 162 162 162 162 162 162 162 162 162 162 162 162 162 162 162 162 162 162 162 162 162 162 162 162 162 162 162 162 162 162 162 162 162 162 162 162 162 162
      162 162 162 162 162 162 162 162 162 162 162 162 162 162 162 162 162 162 162 162 162 162 162 162 162 162 162 162 162 162 162 162 162 162 162 162 162 162 162 162
      162 162 162 162 162 162 162 162 162 162 162 162 162 162 162 162 162 162 162 162 162 162 162 162 162 162 162 162 162 162 162 162 162 162 162 162 162 162 162 162
      162 162 162 162 162 162 162 162 162 162 162 162 162 162 162 162 162 162 162 162 162 162 162 162 162 162 162 162 162 162 162 162 162 162 162 162 162 162 162 162
      162 162 162 162 162 162 162 162 162 162 162 228 226 226 226 226 226 226 226 226 226 226 226 226 226 226 226 226 226 226 229 162 162 162 162 162 162 162 162 162
      162 162 162 162 162 162 162 162 162 162 162 224 0 0 0 0 0 0 0 0 0 0 0 0 0 0 0 0 0 0 222 162 162 162 162 162 162 162 162 162
      162 162 162 162 162 162 162 162 162 162 162 224 0 0 0 0 0 0 0 0 0 9 9 0 0 0 0 0 0 0 222 162 162 162 162 162 162 162 162 162
      162 162 162 162 162 162 162 162 162 162 162 224 0 0 0 0 0 0 0 0 0 0 0 0 0 0 0 0 0 0 222 162 162 162 162 162 162 162 162 162
      162 162 162 162 162 162 162 162 162 162 162 224 0 0 0 0 0 0 0 0 0 0 0 0 0 0 0 0 0 0 222 162 162 162 162 162 162 162 162 162
      162 162 162 162 162 162 162 162 162 162 162 224 0 0 0 0 0 0 0 0 0 0 0 0 0 0 0 0 0 0 222 162 162 162 162 162 162 162 162 162
      162 162 162 162 162 162 162 162 162 162 162 224 0 0 0 0 0 0 0 0 0 0 0 0 0 230 0 0 0 0 222 162 162 162 162 162 162 162 162 162
      162 162 162 162 162 162 162 162 162 162 162 224 0 0 0 0 0 0 0 0 0 0 0 0 0 0 0 0 0 0 222 162 162 162 162 162 162 162 162 162
      162 162 162 162 162 162 162 162 162 162 162 224 0 0 0 0 0 0 0 0 0 0 0 0 0 0 0 0 0 0 222 162 162 162 162 162 162 162 162 162
      162 162 162 162 162 162 162 162 162 162 162 231 220 220 220 220 220 220 220 220 220 220 220 220 220 220 220 220 220 220 232 162 162 162 162 162 162 162 162 162
      162 162 162 162 162 162 162 162 162 162 162 162 162 162 162 162 162 162 162 162 162 162 162 162 162 162 162 162 162 162 162 162 162 162 162 162 162 162 162 162
      162 162 162 162 162 162 162 162 162 162 162 162 162 162 162 162 162 162 162 162 162 162 162 162 162 162 162 162 162 162 162 162 162 162 162 162 162 162 162 162
      162 162 162 162 162 162 162 162 162 162 162 162 162 162 162 162 162 162 162 162 162 162 162 162 162 162 162 162 162 162 162 162 162 162 162 162 162 162 162 162
      162 162 162 162 162 162 162 162 162 162 162 162 162 162 162 162 162 162 162 162 162 162 162 162 162 162 162 162 162 162 162 162 162 162 162 162 162 162 162 162
      162 162 162 162 162 162 162 162 162 162 162 162 162 162 162 162 162 162 162 162 162 162 162 162 162 162 162 162 162 162 162 162 162 162 162 162 162 162 162 162
      162 162 162 162 162 162 162 162 162 162 162 162 162 162 162 162 162 162 162 162 162 162 162 162 162 162 162 162 162 162 162 162 162 162 162 162 162 162 162 162
      162 162 162 162 162 162 162 162 162 162 162 162 162 162 162 162 162 162 162 162 162 162 162 162 162 162 162 162 162 162 162 162 162 162 162 162 162 162 162 162
      162 162 162 162 162 162 162 162 162 162 162 162 162 162 162 162 162 162 162 162 162 162 162 162 162 162 162 162 162 162 162 162 162 162 162 162 162 162 162 162
      )
    )
    (tilemap
      (solid #f)
      (z-pos -10)
      (name "snow")
      (width 40)
      (height 25)
      (tiles
      0 0 0 0 0 0 0 0 0 0 0 0 0 0 0 0 0 0 0 0 0 0 0 0 0 0 0 0 0 0 0 0 0 0 0 0 0 0 0 0
      0 0 0 0 0 0 0 0 0 0 0 0 0 0 0 0 0 0 0 0 0 0 0 0 0 0 0 0 0 0 0 0 0 0 0 0 0 0 0 0
      0 0 0 0 0 0 0 0 0 0 0 0 0 0 0 0 0 0 0 0 0 0 0 0 0 0 0 0 0 0 0 0 0 0 0 0 0 0 0 0
      0 0 0 0 0 0 0 0 0 0 0 0 0 0 0 0 0 0 0 0 0 0 0 0 0 0 0 0 0 0 0 0 0 0 0 0 0 0 0 0
      0 0 0 0 0 0 0 0 0 0 0 0 0 0 0 0 0 0 0 0 0 0 0 0 0 0 0 0 0 0 0 0 0 0 0 0 0 0 0 0
      0 0 0 0 0 0 0 0 0 0 0 0 0 0 0 0 0 0 0 0 0 0 0 0 0 0 0 0 0 0 0 0 0 0 0 0 0 0 0 0
      0 0 0 0 0 0 0 0 0 0 0 0 0 0 0 0 0 0 0 0 0 0 0 0 0 0 0 0 0 0 0 0 0 0 0 0 0 0 0 0
      0 0 0 0 0 0 0 0 0 0 0 0 0 0 0 0 0 0 0 0 0 0 0 0 0 0 0 0 0 0 0 0 0 0 0 0 0 0 0 0
      0 0 0 0 0 0 0 0 0 0 0 0 0 0 0 0 0 0 0 0 0 0 0 0 0 0 0 0 0 0 0 0 0 0 0 0 0 0 0 0
      0 0 0 0 0 0 0 0 0 0 0 0 0 0 0 0 0 0 0 0 0 0 0 0 0 0 0 0 0 0 0 0 0 0 0 0 0 0 0 0
      0 0 0 0 0 0 0 0 0 0 0 0 0 0 0 0 0 0 0 0 0 0 0 0 0 0 0 0 0 0 0 0 0 0 0 0 0 0 0 0
      0 0 0 0 0 0 0 0 0 0 0 0 0 0 0 0 0 0 0 0 0 0 0 0 0 0 0 0 0 0 0 0 0 0 0 0 0 0 0 0
      0 0 0 0 0 0 0 0 0 0 0 0 0 0 0 0 0 0 0 0 0 0 0 0 0 0 0 0 0 0 0 0 0 0 0 0 0 0 0 0
      0 0 0 0 0 0 0 0 0 0 0 0 0 0 0 0 0 0 0 0 0 0 0 0 0 0 0 0 0 0 0 0 0 0 0 0 0 0 0 0
      0 0 0 0 0 0 0 0 0 0 0 0 0 0 0 0 0 0 0 0 0 0 0 0 0 0 0 0 0 0 0 0 0 0 0 0 0 0 0 0
      0 0 0 0 0 0 0 0 0 0 0 0 0 0 0 0 0 0 0 0 0 0 0 0 0 0 0 0 0 0 0 0 0 0 0 0 0 0 0 0
      0 0 0 0 0 0 0 0 0 0 0 0 0 0 0 0 0 0 0 0 0 0 0 0 0 0 0 0 0 0 0 0 0 0 0 0 0 0 0 0
      0 0 0 0 0 0 0 0 0 0 0 0 0 0 0 0 0 0 0 0 0 0 0 0 0 0 0 0 0 0 0 0 0 0 0 0 0 0 0 0
      0 0 0 0 0 0 0 0 0 0 0 0 0 0 0 0 0 0 0 0 0 0 0 0 0 0 0 0 0 0 0 0 0 0 0 0 0 0 0 0
      0 0 0 0 0 0 0 0 0 0 0 0 0 0 0 0 0 0 0 0 0 0 0 0 0 0 0 0 0 0 0 0 0 0 0 0 0 0 0 0
      0 0 0 0 0 0 0 0 0 0 0 0 0 0 0 0 0 0 0 0 0 0 0 0 0 0 0 0 0 0 0 0 0 0 0 0 0 0 0 0
      0 0 0 0 0 0 0 0 0 0 0 0 0 0 0 0 0 0 0 0 0 0 0 0 0 0 0 0 0 0 0 0 0 0 0 0 0 0 0 0
      0 0 0 0 0 0 0 0 0 0 0 0 0 0 0 0 0 0 0 0 0 0 0 0 0 0 0 0 0 0 0 0 0 0 0 0 0 0 0 0
      0 0 0 0 0 0 0 0 0 0 0 0 0 0 0 0 0 0 0 0 0 0 0 0 0 0 0 0 0 0 0 0 0 0 0 0 0 0 0 0
      0 0 0 0 0 0 0 0 0 0 0 0 0 0 0 0 0 0 0 0 0 0 0 0 0 0 0 0 0 0 0 0 0 0 0 0 0 0 0 0
      )
    )
    (tilemap
      (solid #f)
      (z-pos 5)
      (name "watereffect")
      (width 40)
      (height 25)
      (tiles
      0 0 0 0 0 0 0 0 0 0 0 0 0 0 0 0 0 0 0 0 0 0 0 0 0 0 0 0 0 0 0 0 0 0 0 0 0 0 0 0
      0 0 0 0 0 0 0 0 0 0 0 0 0 0 0 0 0 0 0 0 0 0 0 0 0 0 0 0 0 0 0 0 0 0 0 0 0 0 0 0
      0 0 0 0 0 0 0 0 0 0 0 0 0 0 0 0 0 0 0 0 0 0 0 0 0 0 0 0 0 0 0 0 0 0 0 0 0 0 0 0
      0 0 0 0 0 0 0 0 0 0 0 0 0 0 0 0 0 0 0 0 0 0 0 0 0 0 0 0 0 0 0 0 0 0 0 0 0 0 0 0
      0 0 0 0 0 0 0 0 0 0 0 0 0 0 0 0 0 0 0 0 0 0 0 0 0 0 0 0 0 0 0 0 0 0 0 0 0 0 0 0
      0 0 0 0 0 0 0 0 0 0 0 0 0 0 0 0 0 0 0 0 0 0 0 0 0 0 0 0 0 0 0 0 0 0 0 0 0 0 0 0
      0 0 0 0 0 0 0 0 0 0 4 0 0 0 0 0 0 0 0 0 0 0 0 0 0 0 0 0 0 0 0 0 0 0 0 0 0 0 0 0
      0 0 0 0 0 0 0 0 0 0 2 0 0 0 0 0 0 0 0 0 0 0 0 0 0 0 0 0 0 0 0 4 0 0 0 0 0 0 0 0
      0 0 0 0 0 0 0 0 0 0 0 0 0 0 0 0 0 0 0 0 0 0 0 0 0 0 0 0 0 0 0 0 0 0 0 0 0 0 0 0
      0 0 0 0 0 0 0 0 0 0 0 0 0 0 0 0 0 0 0 0 0 0 0 0 0 0 0 0 0 0 0 0 0 0 0 0 0 0 0 0
      0 0 0 0 0 0 0 0 0 0 0 0 0 0 0 0 0 0 0 0 0 0 0 0 0 0 0 0 0 0 0 0 0 0 0 0 0 0 0 0
      0 0 0 0 0 0 0 0 0 0 0 0 0 0 0 0 0 0 0 0 0 0 0 0 0 0 0 0 0 0 0 0 0 0 0 0 0 0 0 0
      0 0 0 0 0 0 0 0 0 0 0 0 0 0 0 0 0 0 0 0 0 0 0 0 0 0 0 0 0 0 0 0 0 0 0 0 0 0 0 0
      0 0 0 0 0 0 0 0 0 0 0 0 0 0 0 0 0 0 0 0 0 0 0 0 0 0 0 0 0 0 0 0 0 0 0 0 0 0 0 0
      0 0 0 0 0 0 0 0 0 0 0 0 0 0 0 0 0 0 0 0 0 0 0 0 0 0 0 0 0 0 0 0 0 0 0 0 0 0 0 0
      0 0 0 0 0 0 0 0 0 0 0 0 0 0 0 0 0 0 0 0 0 0 0 0 0 0 0 0 0 0 0 0 0 0 0 0 0 0 0 0
      0 0 0 0 0 0 0 0 0 0 0 0 0 0 0 0 0 0 0 0 0 0 0 0 0 0 0 0 0 0 0 0 0 0 0 0 0 0 0 0
      0 0 0 0 0 0 0 0 0 0 0 0 0 0 0 0 0 0 0 0 0 0 0 0 0 0 0 0 0 0 0 0 0 0 0 0 0 0 0 0
      0 0 0 0 0 0 0 0 0 0 0 0 0 0 0 0 0 0 0 0 0 0 0 0 0 0 0 0 0 0 0 0 0 0 0 0 0 0 0 0
      0 0 0 0 0 0 0 0 0 0 0 0 0 0 0 0 0 0 0 0 0 0 0 0 0 0 0 0 0 0 0 0 0 0 0 0 0 0 0 0
      0 0 0 0 0 0 0 0 0 0 0 0 0 0 0 0 0 0 0 0 0 0 0 0 0 0 0 0 0 0 0 0 0 0 0 0 0 0 0 0
      0 0 0 0 0 0 0 0 0 0 0 0 0 0 0 0 0 0 0 0 0 0 0 0 0 0 0 0 0 0 0 0 0 0 0 0 0 0 0 0
      0 0 0 0 0 0 0 0 0 0 0 0 0 0 0 0 0 0 0 0 0 0 0 0 0 0 0 0 0 0 0 0 0 0 0 0 0 0 0 0
      0 0 0 0 0 0 0 0 0 0 0 0 0 0 0 0 0 0 0 0 0 0 0 0 0 0 0 0 0 0 0 0 0 0 0 0 0 0 0 0
      0 0 0 0 0 0 0 0 0 0 0 0 0 0 0 0 0 0 0 0 0 0 0 0 0 0 0 0 0 0 0 0 0 0 0 0 0 0 0 0
      )
    )
    (worldmap-spawnpoint
      (name "main")
      (x 29)
      (y 9)
    )
  )
  (tileset "/images/ice_world.strf")
)
