(supertux-level
  (version 3)
  (name (_ "Ambient Sound Test"))
  (author "basti_")
  (sector
    (name "main")
    (ambient-light
      (color 1 1 1)
    )
    (ambient-sound
      (sample "sounds/rain.wav")
      (distance_factor 0.01)
      (distance_bias 200)
      (volume 0)
      (width 32)
      (height 32)
      (x 128)
      (y 900)
    )
    (ambient-sound
      (sample "sounds/waterfall.wav")
      (distance_factor 0.05)
      (distance_bias 100)
      (volume 0.2)
      (width 32)
      (height 32)
      (x 512)
      (y 900)
    )
    (ambient-sound
      (sample "sounds/lava.wav")
      (distance_factor 0.1)
      (distance_bias 50)
      (volume 0)
      (width 300)
      (height 200)
      (x 700)
      (y 900)
    )
    (ambient-sound
      (sample "music/leveldone.ogg")
      (distance_factor 0.01)
      (distance_bias 200)
      (volume 0)
      (width 32)
      (height 32)
      (x 704)
      (y 97)
    )
    (background
      (speed 0.5)
      (image "images/background/arctis.jpg")
    )
    (background
      (speed 0.5)
      (image "images/background/arctis.jpg")
    )
    (camera
      (name "Camera")
      (mode "normal")
    )
    (infoblock
      (message (_ "-Info
#An ambient sound 
#leveldone music
"))
      (x 704)
      (y 96)
    )
    (infoblock
      (message (_ "-Info
#An ambient sound 
#source playing the
#rain effect should 
#be audible here.
"))
      (x 128)
      (y 864)
    )
    (infoblock
      (message (_ "-Info
#Waterfall
#Volume 0.2
#smaller geometry
#than rain source
"))
      (x 512)
      (y 864)
    )
    (infoblock
      (message (_ "-Info
#Lava (Area)
#extending right
"))
      (x 700)
      (y 864)
    )
    (music
    )
    (spawnpoint
      (name "main")
      (x 96)
      (y 160)
    )
    (tilemap
      (solid #t)
      (z-pos 0)
      (width 30)
      (height 30)
      (tiles
      61 61 61 61 61 61 61 61 61 61 61 61 61 61 61 61 61 61 61 61 61 61 61 61 61 61 61 61 61 61
      61 0 0 0 0 0 0 0 0 0 0 0 0 0 0 0 0 0 0 0 0 0 0 0 0 0 0 0 0 61
      61 0 0 0 0 0 0 0 0 0 0 0 0 0 0 0 0 0 0 0 0 0 0 0 0 0 0 0 0 61
      61 0 0 0 0 0 0 0 0 0 0 0 0 0 0 0 0 0 0 0 0 0 0 0 0 0 0 0 0 61
      61 0 0 0 0 0 0 0 0 0 0 0 0 0 0 0 0 0 0 0 0 0 0 0 0 0 0 0 0 61
      61 0 0 0 0 0 0 0 0 0 0 0 0 0 0 0 0 0 0 0 0 0 0 0 0 0 0 0 0 61
      61 0 0 61 61 61 61 61 61 61 61 61 61 61 61 61 61 61 61 61 61 61 61 0 0 0 0 0 0 61
      61 0 0 0 0 0 0 0 0 0 0 0 0 0 0 0 0 0 0 0 0 0 0 0 0 0 0 0 0 61
      61 0 0 0 0 0 0 0 0 0 0 0 0 0 0 0 0 0 0 0 0 0 0 0 61 0 0 0 61 61
      61 0 0 0 0 0 0 0 0 0 0 0 0 0 0 0 0 0 0 0 0 0 0 0 61 61 0 0 0 61
      61 0 0 0 0 0 0 0 0 0 0 0 0 0 0 0 0 0 0 0 0 0 0 0 0 0 0 0 0 61
      61 0 0 0 0 0 0 0 0 0 0 0 0 0 0 0 0 0 0 0 0 0 0 0 0 0 0 0 61 61
      61 0 0 0 0 61 61 61 61 61 61 61 61 0 0 0 0 0 0 0 0 0 0 0 0 61 0 0 0 61
      61 0 0 0 0 0 0 0 0 0 0 0 61 0 0 0 0 0 0 0 0 0 0 0 0 61 61 0 0 61
      61 0 0 0 0 0 0 0 0 0 0 0 61 61 61 61 0 0 0 0 0 0 0 0 0 0 0 0 0 61
      61 0 0 0 0 0 0 0 0 0 0 0 0 0 0 61 61 61 0 0 0 0 0 0 0 0 0 0 0 61
      61 0 0 0 0 0 0 0 0 0 0 0 0 0 0 0 0 61 0 0 0 0 0 0 0 0 0 0 61 61
      61 0 0 0 0 0 0 0 0 0 0 0 0 0 0 0 0 61 61 61 0 0 0 0 61 0 0 0 0 61
      61 0 0 0 0 0 0 0 0 0 0 0 0 0 0 0 0 0 0 61 0 0 0 0 61 61 0 0 0 61
      61 0 0 0 0 0 0 0 0 0 0 0 0 0 0 0 0 0 0 61 61 61 0 0 0 0 0 0 0 61
      61 0 0 0 0 0 0 0 0 0 0 0 0 0 0 0 0 0 0 0 0 61 0 0 0 0 0 0 0 61
      61 0 0 0 0 0 0 0 0 0 0 0 0 0 0 0 0 0 0 0 0 61 61 61 0 0 0 0 61 61
      61 0 0 0 0 0 0 0 0 0 0 0 0 0 0 0 0 0 0 0 0 0 0 61 0 0 0 0 0 61
      61 0 0 0 0 0 0 0 0 0 0 0 0 0 0 0 0 0 0 0 0 0 0 61 61 61 0 0 0 61
      61 0 0 0 0 0 0 0 0 0 0 0 0 0 0 0 0 0 0 0 0 0 0 0 0 61 0 0 0 61
      61 0 0 0 0 0 0 0 0 0 0 0 0 0 0 0 0 0 0 0 0 0 0 0 0 61 61 0 0 61
      61 0 0 0 0 0 0 0 0 0 0 0 0 0 0 0 0 0 0 0 0 0 0 0 0 0 0 0 0 61
      61 0 0 0 0 0 0 0 0 0 0 0 0 0 0 0 0 0 0 0 0 0 0 0 0 0 0 0 0 61
      61 0 0 0 0 0 0 0 0 0 0 0 0 0 0 0 0 0 0 0 0 0 0 0 0 0 0 0 0 61
      61 61 61 61 61 61 61 61 61 61 61 61 61 61 61 61 61 61 61 61 61 61 61 61 61 61 61 61 61 61
      )
    )
  )
)
