;; Generated by Flexlay Editor
(supertux-level
  (version 2)
  (name   (_ "Bonus Block Test"))
  (author "SuperTux Team")
  (sector
    (name  "main")
    (music  "theme.ogg")
    (gravity 10.000000)
    (tilemap
      (z-pos 0)
      (solid #t)
      (speed  1.000000)
      (width  30)
      (height 30)
      (tiles
        61 61 61 61 61 61 61 61 61 61 61 61 61 61 61 61 61 61 61 61 61 61 61 61 61 61 61 61 61 61 
        61 0 0 0 0 0 0 0 0 0 0 0 0 0 0 0 0 0 0 0 0 0 0 0 0 0 0 0 0 61 
        61 0 0 0 0 0 0 0 0 0 0 0 62 0 0 0 0 0 0 0 0 0 0 0 0 0 0 0 0 61 
        61 0 0 0 0 0 0 0 0 0 0 0 0 0 0 0 0 0 62 0 0 0 0 0 0 0 62 0 0 61 
        61 0 0 0 0 0 62 0 0 0 0 0 0 0 0 0 0 0 0 0 0 0 0 0 0 0 0 0 0 61 
        61 0 0 0 0 0 0 0 0 0 0 0 0 0 0 0 0 0 0 0 0 0 0 0 0 0 0 0 0 61 
        61 0 0 61 61 61 61 61 61 61 61 61 61 61 61 61 61 61 61 61 61 61 61 61 61 61 61 0 0 61 
        61 0 0 0 0 0 0 0 0 0 0 0 0 0 0 0 0 0 0 0 0 0 0 0 0 0 0 0 0 61 
        61 0 0 0 0 0 0 0 0 0 0 0 0 0 0 0 0 0 0 0 0 0 0 0 62 0 0 0 0 61 
        61 0 0 0 0 0 0 0 0 0 0 0 0 0 0 0 0 0 0 0 0 0 0 0 0 0 0 0 0 61 
        61 0 0 0 0 0 0 0 0 0 0 0 0 0 0 0 0 0 0 0 0 0 0 0 0 0 0 62 0 61 
        61 0 0 0 0 0 0 0 0 0 0 0 0 0 0 0 0 0 0 0 0 0 0 62 0 0 0 0 0 61 
        61 0 0 0 0 0 0 0 0 0 0 0 0 0 0 0 0 0 0 62 0 0 0 0 0 0 0 0 0 61 
        61 0 0 0 0 0 0 0 0 0 0 0 62 0 0 62 0 0 0 0 0 0 0 0 0 0 0 0 0 61 
        61 0 0 0 0 0 0 0 0 62 0 0 0 0 0 0 0 0 0 0 0 0 0 0 0 0 0 0 0 61 
        61 0 0 0 0 0 62 0 0 0 0 0 0 0 0 0 0 0 0 0 0 0 0 0 0 0 0 0 0 61 
        61 0 0 0 0 0 0 0 0 0 0 0 0 0 0 0 0 0 0 0 0 62 0 0 0 0 0 0 0 61 
        61 0 0 0 62 0 0 0 0 0 0 0 0 0 0 0 0 0 0 0 0 0 0 0 0 0 0 0 0 61 
        61 0 0 0 0 0 0 0 0 0 0 62 0 0 0 0 0 0 0 0 0 0 0 0 0 0 0 0 0 61 
        61 0 0 0 0 0 62 0 0 0 0 0 0 0 0 0 0 0 0 0 0 0 0 0 0 0 0 0 0 61 
        61 0 0 0 0 0 0 0 0 0 0 0 0 0 0 0 0 62 0 0 0 0 0 0 0 0 0 0 0 61 
        61 0 0 0 62 0 0 0 0 0 0 0 0 0 0 0 0 0 0 0 0 0 0 0 0 0 0 0 0 61 
        61 0 0 0 0 0 0 0 0 0 0 0 0 0 0 0 0 0 0 0 0 0 0 0 0 0 0 0 0 61 
        61 0 0 0 0 0 62 0 0 0 0 0 0 0 0 0 0 0 0 0 0 0 0 0 0 0 0 0 0 61 
        61 0 0 0 0 0 0 0 0 0 0 0 0 0 0 0 0 0 0 0 0 0 0 0 0 0 0 0 0 61 
        61 0 0 0 0 0 0 26 0 83 0 0 0 102 0 102 0 0 0 128 0 0 0 103 0 0 0 0 0 61 
        61 0 0 0 0 0 0 0 0 0 0 0 0 0 0 0 0 0 0 0 0 0 0 0 0 0 0 0 0 61 
        61 0 0 0 0 0 0 0 0 0 0 0 0 0 0 0 0 0 0 0 0 0 0 0 0 0 0 0 0 61 
        61 0 0 0 0 0 0 0 0 0 0 0 0 0 0 0 0 0 0 0 0 0 0 0 0 0 0 0 0 61 
        61 61 61 61 61 61 61 61 61 61 61 61 61 61 61 61 61 61 61 61 61 61 61 61 61 61 61 61 61 61 
        ))
    (camera
      (mode "normal")
    )

       (background
         (image "images/background/arctis.jpg")
         (speed 0.500000)
       )
       (powerup (x 135) (y 600) (sprite "images/powerups/egg/egg.sprite"))
       (spawnpoint (name "main") (x 33) (y 160))
      (infoblock (x 128) (y 800)
        (message (_ "-Info
#Beware of these crazy
#red potions.
#Better seek for blue
#potions."))
      )
       (bonusblock (x 96) (y 800)
          (contents "custom")
          (powerup
            (sprite "images/powerups/potions/red-potion.sprite")
            (script "
Effect.set_black(true);
wait(0.1);
Effect.set_black(false);
wait(0.07);
Effect.set_black(true);
wait(0.11);
Effect.set_black(false);
wait(0.09);
Effect.set_black(true);
wait(0.6);
Level.flip_vertically();
Effect.fade_in(1);
")
          )
      )
      (bonusblock (x 470) (y 96)
        (contents "custom")
        (powerup
          (sprite "images/powerups/potions/blue-potion.sprite")
          (script "
Effect.fade_out(1);
wait(1);
Level.flip_vertically();
Effect.fade_in(1);
")
        )
      )
   )
 )

;; EOF ;;
