(supertux-level
  (version 2)
  (name (_ "Badguy Direction Test"))
  (author "Wolfgang Becker")
  (license "GPL 2 / CC-by-sa 3.0")
  (sector
    (name "main")
    (background
      (speed 0.5)
      (image-top "images/background/arctis_top.jpg")
      (image "images/background/arctis.jpg")
      (image-bottom "images/background/arctis_bottom.jpg")
    )
    (tilemap
      (z-pos 0)
      (solid #t)
      (speed 1)
      (width 50)
      (height 35)
      (tiles 28 0 0 0 28 0 0 0 28 0 0 0 0 28 0 0 0 0 0 0 0 28 0 0 0 0 0 0 0 0 0 0 0 28 0 0 0 0 0 0 0 28 0 0 0 0 0 0 0 0 28 0 0 0 28 0 0 0 28 0 0 0 0 28 0 0 0 0 0 0 0 28 0 0 0 0 0 0 0 0 0 0 0 28 0 0 0 0 0 0 0 28 0 0 0 0 0 0 0 0 28 28 28 28 28 28 28 28 28 28 28 28 28 28 28 28 28 28 28 28 28 28 0 0 0 0 0 0 28 0 0 0 0 28 28 28 28 28 28 28 28 28 28 28 0 0 0 0 0 0 28 0 0 0 28 0 0 0 28 0 0 0 0 28 0 0 0 0 0 0 0 28 0 0 0 0 0 28 28 28 28 28 28 0 0 0 0 0 0 0 0 0 0 0 0 0 0 0 0 0 28 0 0 0 28 0 0 0 28 0 0 0 0 28 0 0 0 0 0 0 0 28 0 0 0 0 0 0 0 0 0 0 0 0 0 0 0 0 0 0 0 0 0 0 0 0 0 0 0 0 28 28 28 28 28 28 28 28 28 28 28 28 28 28 28 28 28 28 28 28 28 28 0 0 0 0 0 0 0 0 0 0 0 1 0 0 0 0 0 0 0 0 0 1 0 0 0 0 0 0 0 0 0 0 0 0 0 0 0 0 0 0 0 0 0 0 0 0 0 0 0 0 0 1 1 1 0 0 0 0 0 0 0 1 1 1 1 1 1 1 1 1 1 1 0 0 0 0 0 0 0 0 0 0 0 0 0 0 0 0 0 0 0 0 0 0 0 0 0 0 0 0 0 0 0 0 0 0 0 0 0 0 0 0 0 0 0 0 0 0 0 0 0 0 0 0 0 0 0 0 0 0 0 0 0 0 0 0 0 0 0 0 0 0 0 0 0 0 0 0 0 0 0 0 0 0 0 0 0 0 0 0 0 0 0 0 0 0 0 0 0 0 0 0 0 0 0 0 0 0 0 0 0 0 0 0 0 1 0 0 0 0 0 1 0 0 0 0 0 0 1 0 0 1756 1757 0 0 0 0 0 0 1 0 0 0 0 0 0 0 0 0 0 0 1 0 0 0 0 0 0 0 0 0 0 1 1 1 1 1 1 1 1 1 1 1 1 1 1 1 1 1 0 0 0 0 0 0 1 1 1 1 1 1 1 1 1 1 1 1 1 1 1 1 1 1 1 0 0 0 0 0 0 0 0 0 0 0 0 0 0 0 0 0 0 0 0 0 0 0 0 0 0 0 0 1756 1757 0 0 0 0 0 0 0 0 0 0 0 0 0 0 0 0 0 0 0 0 0 0 0 0 0 0 0 0 0 0 0 0 0 0 0 0 0 0 0 0 0 0 0 0 0 0 0 0 0 0 0 0 0 0 0 0 0 0 0 0 0 0 0 0 0 0 0 0 0 0 0 0 0 0 0 0 0 0 0 0 0 0 0 0 0 0 0 0 0 0 0 0 0 0 0 0 0 0 1756 1757 0 0 0 0 0 0 0 0 0 0 0 0 0 0 0 0 0 0 0 0 0 0 0 0 0 0 0 0 0 0 0 0 0 0 0 0 0 0 0 0 0 0 0 0 0 0 0 0 0 0 0 0 0 0 0 0 0 0 0 0 0 0 0 0 0 0 0 0 0 0 0 0 0 0 0 0 0 0 0 0 0 0 0 0 0 0 0 0 0 0 0 0 0 0 0 0 1756 1757 0 0 0 0 0 0 0 0 0 0 0 0 0 0 0 0 0 0 0 0 0 0 0 0 0 0 0 0 0 1 0 0 0 0 0 0 0 0 0 0 0 0 0 0 0 0 1 0 0 0 0 0 0 0 0 0 0 0 0 0 0 0 0 0 0 0 0 0 0 0 0 0 0 0 0 0 0 0 0 1 1 1 1 1 1 1 1 1 1 1 1 1 1 1 1 1 1 0 0 0 0 0 0 1 1 1 1 1 1 1 1 1 1 1 1 1 1 1 1 1 1 1 0 0 0 0 0 0 0 0 0 0 0 0 0 0 0 0 0 0 0 0 0 0 0 0 0 0 0 1756 1757 0 0 0 0 0 0 0 0 0 0 0 0 0 0 0 0 0 0 0 0 0 0 0 0 0 0 0 0 0 0 0 0 0 0 0 0 0 0 0 0 0 0 0 0 0 0 0 0 0 0 0 0 0 0 0 0 0 0 0 0 0 0 0 0 0 0 0 0 0 0 0 0 0 0 0 0 0 0 0 0 0 0 0 0 0 0 0 0 0 0 0 0 0 0 0 0 0 0 0 0 0 0 0 0 0 0 0 0 0 0 0 0 0 0 0 0 0 0 0 0 0 0 0 0 0 0 0 0 0 0 0 0 0 0 0 0 0 0 0 0 0 0 0 0 0 0 0 1756 1757 0 0 0 0 0 0 0 0 0 0 0 0 0 0 0 0 0 0 0 0 0 0 0 0 0 0 0 0 0 0 0 0 0 0 0 0 0 0 0 0 0 0 0 0 0 0 0 0 0 0 0 0 0 0 0 0 0 0 0 0 0 0 0 0 0 0 0 0 0 0 0 0 0 0 0 0 0 0 0 0 0 0 0 0 0 0 0 0 0 0 0 0 0 0 0 0 0 0 0 0 0 0 0 0 0 0 0 0 0 0 0 0 0 0 0 0 0 0 0 0 0 0 0 0 0 0 0 0 0 0 0 0 0 0 0 0 0 0 0 0 0 0 0 0 0 0 0 0 0 1756 1757 0 0 0 0 0 0 0 0 0 0 0 0 0 0 0 0 0 0 0 0 0 0 0 0 0 0 0 0 0 0 0 0 0 0 0 0 0 0 0 0 0 0 0 0 0 0 0 0 0 0 0 0 0 0 0 0 0 0 0 0 0 0 0 0 0 0 0 0 0 0 0 0 0 0 0 0 0 0 0 1 1 1 1 1 1 1 1 1 1 1 1 1 1 1 1 0 0 0 0 0 0 0 1 1 1 1 1 1 1 1 1 1 1 1 1 1 1 1 1 1 1 0 0 0 0 0 0 0 0 0 0 0 1 0 0 0 1 0 0 0 0 1 0 0 0 0 0 1756 1757 0 0 0 0 0 0 0 0 0 0 0 0 0 0 0 0 0 0 0 0 0 0 0 0 0 0 0 0 0 0 0 0 0 1 0 0 0 1 0 0 0 0 1 0 0 0 0 0 0 0 0 0 0 0 0 0 0 0 0 0 0 0 0 0 0 0 0 0 0 0 0 0 0 0 0 0 0 0 0 0 0 0 0 1 0 0 0 1 0 0 0 0 1 0 0 0 0 0 0 0 0 0 0 0 0 0 0 0 0 0 0 0 0 0 0 0 0 0 0 0 0 0 0 0 0 0 0 0 0 0 0 0 0 0 0 0 0 1 0 0 0 0 0 0 0 0 0 1756 1757 0 1756 1757 0 0 0 0 0 0 0 0 0 0 0 0 0 0 0 0 0 0 0 0 0 0 0 0 0 0 0 0 0 0 0 0 0 0 0 1 0 0 0 0 0 0 0 0 0 0 0 0 0 0 0 0 0 0 0 0 0 0 0 0 0 0 0 0 0 0 0 0 0 0 0 0 0 0 0 0 0 0 0 0 0 0 0 0 0 1 0 0 0 0 0 0 0 0 0 0 0 0 0 0 0 0 0 0 0 0 0 0 0 0 0 0 0 0 0 0 0 0 0 0 0 0 0 0 0 0 0 0 1 1 1 1 1 1 1 1 1 1 1 1 1 1 1 1 1 0 0 1756 1757 0 0 0 1 1 1 1 1 1 1 1 1 1 1 1 1 1 1 1 1 1 0 0 0 0 0 0 0 0 0 0 0 0 0 0 0 0 0 0 0 0 0 0 0 0 0 0 0 0 0 0 0 0 0 0 0 0 0 0 0 0 0 0 0 0 0 0 0 0 0 0 0 0 0 0)
    )
    (camera
      (mode "normal")
    )
    (mrbomb
      (direction "left")
      (x 1329.884)
      (y 784.2773)
    )
    (mrbomb
      (direction "auto")
      (x 1047.041)
      (y 501.4346)
    )
    (mrbomb
      (direction "left")
      (x 1270.487)
      (y 490.1208)
    )
    (mrbomb
      (direction "right")
      (x 1189.522)
      (y 503.0915)
    )
    (mrbomb
      (direction "right")
      (x 1196.947)
      (y 784.2773)
    )
    (mrbomb
      (direction "auto")
      (x 184.936)
      (y 21.92181)
    )
    (snowball
      (direction "auto")
      (x 64)
      (y 128)
    )
    (mriceblock
      (direction "auto")
      (x 1191.523)
      (y 155.6863)
    )
    (mriceblock
      (direction "auto")
      (x 495.73)
      (y 25.57867)
    )
    (mriceblock
      (direction "right")
      (x 299.6964)
      (y 493.6467)
    )
    (mriceblock
      (direction "left")
      (x 432.6324)
      (y 493.6467)
    )
    (bouncingsnowball
      (direction "auto")
      (x 320)
      (y 128)
    )
    (spiky
      (direction "auto")
      (x 595.1513)
      (y 115.6619)
    )
    (sspiky
      (direction "left")
      (x 224)
      (y 768)
    )
    (sspiky
      (direction "right")
      (x 320)
      (y 768)
    )
    (sspiky
      (direction "auto")
      (x 911.2763)
      (y 784.2773)
    )
    (sspiky
      (direction "auto")
      (x 480)
      (y 768)
    )
    (sspiky
      (direction "auto")
      (x 962)
      (y 50)
    )
    (spawnpoint
      (name "main")
      (x 768)
      (y 96)
    )
    (mrtree
      (direction "left")
      (x 288)
      (y 224)
    )
    (mrtree
      (direction "right")
      (x 512)
      (y 224)
    )
    (mrtree
      (direction "auto")
      (x 1121.783)
      (y 231.9706)
    )
    (poisonivy
      (direction "auto")
      (x 335.9066)
      (y 24.00513)
    )
    (zeekling
      (direction "auto")
      (x 1178.352)
      (y 5.696381)
    )
    (snail
      (direction "auto")
      (x 192)
      (y 128)
    )
    (dispenser
      (type "rocketlauncher")
      (badguy "mrrocket")
      (cycle 1)
      (direction "left")
      (x 215.4832)
      (y 996.4092)
    )
    (dispenser
      (type "rocketlauncher")
      (badguy "mrrocket")
      (cycle 1)
      (direction "right")
      (x 472.8701)
      (y 999.2377)
    )
    (dispenser
      (badguy "random")
      (cycle 1)
      (direction "auto")
      (x 931.0753)
      (y 917.2133)
    )
    (dispenser
      (badguy "random")
      (cycle 1)
      (direction "left")
      (x 1240.788)
      (y 912.9707)
    )
    (dispenser
      (badguy "random")
      (cycle 1)
      (direction "")
      (x 1379.381)
      (y 911.5566)
    )
    (dispenser
      (badguy "random")
      (cycle 1)
      (direction "right")
      (x 1093.71)
      (y 910.1423)
    )
    (darttrap
      (initial-delay 0)
      (fire-delay 2)
      (ammo -1)
      (direction "right")
      (x 256.5859)
      (y 964.7768)
    )
    (darttrap
      (initial-delay 0)
      (fire-delay 2)
      (ammo -1)
      (direction "auto")
      (x 209.8263)
      (y 890.3432)
    )
    (darttrap
      (initial-delay 0)
      (fire-delay 2)
      (ammo -1)
      (direction "auto")
      (x 258.0001)
      (y 919.5219)
    )
    (darttrap
      (initial-delay 0)
      (fire-delay 2)
      (ammo -1)
      (direction "left")
      (x 259.4143)
      (y 875.6813)
    )
    (darttrap
      (initial-delay 0)
      (fire-delay 2)
      (ammo -1)
      (direction "left")
      (x 498.4164)
      (y 874.2671)
    )
    (darttrap
      (initial-delay 0)
      (fire-delay 2)
      (ammo -1)
      (direction "auto")
      (x 498.4164)
      (y 919.5219)
    )
    (darttrap
      (initial-delay 0)
      (fire-delay 2)
      (ammo -1)
      (direction "right")
      (x 498.4164)
      (y 961.9484)
    )
  )
)
