(supertux-level
  (version 3)
  (name (_ "Sliding Glitches Demo"))
  (author "Marek Moeckel")
  (sector
    (name "main")
    (ambient-light
      (color 1 1 1)
    )
    (camera
      (name "Camera")
      (mode "normal")
    )
    (gradient
      (top_color 0 0 0.2)
      (bottom_color 0 0 0.6)
    )
    (music
    )
    (spawnpoint
      (name "main")
      (x 100)
      (y 170)
    )
    (tilemap
      (solid #t)
      (z-pos 0)
      (width 50)
      (height 15)
      (tiles
      0 0 0 0 0 0 0 0 0 0 0 0 0 0 0 0 0 0 0 0 0 0 0 0 0 0 0 0 0 0 0 0 0 0 0 0 0 0 0 0 0 0 0 0 0 0 0 0 0 0
      27 28 28 28 28 28 28 28 28 28 29 0 0 0 0 0 0 0 0 0 0 0 0 0 0 0 0 0 0 0 0 0 0 0 0 0 0 0 0 0 0 0 0 0 0 0 0 0 0 0
      48 48 0 0 0 0 0 0 0 0 48 48 48 48 48 27 28 28 28 28 28 28 28 28 28 28 28 28 29 0 0 44 44 44 0 0 0 0 0 0 0 0 0 0 0 0 0 0 0 0
      48 48 0 0 0 0 0 0 0 0 48 48 48 48 48 0 0 0 0 0 0 0 0 0 0 0 0 0 48 0 0 0 44 0 0 0 0 0 0 0 0 0 0 0 0 0 0 0 0 0
      48 48 0 0 0 0 0 0 0 0 48 48 48 48 48 0 0 0 0 0 0 0 0 0 0 0 0 0 48 0 0 0 44 0 0 0 0 0 0 0 0 0 0 0 0 0 0 0 0 0
      48 48 0 0 0 0 0 0 0 0 48 48 48 48 48 0 0 0 44 44 44 44 44 0 0 0 0 0 48 0 0 0 44 0 0 0 0 0 0 0 0 0 0 0 0 0 0 0 0 0
      48 48 0 0 0 0 0 0 0 0 48 48 48 48 48 0 0 0 0 44 0 44 0 0 0 0 0 0 48 0 0 44 44 44 0 0 0 0 0 0 0 0 0 0 0 0 0 0 0 0
      48 48 0 0 0 0 0 0 0 0 48 48 48 48 48 0 0 0 0 44 0 44 0 0 0 0 0 0 48 0 0 0 0 0 0 0 0 0 0 0 0 0 0 0 0 0 0 0 0 0
      48 48 0 0 0 0 0 0 0 0 48 48 48 48 48 0 0 0 0 44 0 44 0 0 0 0 0 0 27 28 28 28 28 28 28 28 29 0 0 0 0 0 0 0 0 0 0 0 0 0
      48 48 0 0 0 102 0 0 0 0 48 48 48 48 48 0 0 0 0 44 0 44 0 0 0 0 0 0 0 0 0 0 0 0 0 0 0 0 0 0 0 0 0 0 0 0 0 0 0 0
      48 48 0 0 0 0 0 0 0 0 48 48 48 48 48 0 0 0 44 44 44 44 44 0 0 0 0 0 0 0 0 0 0 0 0 0 0 0 0 0 0 0 0 0 0 0 0 0 0 0
      48 0 0 0 0 0 0 0 0 0 0 48 48 48 48 0 0 0 0 0 0 0 0 0 0 0 0 0 0 0 0 0 0 0 0 0 0 0 0 0 0 0 0 0 0 0 0 0 0 0
      27 28 28 28 28 28 28 28 28 28 28 28 28 28 28 28 28 28 28 28 28 28 28 28 28 28 28 28 28 28 28 28 28 28 28 28 29 0 0 0 0 0 0 0 0 0 0 0 0 0
      0 0 0 0 0 0 0 0 0 0 0 0 0 0 0 0 0 0 0 0 0 0 0 0 0 0 0 0 0 0 0 0 0 0 0 0 0 0 0 0 0 0 0 0 0 0 0 0 0 0
      0 0 0 0 0 0 0 0 0 0 0 0 0 0 0 0 0 0 0 0 0 0 0 0 0 0 0 0 0 0 0 0 0 0 0 0 0 0 0 0 0 0 0 0 0 0 0 0 0 0
      )
    )
  )
)
