;; Generated by Flexlay Editor
(supertux-level
  (version 2)
  (name   (_ "SuperTux Intro"))
  (author "SuperTux Team")
  (sector
    (name  "main")
    (music  "theme.ogg")
    (gravity 10.000000)
    (tilemap
      (z-pos -100)
      (solid #f)
      (speed  1.000000)
      (width  25)
      (height 20)
      (tiles
        0 0 0 0 0 0 0 0 0 0 0 0 0 0 0 0 0 0 0 0 0 0 0 0 0 
        0 0 0 0 0 0 0 0 0 0 0 0 0 0 0 0 0 0 0 0 0 0 0 0 0 
        0 0 0 0 0 0 0 0 0 0 0 0 0 0 0 0 0 0 0 0 0 0 0 0 0 
        0 0 0 0 0 0 0 0 0 0 0 0 0 0 0 0 0 0 0 0 0 0 0 0 0 
        0 0 0 0 0 0 0 0 0 0 0 0 0 0 0 0 0 0 0 0 0 0 0 0 0 
        0 0 0 0 0 0 0 0 0 0 0 0 0 0 0 0 0 0 0 0 0 0 0 0 0 
        0 0 0 0 0 0 0 0 0 0 0 0 0 0 0 0 0 0 0 0 0 0 0 0 0 
        0 0 0 0 0 0 0 0 0 0 0 0 0 0 0 0 0 0 0 0 0 0 0 0 0 
        0 0 0 0 0 0 0 0 0 0 0 0 0 0 0 0 0 0 0 0 0 0 0 0 0 
        0 0 0 0 0 0 0 0 0 0 0 0 0 0 0 0 0 0 0 0 0 0 0 0 0 
        1343 1343 1343 1343 1343 1343 1343 1343 1343 1343 1343 1343 1343 1343 1343 1343 1343 1343 1343 1343 1343 1343 1343 1343 1343 
        1342 1342 1342 1342 1342 1342 1342 1342 1342 1342 1342 1342 1342 1342 1342 1342 1342 1342 1342 1342 1342 1342 1342 1342 1342 
        1342 1342 1342 1342 1342 1342 1342 1342 1342 1342 1342 1342 1342 1342 1342 1342 1342 1342 1342 1342 1342 1342 1342 1342 1342 
        1342 1342 1342 1342 1342 1342 1342 1342 1342 1342 1342 1342 1342 1342 1342 1342 1342 1342 1342 1342 1342 1342 1342 1342 1342 
        1342 1342 1342 1342 1342 1342 1342 1342 1342 1342 1342 1342 1342 1342 1342 1342 1342 1342 1342 1342 1342 1342 1342 1342 1342 
        1342 1342 1342 1342 1342 1342 1342 1342 1342 1342 1342 1342 1342 1342 1342 1342 1342 1342 1342 1342 1342 1342 1342 1342 1342 
        1342 1342 1342 1342 1342 1342 1342 1342 1342 1342 1342 1342 1342 1342 1342 1342 1342 1342 1342 1342 1342 1342 1342 1342 1342 
        1342 1342 1342 1342 1342 1342 1342 1342 1342 1342 1342 1342 1342 1342 1342 1342 1342 1342 1342 1342 1342 1342 1342 1342 1342 
        1342 1342 1342 1342 1342 1342 1342 1342 1342 1342 1342 1342 1342 1342 1342 1342 1342 1342 1342 1342 1342 1342 1342 1342 1342 
        1342 1342 1342 1342 1342 1342 1342 1342 1342 1342 1342 1342 1342 1342 1342 1342 1342 1342 1342 1342 1342 1342 1342 1342 1342 
        ))
    (tilemap
      (z-pos 0)
      (solid #t)
      (speed  1.000000)
      (width  25)
      (height 20)
      (tiles
        0 0 0 0 0 0 0 0 0 0 0 0 0 0 0 0 0 0 0 0 0 0 0 0 0 
        0 0 0 0 0 0 0 0 0 0 0 0 0 0 0 0 0 0 0 0 0 0 0 0 0 
        0 0 0 0 0 0 0 0 0 0 0 0 0 0 0 0 0 0 0 0 0 0 0 0 0 
        0 0 0 0 0 0 0 0 0 0 0 0 0 0 0 0 0 0 0 0 0 0 0 0 0 
        0 0 0 0 0 0 0 0 0 0 0 0 0 0 0 0 0 0 0 0 0 0 0 0 0 
        0 0 0 0 0 0 0 0 0 0 0 0 0 0 0 0 0 0 0 0 0 0 0 0 0 
        0 0 0 0 0 0 0 0 0 0 0 0 0 0 0 0 0 0 0 0 0 0 0 0 0 
        0 0 0 0 0 0 0 0 0 0 0 0 0 0 0 0 0 0 0 0 0 0 0 0 0 
        0 0 0 0 0 0 0 0 0 0 0 0 0 0 0 0 0 0 0 0 0 0 0 0 0 
        0 0 0 0 0 0 0 0 0 0 0 0 122 209 209 123 0 0 0 0 0 0 0 0 0 
        0 0 0 0 0 0 0 0 0 0 0 0 124 98 98 125 0 0 0 0 0 0 0 0 0 
        0 0 0 0 0 0 0 0 0 0 0 0 124 98 98 125 0 0 0 0 0 0 0 0 0 
        0 0 122 123 0 0 0 0 0 0 0 0 124 98 98 125 0 0 0 0 0 1348 0 0 0 
        0 0 124 125 0 0 0 0 0 0 0 0 124 98 98 125 0 0 122 123 0 79 0 0 0 
        0 0 124 125 0 0 0 0 0 0 0 0 124 98 98 125 0 0 124 125 0 79 0 0 0 
        0 0 1345 1344 0 0 0 0 0 0 0 0 1345 1346 1346 1344 0 0 1345 1344 0 1349 0 0 0 
        1342 1342 1342 1342 1342 1342 1342 1342 1342 1342 1342 1342 1342 1342 1342 1342 1342 1342 1342 1342 1342 1342 1342 1342 1342 
        0 0 0 0 0 0 0 0 0 0 0 0 0 0 0 0 0 0 0 0 0 0 0 0 0 
        0 0 0 0 0 0 0 0 0 0 0 0 0 0 0 0 0 0 0 0 0 0 0 0 0 
        0 0 0 0 0 0 0 0 0 0 0 0 0 0 0 0 0 0 0 0 0 0 0 0 0 
        ))
    (tilemap
      (z-pos 100)
      (solid #f)
      (speed  1.000000)
      (width  25)
      (height 20)
      (tiles
        0 0 0 0 0 0 0 0 0 0 0 0 0 0 0 0 0 0 0 0 0 0 0 0 0 
        0 0 0 0 0 0 0 0 0 0 0 0 0 0 0 0 0 0 0 0 0 0 0 0 0 
        0 0 0 0 0 0 0 0 0 0 0 0 0 0 0 0 0 0 0 0 0 0 0 0 0 
        0 0 0 0 0 0 0 0 0 0 0 0 0 0 0 0 0 0 0 0 0 0 0 0 0 
        0 0 0 0 0 0 0 0 0 0 0 0 0 0 0 0 0 0 0 0 0 0 0 0 0 
        0 0 0 0 0 0 0 0 0 0 0 0 0 0 0 0 0 0 0 0 0 0 0 0 0 
        0 0 0 0 0 0 0 0 0 0 0 0 0 0 0 0 0 0 0 0 0 0 0 0 0 
        0 0 0 0 0 0 0 0 0 0 0 0 0 0 0 0 0 0 0 0 0 0 0 0 0 
        0 0 0 0 0 0 0 0 0 0 0 0 0 0 0 0 0 0 0 0 0 0 0 0 0 
        0 0 0 0 0 0 0 0 0 0 0 0 0 0 0 0 0 0 0 0 0 0 0 0 0 
        0 0 0 0 0 0 0 0 0 0 0 0 0 0 0 0 0 0 0 0 0 0 0 0 0 
        0 0 0 0 0 0 0 0 0 0 0 0 0 0 0 0 0 0 0 0 0 0 0 0 0 
        0 0 0 0 0 0 0 0 0 0 0 0 0 0 0 0 0 0 0 0 0 0 0 0 0 
        0 0 0 0 0 0 0 0 0 0 0 0 0 0 0 0 0 0 0 0 0 0 0 0 0 
        0 1321 1322 1323 1324 0 0 0 0 0 0 0 0 0 1321 1322 1323 1324 0 0 0 0 0 0 0 
        0 1325 1326 1327 1328 0 0 0 0 0 0 0 0 0 1325 1326 1327 1328 0 0 0 0 0 0 0 
        0 1329 1330 1331 1332 0 0 1350 0 0 0 0 0 0 1329 1330 1331 1332 0 0 0 0 0 0 0 
        0 1333 1334 1335 1336 0 0 0 0 0 0 0 0 0 1333 1334 1335 1336 0 0 0 0 0 0 0 
        0 0 0 0 0 0 0 0 0 0 0 0 0 0 0 0 0 0 0 0 0 0 0 0 0 
        0 0 0 0 0 0 0 0 0 0 0 0 0 0 0 0 0 0 0 0 0 0 0 0 0 
        ))
    (camera
      (mode "normal")
    )

       (background
         (image "images/background/semi_arctic.jpg")
         (speed 0.500000)
       )
       (spawnpoint (name "main") (x 220) (y 416))
       (particles-snow)

       (scriptedobject
         (name "PENNY")
         (x 390)
         (y 510)
         (sprite "images/creatures/dummyguy/dummyguy.sprite")
       )
       (init-script "
          intro();
        ")
   )
 )

;; EOF ;;
