(supertux-level
  (version 2)
  (name (_ "Bonusblock Test"))
  (author "LMH")
  (license "GPL 2 / CC-by-sa 3.0")
  (sector
    (name "main")
    (ambient-light 1 1 1)
    (camera
      (mode "normal")
    )
    (init-script "\tlightson <- true;\t")
    (spawnpoint
      (name "main")
      (x 80)
      (y 704)
    )
    (tilemap
      (name "Interactive")
      (z-pos 0)
      (solid #t)
      (width 42)
      (height 30)
      (tiles 0 0 0 0 0 0 0 0 0 0 0 0 0 0 0 0 0 0 0 0 0 0 0 0 0 0 0 0 0 0 0 0 0 0 0 0 0 0 0 0 0 0 0 0 0 0 0 0 0 0 0 0 0 0 0 0 0 0 0 0 0 0 0 0 0 0 0 0 0 0 0 0 0 0 0 0 0 0 0 0 0 0 0 0 0 0 0 0 0 0 0 0 0 0 0 0 0 0 0 0 0 0 0 0 0 0 0 0 0 0 0 0 0 0 0 0 0 0 0 0 0 0 0 0 0 0 0 0 0 0 0 0 0 0 0 0 0 0 0 0 0 0 0 0 0 0 0 0 0 0 0 0 0 0 0 0 0 0 0 0 0 0 0 0 0 0 0 0 0 0 0 0 0 0 0 0 0 0 0 0 0 0 0 0 0 0 0 0 0 0 0 0 0 0 0 0 0 0 0 0 0 0 0 0 0 0 0 0 0 0 0 0 0 0 0 0 0 0 0 0 0 0 0 0 0 0 0 0 0 0 0 0 0 0 0 0 0 0 0 0 0 0 0 0 0 0 0 0 0 0 0 0 0 0 0 0 0 0 0 0 0 0 0 0 0 0 0 0 0 0 0 0 0 0 0 0 0 0 0 0 0 0 0 0 0 0 0 0 0 0 0 0 0 0 0 0 0 0 0 0 0 0 0 0 0 0 0 0 0 0 0 0 0 0 44 0 0 0 0 0 0 0 0 0 0 0 44 0 0 0 0 0 0 0 0 0 0 0 0 0 0 0 0 0 0 0 0 0 0 0 0 0 0 0 0 0 0 0 0 0 0 0 0 0 0 0 0 0 0 0 0 0 0 0 0 0 0 0 0 0 0 0 0 0 0 0 0 0 0 0 0 0 0 0 0 0 0 0 0 0 0 0 0 0 0 0 0 0 0 0 0 0 0 0 0 0 0 0 0 0 0 0 0 0 0 0 0 0 0 0 0 0 0 0 0 0 0 0 0 0 0 0 0 0 0 0 0 0 0 0 0 0 0 0 0 0 0 0 0 0 0 0 0 0 0 0 0 0 0 0 0 0 0 0 0 0 0 0 0 0 0 0 0 0 0 0 0 0 0 0 0 0 0 0 0 0 0 0 0 0 0 0 0 0 0 0 0 0 0 0 0 0 0 0 0 0 0 0 0 0 0 0 0 0 0 0 0 0 0 0 0 0 0 0 0 0 0 0 0 0 0 0 0 0 0 0 0 0 0 0 0 0 0 0 0 0 0 0 0 0 0 0 0 0 0 0 0 0 0 0 0 0 0 0 0 0 0 0 0 0 0 0 0 0 0 0 0 0 0 0 0 0 0 0 0 0 0 0 0 0 0 0 0 0 0 0 0 0 0 0 0 0 0 0 0 0 0 0 0 0 0 0 0 0 0 0 0 0 0 0 0 0 0 0 2946 0 0 0 2947 0 0 0 2948 0 0 0 0 0 0 0 0 0 0 0 0 0 0 0 0 0 0 0 0 0 0 0 0 0 0 0 0 0 0 0 0 0 0 0 0 0 0 0 0 0 0 0 0 0 0 0 0 0 0 0 0 0 0 0 0 0 0 0 0 0 0 0 0 0 0 0 0 0 0 0 0 0 0 0 0 0 0 0 0 0 0 0 0 0 0 0 0 0 0 0 0 0 0 0 0 0 0 0 0 0 0 0 0 0 0 0 0 0 0 0 0 0 0 0 0 0 0 0 0 0 0 0 0 0 0 0 0 0 0 0 0 0 0 0 0 0 0 0 0 0 0 0 0 0 0 0 0 0 0 0 0 0 0 0 0 0 0 0 0 0 0 0 0 0 0 0 0 0 0 0 0 0 0 0 0 0 0 0 0 0 0 0 0 0 0 0 0 0 0 0 0 0 0 0 0 0 0 0 0 0 0 0 0 0 0 0 0 0 0 0 0 0 0 0 0 0 0 0 0 0 0 0 0 0 2943 0 0 0 2944 2945 0 0 0 0 0 0 0 0 0 0 0 0 0 0 0 0 0 0 0 0 0 0 0 0 0 0 0 0 0 0 0 0 0 0 0 0 0 0 0 0 0 0 0 0 0 0 0 0 0 0 0 0 0 0 0 0 0 0 0 0 0 0 0 0 0 0 0 0 0 0 0 0 0 0 0 0 0 0 0 0 0 0 0 0 0 0 0 0 0 0 132 0 8 8 8 8 8 8 8 8 8 8 8 8 8 8 8 8 8 8 8 8 8 8 8 8 8 8 8 8 8 8 8 8 8 8 8 8 8 8 8 8 48 8 14 14 14 14 14 14 14 14 14 14 14 14 14 14 14 14 14 14 14 14 14 14 14 14 14 14 14 14 14 14 14 14 14 14 14 14 14 14 14 14 14 14 11 11 11 11 11 11 11 11 11 11 11 11 11 11 11 11 11 11 11 11 11 11 11 11 11 11 11 11 11 11 11 11 11 11 11 11 11 11 11 11 11 11 11 11 11 11 11 11 11 11 11 11 11 11 11 11 11 11 11 11 11 11 11 11 11 11 11 11 11 11 11 11 11 11 11 11 11 11 11 11 11 11 11 11 11 11 11 11 11 11 11 11 11 11 11 11 11 11 11 11 11 11 11 11 11 11 11 11 11 11 11 11 11 11 11 11 11 11 11 11 11 11 11 11 11 11 11 11 11 11 11 11 11 11 11 11 11 11 11 11 11 11 11 11 11 11 11 11 11 11 11 11 11 11 11 11 11 11 11 11 11 11 11 11 11 11 11 11 11 11 11 11 11 11 11 11 11 11 11 11 11 11 11 11 11 11 11 11 11 11 11 11 11 11 11 11 11 11 11 11 11 11 11 11 11 11 11 11 11 11)
    )
    (bonusblock
      (x 256)
      (y 640)
      (contents "coin")
      (count 3)
    )
    (bonusblock
      (x 384)
      (y 640)
      (contents "firegrow")
      (sprite "images/objects/bonus_block/brick.sprite")
    )
    (bonusblock
      (x 512)
      (y 640)
      (contents "1up")
      (sprite "images/objects/bonus_block/hiddenbonus.sprite")
    )
    (bonusblock
      (x 640)
      (y 640)
      (contents "script")
      (script "\t\t\t\t\t\t\t\t\t\t\t\t\t\t\t\t\t\t\t\t\t\t\t\t\t\t\t\t\t\t\t\t\t\t\t\t\t\t\t\t\t\n\t\t\tvineA.goto_node(8);\t\t\t\t\t\t\t\t\t\t\t\t\t\t\t\t\t\t\t\t\t\t\t\t\t\t\t\t\t\t\t\t\t\t\t\t\t\t\t\t\n\t\t\tvineB.goto_node(8);\t\t\t\t\t\t\t\t\t\t\t\t\t\t\t\t\t\t\t\t\t\t\t\t\t\t\t\t\t\t\t\t\t\t\t\t\t\t\t\t\n\t\t\tvineC.goto_node(8);\t\t\t\t\t\t\t\t\t\t\t\t\t\t\t\t\t\t\t\t\t\t\t\t\t\t\t\t\t\t\t\t\t\t\t\t\t\t\t\t\n\t\t\tvineD.goto_node(8);\t\t\t\t\t\t\t\t\t\t\t\t\t\t\t\t\t\t\t\t\t\t\t\t\t\t\t\t\t\t\t\t\t\t\t\t\t\t\t\t\n\t\t\tvineE.goto_node(8);\t\t\t\t\t\t\t\t\t\t\t\t\t\t\t\t\t\t\t\t\t\t\t\t\t\t\t\t\t\t\t\t\t\t\t\t\t\t\t\t\n\t\t\tvineF.goto_node(8);\t\t\t\t\t\t\t\t\t\t\t\t\t\t\t\t\t\t\t\t\t\t\t\t\t\t\t\t\t\t\t\t\t\t\t\t\t\t\t\t\n\t\t\tvineG.goto_node(8);\t\t\t\t\t\t\t\t\t\t\t\t\t\t\t\t\t\t\t\t\t\t\t\t\t\t\t\t\t\t\t\t\t\t\t\t\t\t\t\t\n\t\t\tvineH.goto_node(8);\t\t\t\t\t\t\t\t\t\t\t\t\t\t\t\t\t\t\t\t\t\t\t\t\t\t\t\t\t\t\t\t\t\t\t\t\t\t\t\t\n\t\t")
    )
    (bonusblock
      (x 768)
      (y 640)
      (contents "script")
      (sprite "images/objects/bonus_block/hiddenbonus.sprite")
      (count 0)
      (script "\t\t\t\t\t\t\t\t\t\t\t\t\t\t\t\t\t\t\t\t\t\t\t\t\t\t\t\t\t\t\t\t\t\t\t\t\t\t\t\t\t\n\t\t\tif(lightson){\t\t\t\t\t\t\t\t\t\t\t\t\t\t\t\t\t\t\t\t\t\t\t\t\t\t\t\t\t\t\t\t\t\t\t\t\t\t\t\t\n\t\t\t\tlightson <- false;\t\t\t\t\t\t\t\t\t\t\t\t\t\t\t\t\t\t\t\t\t\t\t\t\t\t\t\t\t\t\t\t\t\t\t\t\t\t\t\n\t\t\t\tsettings.set_ambient_light(0, 0, 0);\t\t\t\t\t\t\t\t\t\t\t\t\t\t\t\t\t\t\t\t\t\t\t\t\t\t\t\t\t\t\t\t\t\t\t\t\t\t\t\n\t\t\t\tcover.fade(0,0);\t\t\t\t\t\t\t\t\t\t\t\t\t\t\t\t\t\t\t\t\t\t\t\t\t\t\t\t\t\t\t\t\t\t\t\t\t\t\t\n\t\t\t} else {\t\t\t\t\t\t\t\t\t\t\t\t\t\t\t\t\t\t\t\t\t\t\t\t\t\t\t\t\t\t\t\t\t\t\t\t\t\t\t\t\n\t\t\t\tlightson <- true;\t\t\t\t\t\t\t\t\t\t\t\t\t\t\t\t\t\t\t\t\t\t\t\t\t\t\t\t\t\t\t\t\t\t\t\t\t\t\t\n\t\t\t\tsettings.set_ambient_light(1, 1, 1);\t\t\t\t\t\t\t\t\t\t\t\t\t\t\t\t\t\t\t\t\t\t\t\t\t\t\t\t\t\t\t\t\t\t\t\t\t\t\t\n\t\t\t\tcover.fade(1,0);\t\t\t\t\t\t\t\t\t\t\t\t\t\t\t\t\t\t\t\t\t\t\t\t\t\t\t\t\t\t\t\t\t\t\t\t\t\t\t\n\t\t\t}\t\t\t\t\t\t\t\t\t\t\t\t\t\t\t\t\t\t\t\t\t\t\t\t\t\t\t\t\t\t\t\t\t\t\t\t\t\t\t\t\n\t\t")
    )
    (candle
      (x 768)
      (y 640)
    )
    (tilemap
      (name "cover")
      (alpha 1)
      (z-pos -100)
      (solid #f)
      (path
        (node
          (x 767)
          (y 640)
        )
      )
      (width 1)
      (height 1)
      (tiles 131)
    )
    (tilemap
      (z-pos -200)
      (solid #f)
      (path
        (node
          (x 767)
          (y 640)
        )
      )
      (width 1)
      (height 1)
      (tiles 61)
    )
    (tilemap
      (name "vineA")
      (z-pos -50)
      (solid #t)
      (path
        (node
          (x 640)
          (y 640)
          (time 0.25)
        )
        (node
          (x 640)
          (y 608)
          (time 0.25)
        )
        (node
          (x 640)
          (y 576)
          (time 0.25)
        )
        (node
          (x 640)
          (y 544)
          (time 0.25)
        )
        (node
          (x 640)
          (y 512)
          (time 0.25)
        )
        (node
          (x 640)
          (y 480)
          (time 0.25)
        )
        (node
          (x 640)
          (y 448)
          (time 0.25)
        )
        (node
          (x 640)
          (y 416)
          (time 0.25)
        )
        (node
          (x 640)
          (y 384)
          (time 0.25)
        )
      )
      (width 1)
      (height 1)
      (tiles 2163)
    )
    (tilemap
      (name "vineB")
      (z-pos -50)
      (solid #t)
      (path
        (node
          (x 640)
          (y 640)
          (time 0.25)
        )
        (node
          (x 640)
          (y 640)
          (time 0.25)
        )
        (node
          (x 640)
          (y 608)
          (time 0.25)
        )
        (node
          (x 640)
          (y 576)
          (time 0.25)
        )
        (node
          (x 640)
          (y 544)
          (time 0.25)
        )
        (node
          (x 640)
          (y 512)
          (time 0.25)
        )
        (node
          (x 640)
          (y 480)
          (time 0.25)
        )
        (node
          (x 640)
          (y 448)
          (time 0.25)
        )
        (node
          (x 640)
          (y 416)
          (time 0.25)
        )
      )
      (width 1)
      (height 1)
      (tiles 2162)
    )
    (tilemap
      (name "vineC")
      (z-pos -50)
      (solid #t)
      (path
        (node
          (x 640)
          (y 640)
          (time 0.25)
        )
        (node
          (x 640)
          (y 640)
          (time 0.25)
        )
        (node
          (x 640)
          (y 640)
          (time 0.25)
        )
        (node
          (x 640)
          (y 608)
          (time 0.25)
        )
        (node
          (x 640)
          (y 576)
          (time 0.25)
        )
        (node
          (x 640)
          (y 544)
          (time 0.25)
        )
        (node
          (x 640)
          (y 512)
          (time 0.25)
        )
        (node
          (x 640)
          (y 480)
          (time 0.25)
        )
        (node
          (x 640)
          (y 448)
          (time 0.25)
        )
      )
      (width 1)
      (height 1)
      (tiles 2162)
    )
    (tilemap
      (name "vineD")
      (z-pos -50)
      (solid #t)
      (path
        (node
          (x 640)
          (y 640)
          (time 0.25)
        )
        (node
          (x 640)
          (y 640)
          (time 0.25)
        )
        (node
          (x 640)
          (y 640)
          (time 0.25)
        )
        (node
          (x 640)
          (y 640)
          (time 0.25)
        )
        (node
          (x 640)
          (y 608)
          (time 0.25)
        )
        (node
          (x 640)
          (y 576)
          (time 0.25)
        )
        (node
          (x 640)
          (y 544)
          (time 0.25)
        )
        (node
          (x 640)
          (y 512)
          (time 0.25)
        )
        (node
          (x 640)
          (y 480)
          (time 0.25)
        )
      )
      (width 1)
      (height 1)
      (tiles 2162)
    )
    (tilemap
      (name "vineE")
      (z-pos -50)
      (solid #t)
      (path
        (node
          (x 640)
          (y 640)
          (time 0.25)
        )
        (node
          (x 640)
          (y 640)
          (time 0.25)
        )
        (node
          (x 640)
          (y 640)
          (time 0.25)
        )
        (node
          (x 640)
          (y 640)
          (time 0.25)
        )
        (node
          (x 640)
          (y 640)
          (time 0.25)
        )
        (node
          (x 640)
          (y 608)
          (time 0.25)
        )
        (node
          (x 640)
          (y 576)
          (time 0.25)
        )
        (node
          (x 640)
          (y 544)
          (time 0.25)
        )
        (node
          (x 640)
          (y 512)
          (time 0.25)
        )
      )
      (width 1)
      (height 1)
      (tiles 2163)
    )
    (tilemap
      (name "vineF")
      (z-pos -50)
      (solid #t)
      (path
        (node
          (x 640)
          (y 640)
          (time 0.25)
        )
        (node
          (x 640)
          (y 640)
          (time 0.25)
        )
        (node
          (x 640)
          (y 640)
          (time 0.25)
        )
        (node
          (x 640)
          (y 640)
          (time 0.25)
        )
        (node
          (x 640)
          (y 640)
          (time 0.25)
        )
        (node
          (x 640)
          (y 640)
          (time 0.25)
        )
        (node
          (x 640)
          (y 608)
          (time 0.25)
        )
        (node
          (x 640)
          (y 576)
          (time 0.25)
        )
        (node
          (x 640)
          (y 544)
          (time 0.25)
        )
      )
      (width 1)
      (height 1)
      (tiles 2162)
    )
    (tilemap
      (name "vineG")
      (z-pos -50)
      (solid #t)
      (path
        (node
          (x 640)
          (y 640)
          (time 0.25)
        )
        (node
          (x 640)
          (y 640)
          (time 0.25)
        )
        (node
          (x 640)
          (y 640)
          (time 0.25)
        )
        (node
          (x 640)
          (y 640)
          (time 0.25)
        )
        (node
          (x 640)
          (y 640)
          (time 0.25)
        )
        (node
          (x 640)
          (y 640)
          (time 0.25)
        )
        (node
          (x 640)
          (y 640)
          (time 0.25)
        )
        (node
          (x 640)
          (y 608)
          (time 0.25)
        )
        (node
          (x 640)
          (y 576)
          (time 0.25)
        )
      )
      (width 1)
      (height 1)
      (tiles 2162)
    )
    (tilemap
      (name "vineH")
      (z-pos -50)
      (solid #t)
      (path
        (node
          (x 640)
          (y 640)
          (time 0.25)
        )
        (node
          (x 640)
          (y 640)
          (time 0.25)
        )
        (node
          (x 640)
          (y 640)
          (time 0.25)
        )
        (node
          (x 640)
          (y 640)
          (time 0.25)
        )
        (node
          (x 640)
          (y 640)
          (time 0.25)
        )
        (node
          (x 640)
          (y 640)
          (time 0.25)
        )
        (node
          (x 640)
          (y 640)
          (time 0.25)
        )
        (node
          (x 640)
          (y 640)
          (time 0.25)
        )
        (node
          (x 640)
          (y 608)
          (time 0.25)
        )
      )
      (width 1)
      (height 1)
      (tiles 2162)
    )
  )
)
