(supertux-level
  (version 2)
  (name (_ "Candle Scripting Test"))
  (author "Marek Moeckel")
  (sector
    (name "main")
    (ambient-light 0.1 0.01 0.01)
    (background
      (speed 0.5)
      (image "images/background/BlueRock_Forest/blue-top.jpg")
    )
    (tilemap
      (z-pos -100)
      (solid #f)
      (speed 1)
      (width 30)
      (height 30)
      (tiles 0 0 0 0 0 0 0 0 0 0 0 0 0 0 0 0 0 0 0 0 0 0 0 0 0 0 0 0 0 0 0 0 0 0 0 0 0 0 0 0 0 0 0 0 0 0 0 0 0 0 0 0 0 0 0 0 0 0 0 0 0 0 0 0 0 0 0 0 0 0 0 0 0 0 0 0 0 0 0 0 0 0 0 0 0 0 0 0 0 0 0 0 0 0 0 0 0 0 0 0 0 0 0 0 0 0 0 0 0 0 0 0 0 0 0 0 0 0 0 0 0 0 0 0 0 0 0 0 0 0 0 0 0 0 0 0 0 0 0 0 0 0 0 0 0 0 0 0 0 0 0 0 0 0 0 0 0 0 0 0 0 0 0 0 0 0 0 0 0 0 0 0 0 0 0 0 0 0 0 0 0 0 0 0 0 0 0 0 0 0 0 0 0 0 0 0 0 0 0 0 0 0 0 0 0 0 0 0 0 0 0 0 0 0 0 0 0 0 0 0 0 0 0 0 0 0 0 0 0 0 0 0 0 0 0 0 0 0 0 0 0 0 0 0 0 0 0 0 0 0 0 0 0 0 0 0 0 0 0 0 0 0 0 0 0 0 0 0 0 0 0 0 0 0 0 0 0 0 0 0 0 0 0 0 0 0 0 0 0 0 0 0 0 0 0 0 0 0 0 0 0 0 0 0 0 0 0 0 0 0 0 0 0 0 0 0 0 0 0 0 0 0 0 0 0 0 0 0 0 0 0 0 0 0 0 0 0 0 0 0 0 0 0 0 0 0 0 0 0 0 0 0 0 0 0 0 0 0 0 0 0 0 0 0 0 0 0 0 0 0 0 0 0 0 0 0 0 0 0 0 0 0 0 0 0 0 0 0 0 0 0 0 0 0 0 0 0 0 0 0 0 0 0 0 0 0 0 0 0 0 0 0 0 0 0 0 0 0 0 0 0 0 0 0 0 0 0 0 0 0 0 0 0 0 0 0 0 0 0 0 0 0 0 0 0 0 0 0 0 0 0 0 0 0 0 0 0 0 0 0 0 0 0 0 0 0 0 0 0 0 0 0 0 0 0 0 0 0 0 0 0 0 0 0 0 0 0 0 0 0 0 0 0 0 0 0 0 0 0 0 0 0 0 0 0 0 0 0 0 0 0 0 0 0 0 0 0 0 0 0 0 0 0 0 0 0 0 0 0 0 0 0 0 0 0 0 80 0 0 0 0 0 0 0 0 0 0 0 0 0 0 0 0 0 0 0 0 0 0 0 0 0 0 0 0 0 79 0 0 0 0 0 0 0 0 0 0 0 0 0 0 0 0 0 0 0 0 0 0 0 0 0 0 0 0 1717 1722 1719 1718 0 0 0 0 0 0 0 0 0 0 0 0 0 0 0 0 0 0 0 0 0 0 0 0 0 0 0 79 0 0 0 0 0 0 0 0 0 0 0 0 0 0 0 0 0 0 0 0 0 0 0 0 0 0 0 0 1717 1722 1719 1718 0 0 0 0 0 0 0 0 0 0 0 0 0 0 0 0 0 0 0 0 0 0 0 0 0 0 0 1348 0 0 0 0 0 0 0 0 0 0 0 0 0 0 0 0 0 0 0 0 0 0 0 0 0 0 0 0 0 79 0 0 0 0 0 0 0 0 0 0 0 0 0 0 0 0 0 0 0 0 0 0 0 0 0 0 0 0 0 79 0 0 0 0 0 0 0 0 0 0 0 0 0 0 0 0 0 0 0 0 0 0 0 0 0 0 0 0 0 79 0 0 0 0 0 0 0 0 0 0 0 0 0 0 0 0 0 0 0 0 0 0 0 0 0 0 0 0 0 79 0 0 0 0 0 0 0 0 0 0 0 0 0 0 0 0 1355 0 1355 0 1355 0 1355 0 1355 0 0 0 0 79 0 0 0 0 0 0 0 0 0 0 0 0 0 0 0 0 1356 0 1356 0 1356 0 1356 0 1356 0 0 0 0 0 0 0 0 0 0 0 0 0 0 0 0 0 0 0 0 0 0 0 0 0 0 0 0 0 0 0 0 0 0 0 0 0 0)
    )
    (tilemap
      (z-pos 0)
      (solid #t)
      (speed 1)
      (width 30)
      (height 30)
      (tiles 61 61 61 61 61 61 61 61 61 61 61 61 61 61 61 61 61 61 61 61 61 61 61 61 61 61 61 61 61 61 61 0 0 0 0 0 0 0 0 0 0 0 0 0 0 0 0 0 0 0 0 0 0 0 0 0 0 0 0 61 61 0 0 0 0 0 0 0 0 0 0 0 0 0 0 0 0 0 0 0 0 0 0 0 0 0 0 0 0 61 61 0 0 0 0 0 0 0 0 0 0 0 0 0 0 0 0 0 0 0 0 0 0 0 0 0 0 0 0 61 61 0 0 0 0 0 0 0 0 0 0 0 0 0 0 0 0 0 0 0 0 0 0 0 0 0 0 0 0 61 61 0 0 0 0 0 0 0 0 0 0 0 0 0 0 0 0 0 0 0 0 0 0 0 0 0 0 0 0 61 61 0 0 0 0 0 0 0 0 0 0 0 0 0 0 0 0 0 0 0 0 0 0 0 0 0 0 0 0 61 61 0 0 0 0 0 0 0 0 0 0 0 0 0 0 0 0 0 0 0 0 0 0 0 0 0 0 0 0 61 61 0 0 0 0 0 0 0 0 0 0 0 0 0 0 0 0 0 0 0 0 0 0 0 0 0 0 0 0 61 61 0 0 0 0 0 0 0 0 0 0 0 0 0 0 0 0 0 0 0 0 0 0 0 0 0 0 0 0 61 61 0 0 0 0 0 0 0 0 0 0 0 0 0 0 0 0 0 0 0 0 0 0 0 0 0 0 0 0 61 61 0 0 0 0 0 0 0 0 0 0 0 0 0 0 0 0 0 0 0 0 0 0 0 0 0 0 0 0 61 61 0 0 0 0 0 0 0 0 0 0 0 0 0 0 0 0 0 0 0 0 0 0 0 0 0 0 0 0 61 61 0 0 0 0 0 0 0 0 0 0 0 0 0 0 0 0 0 0 0 0 0 0 0 0 0 0 0 0 61 61 0 0 0 0 0 0 0 0 0 0 0 0 0 0 0 0 0 0 0 0 0 0 0 0 0 0 0 0 61 61 0 0 0 0 0 0 0 0 0 0 0 0 0 0 0 0 0 0 0 0 0 0 0 0 0 0 0 0 61 61 0 0 0 0 0 0 0 0 0 0 0 0 0 0 0 0 0 0 0 0 0 0 0 0 0 0 0 0 61 61 0 0 0 0 0 0 0 0 0 0 0 0 0 0 0 0 0 0 0 0 0 0 0 0 0 0 0 0 61 61 0 0 0 0 0 0 0 0 0 0 0 0 0 0 0 0 0 0 0 0 0 0 0 0 0 0 0 0 61 61 0 0 0 0 0 0 0 0 0 0 0 0 0 0 0 0 0 0 0 0 0 0 0 0 0 0 0 0 61 61 0 0 0 0 0 0 0 0 0 0 0 0 0 0 0 0 0 0 0 0 0 0 0 0 0 0 0 0 61 61 0 0 0 0 0 0 0 0 0 0 0 0 0 0 0 0 0 0 0 0 0 0 0 0 0 0 0 0 61 61 0 0 0 0 0 0 0 0 0 0 0 0 0 0 0 0 0 0 0 0 0 0 0 0 0 0 0 0 61 61 0 0 0 0 0 0 0 0 0 0 0 0 0 0 0 0 0 0 0 0 0 0 0 0 0 0 0 0 61 61 0 0 0 0 0 0 0 0 0 0 0 0 0 0 0 0 0 0 0 0 0 0 0 0 0 0 0 0 61 61 0 0 0 0 0 0 0 0 0 0 0 0 0 0 0 0 0 0 0 0 0 0 0 0 0 0 0 0 61 61 0 0 0 0 0 0 0 0 0 0 0 0 0 0 0 0 0 0 0 0 0 0 0 0 0 0 0 0 61 61 0 0 0 0 0 0 0 0 0 0 0 0 0 0 0 0 0 0 0 0 0 0 0 0 0 0 0 0 61 61 0 0 0 0 0 0 0 0 0 0 0 0 0 0 0 0 0 0 0 0 0 0 0 0 0 1349 0 0 61 61 61 61 61 61 61 61 61 61 61 61 61 61 61 61 61 61 61 61 61 61 61 61 61 61 61 61 61 61 61)
    )
    (tilemap
      (z-pos 100)
      (solid #f)
      (speed 1)
      (width 30)
      (height 30)
      (tiles 0 0 0 0 0 0 0 0 0 0 0 0 0 0 0 0 0 0 0 0 0 0 0 0 0 0 0 0 0 0 0 0 0 0 0 0 0 0 0 0 0 0 0 0 0 0 0 0 0 0 0 0 0 0 0 0 0 0 0 0 0 0 0 0 0 0 0 0 0 0 0 0 0 0 0 0 0 0 0 0 0 0 0 0 0 0 0 0 0 0 0 0 0 0 0 0 0 0 0 0 0 0 0 0 0 0 0 0 0 0 0 0 0 0 0 0 0 0 0 0 0 0 0 0 0 0 0 0 0 0 0 0 0 0 0 0 0 0 0 0 0 0 0 0 0 0 0 0 0 0 0 0 0 0 0 0 0 0 0 0 0 0 0 0 0 0 0 0 0 0 0 0 0 0 0 0 0 0 0 0 0 0 0 0 0 0 0 0 0 0 0 0 0 0 0 0 0 0 0 0 0 0 0 0 0 0 0 0 0 0 0 0 0 0 0 0 0 0 0 0 0 0 0 0 0 0 0 0 0 0 0 0 0 0 0 0 0 0 0 0 0 0 0 0 0 0 0 0 0 0 0 0 0 0 0 0 0 0 0 0 0 0 0 0 0 0 0 0 0 0 0 0 0 0 0 0 0 0 0 0 0 0 0 0 0 0 0 0 0 0 0 0 0 0 0 0 0 0 0 0 0 0 0 0 0 0 0 0 0 0 0 0 0 0 0 0 0 0 0 0 0 0 0 0 0 0 0 0 0 0 0 0 0 0 0 0 0 0 0 0 0 0 0 0 0 0 0 0 0 0 0 0 0 0 0 0 0 0 0 0 0 0 0 0 0 0 0 0 0 0 0 0 0 0 0 0 0 0 0 0 0 0 0 0 0 0 0 0 0 0 0 0 0 0 0 0 0 0 0 0 0 0 0 0 0 0 0 0 0 0 0 0 0 0 0 0 0 0 0 0 0 0 0 0 0 0 0 0 0 0 0 0 0 0 0 0 0 0 0 0 0 0 0 0 0 0 0 0 0 0 0 0 0 0 0 0 0 0 0 0 0 0 0 0 0 0 0 0 0 0 0 0 0 0 0 0 0 0 0 0 0 0 0 0 0 0 0 0 0 0 0 0 0 0 0 0 0 0 0 0 0 0 0 0 0 0 0 0 0 0 0 0 0 0 0 0 0 0 0 0 0 0 0 0 0 0 0 0 0 0 0 0 0 0 0 0 0 0 0 0 0 0 0 0 0 0 0 0 0 0 0 0 0 0 0 0 0 0 0 0 0 0 0 0 0 0 0 0 0 0 0 0 0 0 0 0 0 0 0 0 0 0 0 0 0 0 0 0 0 0 0 0 0 0 0 0 0 0 0 0 0 0 0 0 0 0 0 0 0 0 0 0 0 0 0 0 0 0 0 0 0 0 0 0 0 0 0 0 0 0 0 0 0 0 0 0 0 0 0 0 0 0 0 0 0 0 0 0 0 0 0 0 0 0 0 0 0 0 0 0 0 0 0 0 0 0 0 0 0 0 0 0 0 0 0 0 0 0 0 0 0 0 0 0 0 0 0 0 0 0 0 0 0 0 0 0 0 0 0 0 0 0 0 0 0 0 0 0 0 0 0 0 0 0 0 0 0 0 0 0 0 0 0 0 0 0 0 0 0 0 0 0 0 0 0 0 0 0 0 0 0 0 0 0 0 0 0 0 0 0 0 0 0 0 0 0 0 0 0 0 0 0 0 0 0 0 0 0 0 0 0 0 0 0 0 0 0 0 0 0 0 0 0 0 0 0 0 0 0 0 0 0 0 0 0 0 0 0 0 0 0 0 0 0 0 0 0 0 0 0 0 0 0 0 0 0 0 0 0 0 0 0 0 0 0 0 0 0 0 0 0 0 0 0 0 0 0 0 0 0 0 0 0 0 0 0 0 0 0 0 0 0 0 0 0 0 0 0 0 0 0 0 0 0 0 0 0 0 0 0 0 0 0 0 0 0 0 0 0 0 0 0 0 0 0 0 0 0 0 0 0 0 0 0 0 0 0 0 0 0)
    )
    (tilemap
      (z-pos -101)
      (solid #f)
      (name "TileBG")
      (speed 1)
      (width 30)
      (height 30)
      (tiles 1900 1901 1902 1903 1900 1901 1902 1903 1900 1901 1902 1903 1900 1901 1902 1903 1900 1901 1902 1903 1900 1901 1902 1903 1900 1901 1902 1903 1900 1901 1904 1905 1906 1907 1904 1905 1906 1907 1904 1905 1906 1907 1904 1905 1906 1907 1904 1905 1906 1907 1904 1905 1906 1907 1904 1905 1906 1907 1904 1905 1908 1909 1910 1911 1908 1909 1910 1911 1908 1909 1910 1911 1908 1909 1910 1911 1908 1909 1910 1911 1908 1909 1910 1911 1908 1909 1910 1911 1908 1909 1912 1913 1914 1915 1912 1913 1914 1915 1912 1913 1914 1915 1912 1913 1914 1915 1912 1913 1914 1915 1912 1913 1914 1915 1912 1913 1914 1915 1912 1913 1900 1901 1902 1903 1900 1901 1902 1903 1900 1901 1902 1903 1900 1901 1902 1903 1900 1901 1902 1903 1900 1901 1902 1903 1900 1901 1902 1903 1900 1901 1904 1905 1906 1907 1904 1905 1906 1907 1904 1905 1906 1907 1904 1905 1906 1907 1904 1905 1906 1907 1904 1905 1906 1907 1904 1905 1906 1907 1904 1905 1908 1909 1910 1911 1908 1909 1910 1911 1908 1909 1910 1911 1908 1909 1910 1911 1908 1909 1910 1911 1908 1909 1910 1911 1908 1909 1910 1911 1908 1909 1912 1913 1914 1915 1912 1913 1914 1915 1912 1913 1914 1915 1912 1913 1914 1915 1912 1913 1914 1915 1912 1913 1914 1915 1912 1913 1914 1915 1912 1913 1900 1901 1902 1903 1900 1901 1902 1903 1900 1901 1902 1903 1900 1901 1902 1903 1900 1901 1902 1903 1900 1901 1902 1903 1900 1901 1902 1903 1900 1901 1904 1905 1906 1907 1904 1905 1906 1907 1904 1905 1906 1907 1904 1905 1906 1907 1904 1905 1906 1907 1904 1905 1906 1907 1904 1905 1906 1907 1904 1905 1908 1909 1910 1911 1908 1909 1910 1911 1908 1909 1910 1911 1908 1909 1910 1911 1908 1909 1910 1911 1908 1909 1910 1911 1908 1909 1910 1911 1908 1909 1912 1913 1914 1915 1912 1913 1914 1915 1912 1913 1914 1915 1912 1913 1914 1915 1912 1913 1914 1915 1912 1913 1914 1915 1912 1913 1914 1915 1912 1913 1900 1901 1902 1903 1900 1901 1902 1903 1900 1901 1902 1903 1900 1901 1902 1903 1900 1901 1902 1903 1900 1901 1902 1903 1900 1901 1902 1903 1900 1901 1904 1905 1906 1907 1904 1905 1906 1907 1904 1905 1906 1907 1904 1905 1906 1907 1904 1905 1906 1907 1904 1905 1906 1907 1904 1905 1906 1907 1904 1905 1908 1909 1910 1911 1908 1909 1910 1911 1908 1909 1910 1911 1908 1909 1910 1911 1908 1909 1910 1911 1908 1909 1910 1911 1908 1909 1910 1911 1908 1909 1912 1913 1914 1915 1912 1913 1914 1915 1912 1913 1914 1915 1912 1913 1914 1915 1912 1913 1914 1915 1912 1913 1914 1915 1912 1913 1914 1915 1912 1913 1900 1901 1902 1903 1900 1901 1902 1903 1900 1901 1902 1903 1900 1901 1902 1903 1900 1901 1902 1903 1900 1901 1902 1903 1900 1901 1902 1903 1900 1901 1904 1905 1906 1907 1904 1905 1906 1907 1904 1905 1906 1907 1904 1905 1906 1907 1904 1905 1906 1907 1904 1905 1906 1907 1904 1905 1906 1907 1904 1905 1908 1909 1910 1911 1908 1909 1910 1911 1908 1909 1910 1911 1908 1909 1910 1911 1908 1909 1910 1911 1908 1909 1910 1911 1908 1909 1910 1911 1908 1909 1912 1913 1914 1915 1912 1913 1914 1915 1912 1913 1914 1915 1912 1913 1914 1915 1912 1913 1914 1915 1912 1913 1914 1915 1912 1913 1914 1915 1912 1913 1900 1901 1902 1903 1900 1901 1902 1903 1900 1901 1902 1903 1900 1901 1902 1903 1900 1901 1902 1903 1900 1901 1902 1903 1900 1901 1902 1903 1900 1901 1904 1905 1906 1907 1904 1905 1906 1907 1904 1905 1906 1907 1904 1905 1906 1907 1904 1905 1906 1907 1904 1905 1906 1907 1904 1905 1906 1907 1904 1905 1908 1909 1910 1911 1908 1909 1910 1911 1908 1909 1910 1911 1908 1909 1910 1911 1908 1909 1910 1911 1908 1909 1910 1911 1908 1909 1910 1911 1908 1909 1912 1913 1914 1915 1912 1913 1914 1915 1912 1913 1914 1915 1912 1913 1914 1915 1912 1913 1914 1915 1912 1913 1914 1915 1912 1913 1914 1915 1912 1913 1900 1901 1902 1903 1900 1901 1902 1903 1900 1901 1902 1903 1900 1901 1902 1903 1900 1901 1902 1903 1900 1901 1902 1903 1900 1901 1902 1903 1900 1901 1904 1905 1906 1907 1904 1905 1906 1907 1904 1905 1906 1907 1904 1905 1906 1907 1904 1905 1906 1907 1904 1905 1906 1907 1904 1905 1906 1907 1904 1905 1908 1909 1910 1911 1908 1909 1910 1911 1908 1909 1910 1911 1908 1909 1910 1911 1908 1909 1910 1911 1908 1909 1910 1911 1908 1909 1910 1911 1908 1909 1912 1913 1914 1915 1912 1913 1914 1915 1912 1913 1914 1915 1912 1913 1914 1915 1912 1913 1914 1915 1912 1913 1914 1915 1912 1913 1914 1915 1912 1913 1900 1901 1902 1903 1900 1901 1902 1903 1900 1901 1902 1903 1900 1901 1902 1903 1900 1901 1902 1903 1900 1901 1902 1903 1900 1901 1902 1903 1900 1901 1904 1905 1906 1907 1904 1905 1906 1907 1904 1905 1906 1907 1904 1905 1906 1907 1904 1905 1906 1907 1904 1905 1906 1907 1904 1905 1906 1907 1904 1905)
    )
    (camera
      (mode "normal")
    )
    (spawnpoint
      (name "main")
      (x 253.7847)
      (y 826.1837)
    )
    (candle
      (name "candle1")
      (burning #f)
      (x 416)
      (y 832)
    )
    (candle
      (name "candle2")
      (burning #f)
      (x 480)
      (y 832)
    )
    (candle
      (name "candle3")
      (x 544)
      (y 832)
    )
    (candle
      (name "candle4")
      (burning #f)
      (x 608)
      (y 832)
    )
    (candle
      (name "candle5")
      (burning #f)
      (x 672)
      (y 832)
    )
    (scripttrigger
      (script "candle1.set_burning(true);
wait(0.1);
candle2.set_burning(true);
wait(0.1);
candle3.set_burning(false);
wait(0.1);
candle4.set_burning(true);
wait(0.1);
candle5.set_burning(true);
wait(0.1);
")
      (button #f)
      (width 32)
      (height 32)
      (x 352)
      (y 896)
    )
    (scripttrigger
      (script "candle1.set_burning(false);
wait(0.1);
candle2.set_burning(false);
wait(0.1);
candle3.set_burning(true);
wait(0.1);
candle4.set_burning(false);
wait(0.1);
candle5.set_burning(false);
wait(0.1);
")
      (button #f)
      (width 32)
      (height 32)
      (x 736)
      (y 896)
    )
  )
)
