(supertux-level
  (version 2)
  (name (_ "Dark Snow Test (+Icecrusher)"))
  (author "ingo")
  (sector
    (name "main")
    (ambient-light 1 1 1)
    (background
      (speed 0.5)
      (image-top "images/background/cave2.jpg")
      (image "images/background/cave2.jpg")
      (image-bottom "images/background/cave2.jpg")
    )
    (camera
      (mode "normal")
    )
    (icecrusher
      (x 1227)
      (y 232)
    )
    (icecrusher
      (x 715)
      (y 232)
    )
    (icecrusher
      (x 555)
      (y 232)
    )
    (spawnpoint
      (name "main")
      (x 96)
      (y 96)
    )
    (tilemap
      (z-pos 0)
      (solid #t)
      (name "Interactive")
      (width 100)
      (height 35)
      (tiles
      0 0 0 0 0 0 0 0 2390 2391 2391 2391 2391 2391 2391 2391 2391 2391 2391 2391 2391 2391 2391 2391 2391 2391 2391 2391 2391 2391 2391 2391 2391 2391 2391 2391 2391 2397 2391 2391 2391 2391 2396 2396 2391 2391 2391 2396 2396 2391 2391 2396 2396 2391 2391 0 0 0 0 0 0 0 0 0 0 0 0 0 0 0 0 0 0 0 0 0 0 0 0 0 0 0 0 0 0 0 0 0 0 0 0 0 0 0 0 0 0 0 0 0
      0 0 0 0 0 0 0 0 2390 2391 2391 2391 2391 2396 2396 2391 2391 2391 2396 2396 2391 2391 2391 2391 2397 2391 2391 2391 2391 2399 2391 2396 2396 2391 2391 2391 2396 2399 2399 2391 2396 2391 2391 2396 2391 2399 2391 2391 2396 2391 2391 2391 2396 2391 2399 0 0 0 0 0 0 0 0 0 0 0 0 0 0 0 0 0 0 0 0 0 0 0 0 0 0 0 0 0 0 0 0 0 0 0 0 0 0 0 0 0 0 0 0 0
      0 0 0 0 0 0 0 0 2390 2399 2399 2391 2399 2396 2391 2391 2391 2391 2391 2399 2391 2391 2391 2391 2396 2391 2391 2391 2399 2391 2391 2391 2396 2391 2399 2399 2391 2391 2391 2391 2391 2391 2391 2391 2391 2391 2391 2391 2391 2391 2391 2391 2391 2391 2391 0 0 0 0 0 0 0 0 0 0 0 0 0 0 0 0 0 0 0 0 0 0 0 0 0 0 0 0 0 0 0 0 0 0 0 0 0 0 0 0 0 0 0 0 0
      0 0 0 0 0 0 0 0 2390 2391 2397 2396 2391 2391 2391 2391 2391 2397 2391 2391 2391 2391 2399 2391 2391 2391 2391 2391 2391 2391 2391 2391 2391 2391 2391 2396 2391 2397 2391 2391 2391 2391 2391 2391 2391 2391 2391 2391 2391 2391 2391 2391 2391 2391 2391 0 0 0 0 0 0 0 0 0 0 0 0 0 0 0 0 0 0 0 0 0 0 0 0 0 0 0 0 0 0 0 0 0 0 0 0 0 0 0 0 0 0 0 0 0
      0 0 0 0 0 0 0 0 2390 2391 2391 2391 2391 2397 2397 2399 2391 2391 2391 2391 2391 2391 2397 2391 2391 2396 2391 2391 2396 2391 2391 2391 2391 2391 2391 2391 2396 2399 2399 2391 2396 2399 2391 2396 2396 2391 2399 2391 2396 2396 2399 2391 2397 2391 2391 0 0 0 0 0 0 0 0 0 0 0 0 0 0 0 0 0 0 0 0 0 0 0 0 0 0 0 0 0 0 0 0 0 0 0 0 0 0 0 0 0 0 0 0 0
      0 0 0 0 0 0 0 0 2390 2391 2396 2391 2391 2391 2391 2391 2391 2391 2391 2396 2391 2391 2391 2391 2391 2391 2399 2391 2399 2399 2399 2391 2397 2391 2391 2391 2391 2391 2391 2391 2391 2391 2391 2391 2396 2391 2399 2391 2391 2396 2391 2391 2396 2396 2391 2391 0 0 0 0 0 0 0 0 0 0 0 0 0 0 0 0 0 0 0 0 0 0 0 0 0 0 0 0 0 0 0 0 0 0 0 0 0 0 0 0 0 0 0 0
      0 0 0 0 0 0 0 0 2390 2399 2391 2391 2399 2396 2391 2391 2391 2394 2394 2394 2391 2394 2394 2394 2394 2391 2391 2391 2391 2391 2399 2396 2399 2399 2391 2396 2391 2391 2394 2394 2391 2391 2391 2391 2391 2391 2391 2391 2391 2391 2391 2391 2391 2396 2391 2399 0 0 0 0 0 0 0 0 0 0 0 0 0 0 0 0 0 0 0 0 0 0 0 0 0 0 0 0 0 0 0 0 0 0 0 0 0 0 0 0 0 0 0 0
      0 0 0 0 0 0 0 0 2390 2391 2391 2397 2391 2391 2391 2391 2392 0 0 0 2390 2392 0 0 0 2390 2391 2391 2391 2397 2391 2391 2391 2391 2391 2391 2391 2392 0 0 2390 2391 2391 2391 2391 2391 2391 2391 2391 2391 2391 2391 2391 2391 2391 2391 0 0 0 0 0 0 0 0 0 0 0 0 0 0 0 0 0 0 0 0 0 0 0 0 0 0 0 0 0 0 0 0 0 0 0 0 0 0 0 0 0 0 0 0
      0 0 0 0 0 0 0 0 2393 2394 2394 2394 2394 2394 2394 2394 2395 0 0 0 2393 2395 0 0 0 2393 2394 2394 2394 2394 2394 2394 2394 2394 2394 2394 2394 2395 0 0 2393 2394 2394 2394 2394 2394 2394 2394 2394 2394 2394 2391 2391 2391 2391 2391 0 0 0 0 0 0 0 0 0 0 0 0 0 0 0 0 0 0 0 0 0 0 0 0 0 0 0 0 0 0 0 0 0 0 0 0 0 0 0 0 0 0 0 0
      0 0 0 0 0 0 0 0 0 0 0 0 0 0 0 0 0 0 0 0 0 0 0 0 0 0 0 0 0 0 0 0 0 0 0 0 0 0 0 0 0 0 0 0 0 0 0 0 0 0 0 2399 2391 2397 2391 2391 0 0 0 0 0 0 0 0 0 0 0 0 0 0 0 0 0 0 0 0 0 0 0 0 0 0 0 0 0 0 0 0 0 0 0 0 0 0 0 0 0 0 0 0
      0 0 0 0 0 0 0 0 0 0 0 0 0 0 0 0 0 0 0 0 0 0 0 0 0 0 0 0 0 0 0 0 0 0 0 0 0 0 0 0 0 0 0 0 0 0 0 0 0 0 0 0 0 0 0 0 0 0 0 0 0 0 0 0 0 0 0 0 0 0 0 0 0 0 0 0 0 0 0 0 0 0 0 0 0 0 0 0 0 0 0 0 0 0 0 0 0 0 0 0
      0 0 0 0 0 0 0 0 0 0 0 0 0 0 0 0 0 0 0 0 0 0 0 0 0 0 0 0 0 0 0 0 0 0 0 0 0 0 0 0 0 0 0 0 0 0 0 0 0 0 0 0 0 0 0 0 0 0 0 0 0 0 0 0 0 0 0 0 0 0 0 0 0 0 0 0 0 0 0 0 0 0 0 0 0 0 0 0 0 0 0 0 0 0 0 0 0 0 0 0
      0 0 0 0 0 0 0 0 0 0 0 0 0 0 0 0 0 0 0 0 0 0 0 0 0 0 0 0 0 0 0 0 0 0 0 0 0 0 0 0 0 0 0 0 0 0 0 0 0 0 0 0 0 0 0 0 0 0 0 0 0 0 0 0 0 0 0 0 0 0 0 0 0 0 0 0 0 0 0 0 0 0 0 0 0 0 0 0 0 0 0 0 0 0 0 0 0 0 0 0
      0 0 0 0 0 0 0 0 0 0 0 0 0 0 0 0 0 0 0 0 0 0 0 0 0 0 0 0 0 0 0 0 0 0 0 0 0 0 0 0 0 0 0 0 0 0 0 0 0 0 0 0 0 0 0 0 0 0 0 0 0 0 0 0 0 0 0 0 0 0 0 0 0 0 0 0 0 0 0 0 0 0 0 0 0 0 0 0 0 0 0 0 0 0 0 0 0 0 0 0
      0 0 0 0 0 0 0 0 0 0 0 0 0 0 0 0 0 0 0 0 0 0 2384 2385 2385 2385 2386 0 0 0 0 0 0 0 0 2384 2385 2385 2385 2386 0 0 0 0 0 0 0 0 0 0 0 0 0 0 0 0 0 0 0 0 0 0 0 0 0 0 0 0 0 0 0 0 0 0 0 0 0 0 0 0 0 0 0 0 0 0 0 0 0 0 0 0 0 0 0 0 0 0 0 0
      0 0 0 0 0 0 0 0 0 0 0 0 2384 2385 2385 2385 2386 0 0 2384 2385 2385 2387 2388 2388 2388 2389 0 0 0 0 0 0 0 0 2387 2388 2388 2388 2389 0 0 0 0 0 0 0 0 0 0 0 0 0 0 0 0 0 0 0 0 0 0 0 0 0 0 0 0 0 0 0 0 0 0 0 0 0 0 0 0 0 0 0 0 0 0 0 0 0 0 0 0 0 0 0 0 0 0 0 0
      0 0 0 0 0 0 0 0 0 0 0 0 2387 2388 2388 2388 2389 0 0 2387 2388 2388 2397 2391 2397 2391 2392 0 0 0 0 0 0 0 0 2390 2391 2391 2391 2391 0 0 0 0 0 0 0 0 0 0 0 0 0 0 0 0 0 0 0 0 0 0 0 0 0 0 0 0 0 0 0 0 0 0 0 0 0 0 0 0 0 0 0 0 0 0 0 0 0 0 0 0 0 0 0 0 0 0 0 0
      2384 2385 2385 2385 2385 2385 2385 2385 2385 2385 2385 2385 2390 2391 2399 2391 2392 2385 2385 2390 2399 2399 2399 2391 2397 2391 2392 2385 2385 2385 2385 2385 2385 2385 2385 2390 2391 2396 2391 2392 2385 2385 2386 0 0 0 0 0 0 0 0 0 0 0 0 0 0 0 0 0 0 0 0 0 0 0 0 0 0 0 0 0 0 0 0 0 0 0 0 0 0 0 0 0 0 0 0 0 0 0 0 0 0 0 0 0 0 0 0 0
      2387 2388 2388 2388 2388 2388 2388 2388 2388 2388 2388 2388 2391 2391 2391 2391 2391 2388 2388 2399 2399 2399 2399 2397 2391 2391 2391 2388 2388 2388 2388 2388 2388 2388 2388 2391 2391 2391 2391 2391 2388 2388 2389 0 0 0 0 0 0 0 0 0 0 0 0 0 0 0 0 0 0 0 0 0 0 0 0 0 0 0 0 0 0 0 0 0 0 0 0 0 0 0 0 0 0 0 0 0 0 0 0 0 0 0 0 0 0 0 0 0
      2390 2391 2391 2397 2391 2391 2391 2397 2391 2391 2396 2391 2391 2391 2391 2391 2391 2396 2391 2391 2391 2391 2391 2391 2391 2391 2391 2391 2391 2399 2391 2391 2391 2391 2396 2391 2391 2391 2391 2391 2391 2391 2392 0 0 0 0 0 0 0 0 0 0 0 0 0 0 0 0 0 0 0 0 0 0 0 0 0 0 0 0 0 0 0 0 0 0 0 0 0 0 0 0 0 0 0 0 0 0 0 0 0 0 0 0 0 0 0 0 0
      2390 2391 2399 2391 2391 2391 2399 2399 2391 2391 2391 2391 2396 2399 2391 2391 2398 2398 2391 2391 2391 2398 2391 2399 2399 2391 2391 2396 2391 2391 2391 2391 2399 2391 2391 2391 2396 2399 2391 2391 2396 2391 2392 0 0 0 0 0 0 0 0 0 0 0 0 0 0 0 0 0 0 0 0 0 0 0 0 0 0 0 0 0 0 0 0 0 0 0 0 0 0 0 0 0 0 0 0 0 0 0 0 0 0 0 0 0 0 0 0 0
      2397 2391 2391 2397 2391 2391 2399 2399 2391 2391 2399 2399 2391 2391 2391 2391 2391 2391 2391 2398 2391 2391 2391 2391 2391 2391 2391 2391 2391 2396 2399 2391 2391 2391 2399 2399 2391 2391 2391 2391 2391 2391 2392 0 0 0 0 0 0 0 0 0 0 0 0 0 0 0 0 0 0 0 0 0 0 0 0 0 0 0 0 0 0 0 0 0 0 0 0 0 0 0 0 0 0 0 0 0 0 0 0 0 0 0 0 0 0 0 0 0
      2390 2391 2391 2391 2391 2391 2399 2391 2398 2398 2391 2391 2391 2399 2391 2398 2391 2391 2391 2396 2391 2391 2396 2396 2391 2391 2391 2399 2399 2391 2391 2391 2398 2398 2391 2391 2391 2399 2391 2391 2398 2391 2392 0 0 0 0 0 0 0 0 0 0 0 0 0 0 0 0 0 0 0 0 0 0 0 0 0 0 0 0 0 0 0 0 0 0 0 0 0 0 0 0 0 0 0 0 0 0 0 0 0 0 0 0 0 0 0 0 0
      2390 2391 2399 2391 2391 2397 2391 2391 2391 2397 2391 2391 2391 2398 2391 2391 2398 2391 2398 2398 2391 2391 2391 2391 2391 2398 2398 2391 2391 2391 2399 2391 2391 2397 2391 2391 2391 2398 2391 2391 2396 2391 2392 0 0 0 0 0 0 0 0 0 0 0 0 0 0 0 0 0 0 0 0 0 0 0 0 0 0 0 0 0 0 0 0 0 0 0 0 0 0 0 0 0 0 0 0 0 0 0 0 0 0 0 0 0 0 0 0 0
      2390 2391 2391 2391 2391 2391 2391 2391 2391 2391 2391 2398 2391 2391 2391 2391 2391 2397 2391 2391 2391 2396 2391 2391 2396 2391 2397 2391 2391 2391 2398 2391 2391 2397 2391 2391 2391 2398 2391 2391 2391 2391 2392 0 0 0 0 0 0 0 0 0 0 0 0 0 0 0 0 0 0 0 0 0 0 0 0 0 0 0 0 0 0 0 0 0 0 0 0 0 0 0 0 0 0 0 0 0 0 0 0 0 0 0 0 0 0 0 0 0
      2393 2394 2394 2394 2394 2394 2394 2394 2394 2394 2394 2394 2394 2394 2394 2394 2394 2394 2394 2394 2394 2394 2394 2394 2394 2394 2394 2394 2394 2394 2394 2394 2394 2394 2394 2394 2394 2394 2394 2394 2394 2394 2395 0 0 0 0 0 0 0 0 0 0 0 0 0 0 0 0 0 0 0 0 0 0 0 0 0 0 0 0 0 0 0 0 0 0 0 0 0 0 0 0 0 0 0 0 0 0 0 0 0 0 0 0 0 0 0 0 0
      0 0 0 0 0 0 0 0 0 0 0 0 0 0 0 0 0 0 0 0 0 0 0 0 0 0 0 0 0 0 0 0 0 0 0 0 0 0 0 0 0 0 0 0 0 0 0 0 0 0 0 0 0 0 0 0 0 0 0 0 0 0 0 0 0 0 0 0 0 0 0 0 0 0 0 0 0 0 0 0 0 0 0 0 0 0 0 0 0 0 0 0 0 0 0 0 0 0 0 0
      0 0 0 0 0 0 0 0 0 0 0 0 0 0 0 0 0 0 0 0 0 0 0 0 0 0 0 0 0 0 0 0 0 0 0 0 0 0 0 0 0 0 0 0 0 0 0 0 0 0 0 0 0 0 0 0 0 0 0 0 0 0 0 0 0 0 0 0 0 0 0 0 0 0 0 0 0 0 0 0 0 0 0 0 0 0 0 0 0 0 0 0 0 0 0 0 0 0 0 0
      0 0 0 0 0 0 0 0 0 0 0 0 0 0 0 0 0 0 0 0 0 0 0 0 0 0 0 0 0 0 0 0 0 0 0 0 0 0 0 0 0 0 0 0 0 0 0 0 0 0 0 0 0 0 0 0 0 0 0 0 0 0 0 0 0 0 0 0 0 0 0 0 0 0 0 0 0 0 0 0 0 0 0 0 0 0 0 0 0 0 0 0 0 0 0 0 0 0 0 0
      0 0 0 0 0 0 0 0 0 0 0 0 0 0 0 0 0 0 0 0 0 0 0 0 0 0 0 0 0 0 0 0 0 0 0 0 0 0 0 0 0 0 0 0 0 0 0 0 0 0 0 0 0 0 0 0 0 0 0 0 0 0 0 0 0 0 0 0 0 0 0 0 0 0 0 0 0 0 0 0 0 0 0 0 0 0 0 0 0 0 0 0 0 0 0 0 0 0 0 0
      0 0 0 0 0 0 0 0 0 0 0 0 0 0 0 0 0 0 0 0 0 0 0 0 0 0 0 0 0 0 0 0 0 0 0 0 0 0 0 0 0 0 0 0 0 0 0 0 0 0 0 0 0 0 0 0 0 0 0 0 0 0 0 0 0 0 0 0 0 0 0 0 0 0 0 0 0 0 0 0 0 0 0 0 0 0 0 0 0 0 0 0 0 0 0 0 0 0 0 0
      0 0 0 0 0 0 0 0 0 0 0 0 0 0 0 0 0 0 0 0 0 0 0 0 0 0 0 0 0 0 0 0 0 0 0 0 0 0 0 0 0 0 0 0 0 0 0 0 0 0 0 0 0 0 0 0 0 0 0 0 0 0 0 0 0 0 0 0 0 0 0 0 0 0 0 0 0 0 0 0 0 0 0 0 0 0 0 0 0 0 0 0 0 0 0 0 0 0 0 0
      0 0 0 0 0 0 0 0 0 0 0 0 0 0 0 0 0 0 0 0 0 0 0 0 0 0 0 0 0 0 0 0 0 0 0 0 0 0 0 0 0 0 0 0 0 0 0 0 0 0 0 0 0 0 0 0 0 0 0 0 0 0 0 0 0 0 0 0 0 0 0 0 0 0 0 0 0 0 0 0 0 0 0 0 0 0 0 0 0 0 0 0 0 0 0 0 0 0 0 0
      0 0 0 0 0 0 0 0 0 0 0 0 0 0 0 0 0 0 0 0 0 0 0 0 0 0 0 0 0 0 0 0 0 0 0 0 0 0 0 0 0 0 0 0 0 0 0 0 0 0 0 0 0 0 0 0 0 0 0 0 0 0 0 0 0 0 0 0 0 0 0 0 0 0 0 0 0 0 0 0 0 0 0 0 0 0 0 0 0 0 0 0 0 0 0 0 0 0 0 0
      0 0 0 0 0 0 0 0 0 0 0 0 0 0 0 0 0 0 0 0 0 0 0 0 0 0 0 0 0 0 0 0 0 0 0 0 0 0 0 0 0 0 0 0 0 0 0 0 0 0 0 0 0 0 0 0 0 0 0 0 0 0 0 0 0 0 0 0 0 0 0 0 0 0 0 0 0 0 0 0 0 0 0 0 0 0 0 0 0 0 0 0 0 0 0 0 0 0 0 0
      )
    )
  )
)
