;; Generated by Flexlay Editor
(supertux-level
  (version 2)
  (name   (_ "No Name"))
  (author "No Author")
  (sector
    (name  "main")
    (gravity 10.000000)
    (tilemap
      (layer  "background")
      (solid #f)
      (speed  1.000000)
      (width  25)
      (height 25)
      (tiles
        1478 1478 1478 1478 1478 1478 1478 1478 1478 1478 1478 1478 1478 1478 1478 1478 1478 1478 1478 1478 1478 1478 1478 1478 1478 
        1478 1478 1478 1478 1478 1478 1478 1478 1478 1478 1478 1478 1478 1478 1478 1478 1478 1478 1478 1478 1478 1478 1478 1478 1478 
        1478 1478 1478 1478 1478 1478 1478 1478 1478 1478 1478 1478 1478 1478 1478 1478 1478 1478 1478 1478 1478 1478 1478 1478 1478 
        131 131 131 131 131 131 131 131 131 131 131 131 131 131 1478 1478 1478 1478 1478 1478 1478 1478 1478 1478 1478 
        1477 1477 1477 1481 1481 1481 1481 1481 1481 1481 1481 1481 1481 1481 1478 1478 1478 1478 1478 1478 1478 1478 1478 1478 1478 
        1477 1477 1477 1481 1481 1503 1503 1503 1503 1503 1481 1481 1481 1481 1478 1478 1478 1478 1478 1478 1478 1478 1478 1478 1478 
        1477 1477 1481 1481 1503 1503 1503 1503 1503 1503 1503 1481 1481 1481 1478 1478 1478 1478 1478 1478 1478 1478 1478 1478 1478 
        1477 1481 1481 1503 1503 1526 1526 1526 1526 1526 1503 1503 1481 1481 1478 1478 1478 1478 1478 1478 1478 1478 1478 1478 1478 
        1481 1481 1503 1503 1526 1526 1526 1526 1526 1526 1526 1503 1503 1481 1478 1478 1478 1478 1478 1478 1478 1478 1478 1478 1478 
        1481 1503 1503 1526 1526 1526 1526 1526 1526 1526 1526 1526 1503 1503 131 131 131 131 131 131 131 131 131 131 131 
        1481 1503 1520 1523 1523 1523 1523 1523 1523 1523 1523 1523 1529 1503 1477 1477 1477 1477 1477 1477 1477 1477 1477 1481 1481 
        1517 1503 1521 1527 1527 1527 1527 1527 1527 1527 1527 1527 1530 1503 1517 1481 1479 1480 1481 1482 1483 1484 1485 1481 1481 
        1518 1503 1522 1525 1525 1525 1525 1525 1525 1525 1525 1525 1531 1503 1518 1481 1486 1487 1488 1489 1490 1491 1492 1481 1481 
        1488 1503 1520 1523 1523 1523 1523 1523 1523 1523 1523 1523 1529 1503 1481 1481 1493 1494 1495 1496 1497 1498 1499 1485 1481 
        1495 1503 1521 1527 1527 1527 1527 1527 1527 1527 1527 1527 1530 1503 1481 1481 1500 1501 1502 1503 1504 1505 1506 1481 1481 
        1502 1503 1522 1528 1528 1528 1528 1528 1528 1528 1528 1528 1531 1503 1481 1481 1507 1508 1509 1485 1481 1481 1485 1481 1481 
        1481 1503 1526 1526 1526 1526 1526 1526 1526 1526 1526 1526 1526 1503 1481 1481 1485 1481 1481 1481 1481 1481 1481 1485 1481 
        340 340 341 341 341 341 341 341 341 341 341 341 341 342 1481 1485 1481 1485 1481 1481 1481 1481 1485 1481 1481 
        1091 1091 1014 1014 1014 1014 1014 1014 1014 1014 1014 1014 1014 341 341 341 341 341 341 341 341 341 341 341 342 
        1091 1091 1014 1014 1014 1014 1014 1014 1014 1014 1014 1014 1014 449 449 449 449 449 449 449 449 449 449 449 449 
        1091 1091 1014 1014 1014 1014 1014 1014 1014 1014 1014 1014 1014 449 449 449 449 449 449 449 449 449 449 449 449 
        1091 1091 1014 1014 1014 1014 1014 1014 1014 1014 1014 1014 1014 1014 1014 1014 1014 1014 1014 1014 1014 1014 1014 449 449 
        1091 1091 1146 1146 1146 1146 1146 1146 1146 1146 1146 1146 1146 1146 1146 1146 1146 1146 1014 1014 1014 1014 1014 1091 1091 
        1091 1091 1091 1091 1091 1091 1091 1091 1091 1091 1091 1091 1091 1091 1091 1091 1014 1014 1014 1014 1014 1014 1014 1091 1091 
        1091 1091 1091 1091 1091 1091 1091 1091 1091 1091 1091 1091 1091 1091 1091 1091 1146 1146 1146 1146 1146 1146 1146 1091 1091 
        ))
    (tilemap
      (layer  "interactive")
      (solid #t)
      (speed  1.000000)
      (width  25)
      (height 25)
      (tiles
        1510 1510 1510 1510 1510 0 0 0 0 0 0 0 0 0 0 0 0 0 0 0 0 0 0 0 0 
        0 0 0 0 0 132 0 0 0 0 0 133 0 0 0 0 0 0 0 0 0 0 0 0 0 
        0 0 0 0 0 132 0 0 0 0 0 133 0 0 0 0 0 0 0 0 0 0 0 1348 0 
        61 61 61 61 61 61 61 61 61 61 61 61 61 61 0 0 0 0 0 0 0 0 0 79 0 
        0 0 0 0 0 0 0 0 0 0 0 0 0 0 65 0 0 0 0 0 0 0 0 79 0 
        0 0 0 0 0 0 0 0 0 0 0 0 0 0 0 65 0 0 0 0 0 0 0 79 0 
        0 0 0 0 0 0 0 0 0 0 0 0 0 0 0 0 0 0 0 0 0 0 0 79 0 
        0 0 0 0 0 0 0 0 0 0 0 0 0 0 0 0 0 0 0 0 0 0 0 79 0 
        0 0 0 0 0 0 0 0 0 0 0 0 0 0 0 0 0 0 0 0 0 0 0 1349 0 
        0 0 0 0 0 0 0 0 0 0 0 0 0 0 61 61 61 61 61 61 61 61 61 61 61 
        0 0 0 0 0 0 0 0 0 0 0 0 0 0 0 0 0 0 0 0 0 0 0 0 0 
        0 0 0 0 0 1519 0 0 0 1519 0 0 0 0 0 0 0 0 0 0 0 0 0 0 0 
        0 0 0 0 0 0 0 0 0 0 0 0 0 0 0 0 0 0 0 0 0 0 0 0 0 
        0 0 0 0 0 0 0 0 0 0 0 0 0 0 0 0 0 0 0 0 0 0 0 0 0 
        0 0 0 1519 0 0 0 1519 0 0 0 1519 0 0 0 0 0 0 0 0 0 0 0 0 0 
        0 0 0 0 0 0 0 0 0 0 0 0 0 0 0 0 0 0 0 0 0 0 0 0 0 
        0 0 0 0 0 0 0 0 0 0 0 0 0 0 0 0 0 0 0 0 0 0 0 0 0 
        0 0 0 0 0 0 0 0 0 0 0 0 0 0 0 0 0 0 0 0 0 0 0 0 0 
        28 28 28 28 29 0 0 0 0 0 27 28 28 28 28 28 28 28 28 28 28 28 28 28 28 
        0 0 47 0 0 0 0 0 0 0 0 0 0 0 0 0 0 0 0 0 0 0 0 0 0 
        0 0 47 0 0 0 0 0 0 0 0 0 0 0 0 0 0 0 0 0 0 0 0 0 0 
        0 0 47 0 0 0 0 0 0 0 0 0 0 0 0 0 0 0 0 0 0 0 0 0 0 
        0 0 27 28 28 28 28 28 28 28 28 28 28 28 28 28 28 29 0 0 0 0 0 0 0 
        0 0 0 0 0 0 0 0 0 0 0 0 0 0 0 0 47 0 0 0 0 0 0 0 0 
        0 0 0 0 0 0 0 0 0 0 0 0 0 0 0 0 27 28 28 28 28 28 28 28 29 
        ))
    (tilemap
      (layer  "foreground")
      (solid #f)
      (speed  1.000000)
      (width  25)
      (height 25)
      (tiles
        0 0 0 0 0 0 0 0 0 0 0 0 0 0 0 0 0 0 0 0 0 0 0 0 0 
        0 0 0 0 0 0 0 0 0 0 0 0 0 0 0 0 0 0 0 0 0 0 0 0 0 
        0 0 0 0 0 0 0 0 0 0 0 0 0 0 0 0 0 0 0 0 0 0 0 0 0 
        0 0 0 0 0 0 0 0 0 0 0 0 0 0 0 0 0 0 0 0 0 0 0 0 0 
        0 0 0 0 0 0 0 0 0 0 0 0 0 0 0 0 0 0 0 0 0 0 0 0 0 
        0 0 0 0 0 0 0 0 0 0 0 0 0 0 0 0 0 0 0 0 0 0 0 0 0 
        0 0 0 0 0 0 0 0 0 0 0 0 0 0 0 0 0 0 0 0 0 0 0 0 0 
        0 0 0 0 0 0 0 0 0 0 0 0 0 0 0 0 0 0 0 0 0 0 0 0 0 
        0 0 0 0 0 0 0 0 0 0 0 0 0 0 0 0 0 0 0 0 0 0 0 0 0 
        0 0 0 0 0 0 0 0 0 0 0 0 0 0 0 0 0 0 0 0 0 0 0 0 0 
        0 0 0 0 0 0 0 0 0 0 0 0 0 0 0 0 0 0 0 0 0 0 0 0 0 
        0 0 0 0 0 0 0 0 0 0 0 0 0 0 0 0 0 0 0 0 0 0 0 0 0 
        0 0 0 0 0 0 0 0 0 0 0 0 0 0 0 0 0 0 0 0 0 0 0 0 0 
        0 0 0 0 0 0 0 0 0 0 0 0 0 0 0 0 0 0 0 0 0 0 0 0 0 
        0 0 0 0 0 0 0 0 0 0 0 0 0 0 0 0 0 0 0 0 0 0 0 0 0 
        0 0 0 0 0 0 0 0 0 0 0 0 0 0 0 0 0 0 0 0 0 0 0 0 0 
        0 0 0 0 0 0 0 0 0 0 0 0 0 0 0 0 0 0 0 0 0 0 0 0 0 
        0 0 0 0 0 0 0 0 0 0 0 0 0 0 0 0 0 0 0 0 0 0 0 0 0 
        0 0 0 0 0 0 0 0 0 0 0 0 0 0 0 0 0 0 0 0 0 0 0 0 0 
        0 0 0 0 0 0 0 0 0 0 0 0 0 0 0 0 0 0 0 0 0 0 0 0 0 
        0 0 0 0 0 0 0 0 0 0 0 0 0 0 0 0 0 0 0 0 0 0 0 0 0 
        0 0 0 0 0 0 0 0 0 0 0 0 0 0 0 0 0 0 0 0 0 0 0 0 0 
        0 0 0 0 0 0 0 0 0 0 0 0 0 0 0 0 0 0 0 0 0 0 0 0 0 
        0 0 0 0 0 0 0 0 0 0 0 0 0 0 0 0 0 0 0 0 0 0 0 0 0 
        0 0 0 0 0 0 0 0 0 0 0 0 0 0 0 0 0 0 0 0 0 0 0 0 0 
        ))
    (camera
      (mode "normal")
    )

       (spawnpoint (name "main") (x 736) (y 640))
       (hatch
         (x 736) (y 512)         (sector "main")
         (spawnpoint "main")
       )
       (spidermite (x 201) (y 221))
       (spidermite (x 338) (y 334))
       (spidermite (x 86) (y 356))
      (infoblock (x 736) (y 192)
        (message (_ "!images/objects/voicemail/voicemail.png
#Hey Tux,
#Some friends have 
#left you voicemail 
#messages with advice
#to find Penny. So 
#don't forget to check
#your voicemail and 
#good luck!
#The SuperTux Team"))

      )
       (poisonivy (x 112) (y 611))
        (secretarea (x 460.5625)
                    (y 209.5625)
                    (width 224.9375)
                    (height 89.0)
                    (message "Use the payphone to check your voicemail Tux."))
        (secretarea (x 365.3125)
                    (y 472.4375)
                    (width 229.625)
                    (height 90.5625)
                    (message "Nolok's vault doors can be used as transporters. Use them to explore his hidden areas."))
   )
 )

;; EOF ;;
