(supertux-level
  (version 2)
  (name "Sector Test")
  (author "Matthias Braun")
  (time 500)
  (sector
    (name "main")
    (gravity 10)
    (camera
      (mode "normal")
    )
    (playerspawn
      (name "main")
      (x 100)
      (y 170)
    )
    (tilemap
      (layer "interactive")
      (solid #t)
      (speed 1.)
      (width 50)
      (height 15)
      (tiles
   0  0  0  0  0  0  0  0  0  0  0  0  0  0  0  0  0  0  0  0  0  0  0  0  0  0  0  0  0  0  0  0  0  0  0  0  0  0  0  0  0  0  0  0  0  0  0  0  0  0  
   0  0  0  0  0  0  0  0  0  0  0  0  0  0  0  0  0  0  0  0  0  0  0  0  0  0  0  0  0  0  0  0  0  0  0  0  0  0  0  0  0  0  0  0  0  0  0  0  0  0  
   0  0  0  0  0  0  0  0  0  0  0  0  0  0  0  0  0  0  0  0  0  0  0  0  0  0  0  0  0  0  0  0  0  0  0  0  0  0  0  0  0  0  0  0  0  0  0  0  0  0  
   0  0  0  0  0  0  0  0  0  0  0  0  0  0  0  0  0  0  0  0  0  0  0  0  0  0  0  0  0  0  0  0  0  0  0  0  0  0  0  0  0  0  0  0  0  0  0  0  0  0  
   0  0  0  0  0  0  48 0  0  0  0  0  0  0  48 0  0  0  0  0  0  0  0  0  0  0  0  0  0  0  0  0  0  0  0  0  0  0  0  0  0  0  0  0  0  0  0  0  0  0  
   0  0  0  0  0  0  27 28 28 28 28 28 28 28 29 0  0  0  0  0  0  0  0  0  0  0  0  0  0  0  0  0  0  0  0  0  0  0  0  0  0  0  0  0  0  0  0  0  0  0  
   0  0  0  0  0  0  0  0  0  0  0  0  0  0  0  0  0  0  0  0  0  0  0  0  0  0  0  0  0  0  0  0  0  0  0  0  0  0  0  0  0  0  0  0  0  0  0  0  0  0  
   0  0  0  0  0  0  0  0  0  0  0  0  0  0  0  0  0  0  0  0  0  0  0  0  0  0  0  0  48 0  0  48 0  0  48 0  0  0  0  0  0  48 0  0  0  0  0  0  0  0  
   0  0  0  0  0  0  0  0  0  0  0  0  0  0  0  0  0  0  0  0  0  0  0  0  0  0  0  0  0  0  0  0  0  0  48 48 48 48 48 48 48 48 0  0  0  0  0  0  0  0  
   0  0  0  0  0  0  0  0  0  0  0  0  0  0  0  0  0  0  0  0  0  0  0  0  0  0  0  0  0  0  0  0  0  0  0  0  0  0  0  0  0  0  0  0  0  0  0  0  0  0  
   0  0  0  0  0  0  48 0  0  0  0  0  0  0  48 0  0  0  48 0  0  0  0  0  0  48 0  0  0  0  0  0  0  0  0  0  0  0  0  0  0  0  0  0  0  0  0  0  0  0  
   7  8  8  8  8  8  48 0  0  0  0  7  8  8  48 76 76 76 48 8  8  8  8  8  8  48 8  8  8  8  8  8  8  8  8  8  8  8  8  8  8  8  8  8  8  8  8  8  8  8  
   28 28 28 28 28 28 28 28 28 28 28 28 28 28 48 75 75 75 48 14 14 14 14 14 14 14 14 14 14 14 14 14 14 14 14 14 14 14 14 14 14 14 14 14 14 14 14 14 14 14 
   10 11 11 11 11 11 11 11 11 11 11 11 11 11 48 48 48 48 48 11 11 11 11 11 11 11 11 11 11 11 11 11 11 11 11 11 11 11 11 11 11 11 11 11 11 11 11 11 11 11 
   10 11 11 11 11 11 11 11 11 11 11 11 11 11 11 11 11 11 11 11 11 11 11 11 11 11 11 11 11 11 11 11 11 11 11 11 11 11 11 11 11 11 11 11 11 11 11 11 11 11 
      )
    )
    (background
      (image "arctis.jpg")
      (speed 0.5)
    )
    (fish  (x 509) (y 181))
    (flyingsnowball  (x 941) (y 222))
    (spiky  (x 656) (y 306))
    (snowball  (x 259) (y 303))
    (stalactite  (x 1159) (y 288))
    (stalactite  (x 1235) (y 288))
    (laptop  (x 1198) (y 186))
    (mriceblock  (x 323) (y 74))
  )
)
