;; Generated by Flexlay Editor
(supertux-level
  (version 2)
  (name   (_ "Enemy Stacking Test"))
  (author "Marek Moeckel")
  (sector
    (name  "main")
    (gravity 10.000000)
    (tilemap
      (z-pos 0)
      (solid #t)
      (speed  1.000000)
      (width  28)
      (height 28)
      (tiles
        61 61 61 61 61 61 61 61 61 61 61 61 61 61 61 61 61 61 61 61 61 61 61 61 61 61 61 61 
        61 0 0 0 0 0 0 0 0 0 0 0 0 0 0 0 0 0 0 0 0 0 0 0 0 0 0 61 
        61 0 0 0 0 0 0 0 0 0 0 0 0 0 0 0 0 0 0 0 0 0 0 0 0 0 0 61 
        61 0 0 0 0 0 0 0 0 0 0 0 0 0 0 0 0 0 0 0 0 0 0 0 0 0 0 61 
        61 0 0 0 0 0 0 0 0 0 0 0 0 0 0 0 0 0 0 0 0 0 0 0 0 0 0 61 
        61 0 0 0 0 0 0 0 0 0 0 0 0 0 0 0 0 0 0 0 0 0 0 0 0 0 0 61 
        61 0 0 0 0 0 0 0 0 0 0 0 0 0 0 0 0 0 0 0 0 0 0 0 0 0 0 61 
        61 0 0 0 0 0 0 0 0 0 0 0 0 0 0 0 0 0 0 0 0 0 0 0 0 0 0 61 
        61 0 0 0 0 0 0 0 0 0 0 0 0 0 0 0 0 0 0 0 0 0 0 0 0 0 0 61 
        61 0 0 0 0 0 0 0 0 0 0 0 0 0 0 0 0 0 0 0 0 0 0 0 0 0 0 61 
        61 0 0 0 0 0 0 0 0 0 0 0 0 0 0 0 0 0 0 0 0 0 0 0 0 0 0 61 
        61 0 0 0 0 0 0 0 0 0 0 0 0 0 0 0 0 0 0 0 0 0 0 0 0 0 0 61 
        61 0 0 0 0 0 0 0 0 0 0 0 0 0 0 0 0 0 0 0 0 0 0 0 0 0 0 61 
        61 0 0 0 0 0 0 0 0 0 0 0 0 0 0 0 0 0 0 0 0 0 0 0 0 0 0 61 
        61 0 0 0 0 0 0 0 0 0 0 0 0 0 0 0 0 0 0 0 0 0 0 0 0 0 0 61 
        61 0 0 0 0 0 0 0 0 0 0 0 0 0 0 0 0 0 0 0 0 0 0 0 0 0 0 61 
        61 0 0 0 0 0 0 0 0 0 0 0 0 0 0 0 0 0 0 0 0 0 0 0 0 0 0 61 
        61 0 0 0 0 0 0 0 0 0 0 0 0 0 0 0 0 0 0 0 0 0 0 0 0 0 0 61 
        61 0 0 0 0 0 0 0 0 0 0 0 0 0 0 0 0 0 0 0 0 0 0 0 0 0 0 61 
        61 0 0 0 0 0 0 0 0 0 0 0 0 0 0 0 0 0 0 0 0 0 0 0 0 0 0 61 
        61 0 0 0 0 0 0 0 0 0 0 0 0 0 0 0 0 0 0 0 0 0 0 0 0 0 0 61 
        61 0 0   0 0 0 0 0 0 0 0 0 0 0 0 0 0 0 0 0 0 0 0 0 0 0 0 61 
        61 0 0   0 0 0 48 0 0 0 48 0 0 0 0 0 0 0 0 0 0 0 0 0 0 0 0 61 
        61 0 0   0 0 0 48 0 0 0 48 0 0 0 0 0 0 0 0 0 0 0 0 0 0 0 0 61 
        61 61 61 0 0 0 48 0 0 0 48 0 0 0 0 0 0 0 0 0 0 0 0 0 0 0 0 61 
        61 0 0   0 0 0 48 0 0 0 48 0 0 0 0 0 0 0 0 0 0 0 0 0 0 0 0 61 
        61 0 0   0 0 0 48 0 0 0 48 0 0 0 0 0 0 0 0 0 0 0 0 0 0 0 0 61 
        61 61 61 61 61 61 61 61 61 61 61 61 61 61 61 61 61 61 61 61 61 61 61 61 61 61 61 61 
        ))
    (camera
      (mode "normal")
    )

       (background
         (image "images/background/arctis.jpg")
         (speed 0.500000)
       )
    (switch
      (script "killer.goto_node(1);killer.goto_node(0)")
      (x 32)
      (y 704)
      (sprite "images/objects/switch/right.sprite")
    )
      (powerup (x 96) (y 704)
        (sprite (_ "images/powerups/egg/egg.sprite"))
      )
       (spawnpoint (name "main") (x 32) (y 704))
    (dispenser
      (cycle 1)
      (direction "right")
      (x 224)
      (y 704)
      (random #t)
      (type "dropper")
      (badguy 
"snowball" "smartball" "captainsnowball" "mrbomb" "bouncingsnowball" "spiky"
"crystallo" "toad" "skullyhop" "mrtree" ; "snail"  "mriceblock" "jumpy"
      )
    )
    (tilemap
      (name "killer")
      (z-pos 2)
      (solid #t)
      (path
        (mode "circular")
        (node
          (x 192)
          (y 784)
          (time 1)
        )
        (node
          (x 256)
          (y 784)
          (time 1)
        )
      )
      (width 1)
      (height 3)
      (tiles
        296 296 296
      )
    )
   )
 )

;; EOF ;;
