(supertux-level
  (version 3)
  (name (_ "Test swim speed"))
  (author "zwatotem")
  (contact "zwatotem@gmail.com")
  (license "CC-BY-SA 4.0 International")
  (target-time 1)
  (icon "")
  (icon-locked "")
  (sector
    (name "main")
    (ambient-light
      (color 1 1 1)
    )
    (camera
      (name "Camera")
      (mode "normal")
    )
    (leveltime
      (time 5)
    )
    (music
    )
    (scripttrigger
      (width 32)
      (height 32)
      (script "backcheck <- 1;
      frontcheck <- 0;
wait(0.11);
frontcheck <- 1;
wait(0.05)
if(backcheck==1) Tux.kill(true);")
      (button #f)
      (x 192)
      (y 96)
    )
    (scripttrigger
      (width 32)
      (height 32)
      (script "backcheck <- 2;
      if(frontcheck==2-2) Tux.kill(true);
wait(0.11);
frontcheck <- 2;
wait(0.05)
if(backcheck==2) Tux.kill(true);")
      (button #f)
      (x 224)
      (y 96)
    )
    (scripttrigger
      (width 32)
      (height 32)
      (script "backcheck <- 3;
      if(frontcheck==3-2) Tux.kill(true);
wait(0.11);
frontcheck <- 3;
wait(0.05)
if(backcheck==3) Tux.kill(true);")
      (button #f)
      (x 256)
      (y 96)
    )
    (scripttrigger
      (width 32)
      (height 32)
      (script "backcheck <- 4;
      if(frontcheck==4-2) Tux.kill(true);
wait(0.11);
frontcheck <- 4;
wait(0.05)
if(backcheck==4) Tux.kill(true);")
      (button #f)
      (x 288)
      (y 96)
    )
    (scripttrigger
      (width 32)
      (height 32)
      (script "backcheck <- 5;
      if(frontcheck==5-2) Tux.kill(true);
wait(0.11);
frontcheck <- 5;
wait(0.05)
if(backcheck==5) Tux.kill(true);")
      (button #f)
      (x 320)
      (y 96)
    )
    (scripttrigger
      (width 32)
      (height 32)
      (script "backcheck <- 6;
      if(frontcheck==6-2) Tux.kill(true);
wait(0.11);
frontcheck <- 6;
wait(0.05)
if(backcheck==6) Tux.kill(true);")
      (button #f)
      (x 352)
      (y 96)
    )
    (scripttrigger
      (width 32)
      (height 32)
      (script "backcheck <- 7;
      if(frontcheck==7-2) Tux.kill(true);
wait(0.11);
frontcheck <- 7;
wait(0.05)
if(backcheck==7) Tux.kill(true);")
      (button #f)
      (x 384)
      (y 96)
    )
    (scripttrigger
      (width 32)
      (height 32)
      (script "backcheck <- 8;
      if(frontcheck==8-2) Tux.kill(true);
wait(0.11);
frontcheck <- 8;
wait(0.05)
if(backcheck==8) Tux.kill(true);")
      (button #f)
      (x 416)
      (y 96)
    )
    (scripttrigger
      (width 32)
      (height 32)
      (script "backcheck <- 9;
      if(frontcheck==9-2) Tux.kill(true);
wait(0.11);
frontcheck <- 9;
wait(0.05)
if(backcheck==9) Tux.kill(true);")
      (button #f)
      (x 448)
      (y 96)
    )
    (scripttrigger
      (width 32)
      (height 32)
      (script "backcheck <- 10;
      if(frontcheck==10-2) Tux.kill(true);
wait(0.11);
frontcheck <- 10;
wait(0.05)
if(backcheck==10) Tux.kill(true);")
      (button #f)
      (x 480)
      (y 96)
    )
    (scripttrigger
      (width 32)
      (height 32)
      (script "backcheck <- 11;
      if(frontcheck==11-2) Tux.kill(true);
wait(0.11);
frontcheck <- 11;
wait(0.05)
if(backcheck==11) Tux.kill(true);")
      (button #f)
      (x 512)
      (y 96)
    )
    (scripttrigger
      (width 32)
      (height 32)
      (script "backcheck <- 12;
      if(frontcheck==12-2) Tux.kill(true);
wait(0.11);
frontcheck <- 12;
wait(0.05)
if(backcheck==12) Tux.kill(true);")
      (button #f)
      (x 544)
      (y 96)
    )
    (spawnpoint
      (name "main")
      (x 64)
      (y 64)
    )
    (tilemap
      (solid #t)
      (z-pos 0)
      (width 30)
      (height 10)
      (tiles
      227 227 227 227 227 227 227 227 227 227 227 227 227 227 227 227 227 227 227 227 227 227 227 227 227 227 227 227 227 227
      227 227 227 227 227 227 227 227 227 227 227 227 227 227 227 227 227 227 227 227 227 227 227 227 227 227 227 227 227 227
      227 227 227 227 227 227 227 227 227 227 227 227 227 227 227 227 227 227 227 227 227 227 227 227 227 227 227 227 227 227
      227 227 2020 2020 2020 2020 2020 2020 2020 2020 2020 2020 2020 2020 2020 2020 2020 2020 132 227 227 227 227 227 227 227 227 227 227 227
      227 227 227 227 227 227 227 227 227 227 227 227 227 227 227 227 227 227 227 227 227 227 227 227 227 227 227 227 227 227
      227 227 227 227 227 227 227 227 227 227 227 227 227 227 227 227 227 227 227 227 227 227 227 227 227 227 227 227 227 227
      227 227 227 227 227 227 227 227 227 227 227 227 227 227 227 227 227 227 227 227 227 227 227 227 227 227 227 227 227 227
      227 227 227 227 227 227 227 227 227 227 227 227 227 227 227 227 227 227 227 227 227 227 227 227 227 227 227 227 227 227
      227 227 227 227 227 227 227 227 227 227 227 227 227 227 227 227 227 227 227 227 227 227 227 227 227 227 227 227 227 227
      227 227 227 227 227 227 227 227 227 227 227 227 227 227 227 227 227 227 227 227 227 227 227 227 227 227 227 227 227 227
      )
    )
  )
)
