(supertux-level
  (version 3)
  (name (_ "Test falling speed"))
  (author "SuperTux Player")
  (license "CC-BY-SA 4.0 International")
  (icon "")
  (icon-locked "")
  (sector
    (name "main")
    (ambient-light
      (color 1 1 1)
    )
    (camera
      (name "Camera")
      (mode "normal")
    )
    (leveltime
      (time 1.37)
    )
    (music
    )
    (spawnpoint
      (name "main")
      (x 64)
      (y 96)
    )
    (tilemap
      (solid #t)
      (z-pos 0)
      (width 5)
      (height 200)
      (tiles
      227 227 227 227 227
      227 227 227 227 227
      227 227 227 227 227
      227 227 0 227 227
      227 227 0 227 227
      227 227 0 227 227
      227 227 0 227 227
      227 227 0 227 227
      227 227 0 227 227
      227 227 0 227 227
      227 227 0 227 227
      227 227 0 227 227
      227 227 0 227 227
      227 227 0 227 227
      227 227 0 227 227
      227 227 0 227 227
      227 227 0 227 227
      227 227 0 227 227
      227 227 0 227 227
      227 227 0 227 227
      227 227 0 227 227
      227 227 0 227 227
      227 227 0 227 227
      227 227 0 227 227
      227 227 0 227 227
      227 227 0 227 227
      227 227 0 227 227
      227 227 0 227 227
      227 227 0 227 227
      227 227 0 227 227
      227 227 0 227 227
      227 227 0 227 227
      227 227 0 227 227
      227 227 0 227 227
      227 227 0 227 227
      227 227 0 227 227
      227 227 0 227 227
      227 227 0 227 227
      227 227 0 227 227
      227 227 0 227 227
      227 227 0 227 227
      227 227 0 227 227
      227 227 0 227 227
      227 227 0 227 227
      227 227 0 227 227
      227 227 0 227 227
      227 227 0 227 227
      227 227 0 227 227
      227 227 0 227 227
      227 227 0 227 227
      227 227 0 227 227
      227 227 0 227 227
      227 227 0 227 227
      227 227 0 227 227
      227 227 0 227 227
      227 227 0 227 227
      227 227 0 227 227
      227 227 0 227 227
      227 227 0 227 227
      227 227 0 227 227
      227 227 0 227 227
      227 227 0 227 227
      227 227 0 227 227
      227 227 0 227 227
      227 227 0 227 227
      227 227 0 227 227
      227 227 0 227 227
      227 227 0 227 227
      227 227 0 227 227
      227 227 0 227 227
      227 227 0 227 227
      227 227 0 227 227
      227 227 0 227 227
      227 227 0 227 227
      227 227 0 227 227
      227 227 0 227 227
      227 227 0 227 227
      227 227 0 227 227
      227 227 0 227 227
      227 227 0 227 227
      227 227 0 227 227
      227 227 0 227 227
      227 227 0 227 227
      227 227 0 227 227
      227 227 0 227 227
      227 227 0 227 227
      227 227 0 227 227
      227 227 0 227 227
      227 227 0 227 227
      227 227 0 227 227
      227 227 0 227 227
      227 227 0 227 227
      227 227 0 227 227
      227 227 0 227 227
      227 227 0 227 227
      227 227 0 227 227
      227 227 0 227 227
      227 227 0 227 227
      227 227 0 227 227
      227 227 0 227 227
      227 227 0 227 227
      227 227 0 227 227
      227 227 0 227 227
      227 227 0 227 227
      227 227 0 227 227
      227 227 0 227 227
      227 227 0 227 227
      227 227 0 227 227
      227 227 0 227 227
      227 227 0 227 227
      227 227 0 227 227
      227 227 0 227 227
      227 227 0 227 227
      227 227 0 227 227
      227 227 0 227 227
      227 227 0 227 227
      227 227 0 227 227
      227 227 0 227 227
      227 227 0 227 227
      227 227 0 227 227
      227 227 0 227 227
      227 227 0 227 227
      227 227 0 227 227
      227 227 0 227 227
      227 227 0 227 227
      227 227 0 227 227
      227 227 0 227 227
      227 227 0 227 227
      227 227 0 227 227
      227 227 0 227 227
      227 227 0 227 227
      227 227 0 227 227
      227 227 0 227 227
      227 227 0 227 227
      227 227 0 227 227
      227 227 0 227 227
      227 227 0 227 227
      227 227 0 227 227
      227 227 0 227 227
      227 227 0 227 227
      227 227 0 227 227
      227 227 0 227 227
      227 227 0 227 227
      227 227 0 227 227
      227 227 0 227 227
      227 227 0 227 227
      227 227 0 227 227
      227 227 0 227 227
      227 227 0 227 227
      227 227 0 227 227
      227 227 0 227 227
      227 227 0 227 227
      227 227 0 227 227
      227 227 0 227 227
      227 227 0 227 227
      227 227 0 227 227
      227 227 0 227 227
      227 227 0 227 227
      227 227 0 227 227
      227 227 0 227 227
      227 227 0 227 227
      227 227 0 227 227
      227 227 0 227 227
      227 227 0 227 227
      227 227 0 227 227
      227 227 0 227 227
      227 227 0 227 227
      227 227 0 227 227
      227 227 0 227 227
      227 227 0 227 227
      227 227 0 227 227
      227 227 0 227 227
      227 227 0 227 227
      227 227 0 227 227
      227 227 0 227 227
      227 227 0 227 227
      227 227 0 227 227
      227 227 0 227 227
      227 227 0 227 227
      227 227 0 227 227
      227 227 0 227 227
      227 227 0 227 227
      227 227 0 227 227
      227 227 0 227 227
      227 227 0 227 227
      227 227 0 227 227
      227 227 0 227 227
      227 227 0 227 227
      227 227 0 227 227
      227 227 0 227 227
      227 227 0 227 227
      227 227 0 227 227
      227 227 0 227 227
      227 227 0 227 227
      227 227 0 227 227
      227 227 0 227 227
      227 227 0 227 227
      227 227 0 227 227
      227 227 0 227 227
      132 132 132 132 132
      )
    )
  )
)
