(supertux-level
  (version 3)
  (name (_ "Test swim down"))
  (author "zwatotem")
  (contact "zwatotem@gmail.com")
  (license "CC-BY-SA 4.0 International")
  (target-time 1)
  (icon "")
  (icon-locked "")
  (sector
    (name "main")
    (ambient-light
      (color 1 1 1)
    )
    (camera
      (name "Camera")
      (mode "normal")
    )
    (leveltime
      (time 5)
    )
    (music
    )
    (spawnpoint
      (name "main")
      (x 64)
      (y 32)
    )
    (tilemap
      (solid #t)
      (z-pos 0)
      (width 5)
      (height 5)
      (tiles
      227 227 227 227 227
      227 227 2020 227 227
      227 227 2020 227 227
      227 227 132 227 227
      227 227 227 227 227
      )
    )
  )
)
