(supertux-level
  (version 3)
  (name (_ "Test short jump"))
  (author "zwatotem")
  (contact "zwatotem@gmail.com")
  (license "CC-BY-SA 4.0 International")
  (target-time 1)
  (icon "")
  (icon-locked "")
  (sector
    (name "main")
    (ambient-light
      (color 1 1 1)
    )
    (brick
      (x 195)
      (y 288)
      (breakable #f)
    )
    (camera
      (name "Camera")
      (mode "normal")
    )
    (leveltime
      (time 4.5)
    )
    (music
    )
    (spawnpoint
      (name "main")
      (x 88)
      (y 255)
    )
    (tilemap
      (solid #t)
      (z-pos 0)
      (width 10)
      (height 10)
      (tiles
      227 227 227 227 227 227 227 227 227 227
      227 227 227 227 227 227 227 227 227 227
      227 227 227 227 227 227 227 227 227 227
      227 227 227 227 227 227 227 227 227 227
      227 227 227 227 227 227 227 227 227 227
      227 227 227 227 227 227 227 227 227 227
      227 227 227 0 0 0 227 227 227 227
      227 227 0 0 0 0 0 227 227 227
      227 227 0 0 0 0 0 132 227 227
      227 227 48 227 227 227 0 227 227 227
      )
    )
  )
)
