(supertux-level
  (version 2)
  (name (_ "Tilemap disco test"))
  (author "Hume")
  (contact "Nemám zájem, aby mě někdo otravoval.")
  (license "GPL 2+ / CC-by-sa 3.0")
  (target-time 0)
  (sector
    (name "main")
    (ambient-light 1 1 1)
    (camera
      (mode "normal")
    )
    (spawnpoint
      (name "main")
      (x 288)
      (y 448)
    )
    (switch
      (script "tm.tint_fade(1,1,1,1,1)")
      (sprite "images/objects/switch/switch.sprite")
      (x 195)
      (y 420)
    )
    (switch
      (script "tm.tint_fade(1,0,1,0,1)")
      (sprite "images/objects/switch/switch.sprite")
      (x 387)
      (y 420)
    )
    (switch
      (script "tm.tint_fade(1,1,0,0,1)")
      (sprite "images/objects/switch/switch.sprite")
      (x 451)
      (y 420)
    )
    (switch
      (script "tm.tint_fade(1,0,0,1,1)")
      (sprite "images/objects/switch/switch.sprite")
      (x 515)
      (y 420)
    )
    (switch
      (script "tm.tint_fade(1,0,0.7,1,1)")
      (sprite "images/objects/switch/switch.sprite")
      (x 579)
      (y 420)
    )
    (switch
      (script "tm.tint_fade(1,1,0.7,0,1)")
      (sprite "images/objects/switch/switch.sprite")
      (x 643)
      (y 420)
    )
    (switch
      (script "tm.tint_fade(2,1,1,1,0)")
      (sprite "images/objects/switch/switch.sprite")
      (x 707)
      (y 420)
    )
    (switch
      (script "tm.tint_fade(2,0,0.7,0,0.5)")
      (sprite "images/objects/switch/switch.sprite")
      (x 771)
      (y 420)
    )
    (tilemap
      (solid #t)
      (z-pos 0)
      (name "tm")
      (width 50)
      (height 35)
      (tiles
      0 0 0 0 0 0 0 0 0 0 0 0 0 0 0 0 0 0 0 0 0 0 0 0 0 0 0 0 0 0 0 0 0 0 0 0 0 0 0 0 0 0 0 0 0 0 0 0 0 0
      0 0 0 0 1240 1241 1242 0 0 0 0 0 0 0 0 0 0 0 0 0 0 0 0 0 0 0 0 0 0 0 0 0 0 0 0 0 0 0 0 0 0 0 0 0 0 0 0 0 0 0
      0 0 0 1243 1244 1245 1246 0 0 0 0 0 0 0 0 0 0 0 0 0 0 0 0 0 0 0 0 0 0 0 0 0 0 0 0 0 0 0 0 0 0 0 0 0 0 0 0 0 0 0
      0 0 0 1247 1248 1249 1250 0 0 0 0 0 0 0 0 0 3023 3024 0 0 0 0 0 402 403 404 405 0 0 0 0 0 0 0 0 0 0 0 0 0 0 0 0 0 0 0 0 0 0 0
      0 0 0 1267 1268 1269 1270 0 0 0 0 0 0 0 0 3023 3009 3010 3024 1762 1763 0 0 406 407 408 409 0 0 0 0 0 0 0 0 0 0 0 0 0 0 0 0 0 0 0 0 0 0 0
      0 0 0 0 1280 1281 0 0 0 0 1479 1480 1481 2149 2150 3027 3013 3014 3028 1764 1765 0 0 418 419 420 421 0 2421 2422 2423 2424 2425 2426 0 0 0 0 0 0 0 0 0 0 0 0 0 0 0 0
      0 0 0 0 1284 1285 0 0 0 0 1486 1487 1488 2151 2152 0 3027 3028 0 1766 1767 0 0 422 423 424 425 0 2435 2436 2437 2438 2439 2440 0 0 0 2384 2385 2386 0 0 0 0 0 0 0 0 0 0
      0 0 0 2091 2092 2093 0 1367 1368 1369 1493 1494 1495 68 65 65 65 69 1355 1768 1769 61 50 49 50 49 50 49 2449 2450 2451 2452 2453 2454 301 302 303 2387 2388 2389 0 0 0 0 0 0 0 0 0 0
      0 0 0 2096 2097 2098 1370 1371 1372 1373 1500 1501 1502 68 64 64 64 69 1356 1770 1771 62 51 52 51 52 51 52 2491 2492 2493 2494 2495 2496 304 305 306 2390 2391 2392 0 0 0 0 0 0 0 0 0 0
      0 0 0 2101 2102 2103 1374 1375 1376 1377 1507 1508 1509 67 66 66 66 69 1411 1772 1773 62 27 28 28 28 28 29 2505 2506 2507 2508 2509 2510 307 308 309 2393 2394 2395 0 0 0 0 0 0 0 0 0 0
      1543 1544 0 0 0 0 0 0 0 0 0 0 0 0 0 0 0 0 0 0 0 0 0 0 0 0 0 0 0 0 0 0 0 0 0 0 0 0 0 0 0 0 0 0 0 0 0 0 0 0
      1547 1548 0 0 0 0 0 0 0 0 0 0 0 0 0 0 0 0 0 0 2655 2653 2656 0 0 0 0 0 0 0 0 0 0 0 0 0 0 0 0 0 0 0 0 0 0 0 0 0 0 0
      1543 1544 0 0 0 0 0 0 0 0 0 0 0 0 0 0 0 0 2655 2647 2648 2649 2650 2647 2656 0 85 86 87 88 0 0 0 0 0 0 0 0 0 0 0 0 0 0 0 0 0 0 0 0
      1547 1548 1542 0 0 0 0 0 0 0 0 0 0 0 0 0 0 0 2659 2651 2652 2653 2654 2651 2660 0 89 90 91 92 0 0 0 0 0 0 0 0 0 0 0 0 0 0 0 0 0 0 0 0
      3185 3186 1546 0 0 0 0 0 0 0 0 0 0 0 0 0 0 0 0 0 2659 2651 2660 0 0 0 0 0 0 0 0 0 0 0 0 0 0 0 0 0 0 0 0 0 0 0 0 0 0 0
      3191 3192 1550 7 8 8 8 8 8 8 8 8 8 8 8 8 8 8 8 8 8 8 8 8 8 8 8 8 8 8 8 8 8 8 8 8 8 8 8 8 8 8 8 8 9 0 0 0 0 0
      3185 3186 0 13 14 14 14 14 14 14 14 14 14 14 14 14 14 14 14 14 14 14 14 14 14 14 14 14 14 14 14 14 14 14 14 14 14 14 14 14 14 14 14 14 15 0 0 0 0 0
      3191 3192 3172 10 11 11 11 11 11 11 11 11 11 11 11 11 11 11 11 11 11 11 11 11 11 11 11 11 11 11 11 11 11 11 11 11 11 11 11 11 11 11 11 11 12 0 0 0 0 0
      3185 3186 3178 16 17 17 17 17 17 17 17 17 17 17 17 17 17 17 17 17 17 17 17 17 17 17 17 17 17 17 17 17 17 17 17 17 17 17 17 17 17 17 17 17 18 0 0 0 2085 2086
      3191 3192 0 0 0 0 0 0 0 0 0 0 0 0 0 0 0 0 0 0 0 0 0 0 0 0 0 0 0 0 0 0 0 0 0 0 0 0 0 0 0 0 0 0 0 0 1612 1613 2087 2088
      0 0 0 1000 1001 1002 1003 0 0 0 0 2005 1351 2010 0 0 0 0 0 0 0 0 0 2067 2068 2068 2069 3068 3069 3070 3071 33 32 34 0 0 0 0 0 0 0 0 0 0 0 0 1614 1615 2089 2090
      0 0 0 1004 1005 1006 1007 1972 1976 1980 1984 2006 1352 2011 1779 1780 1781 1783 2310 2311 337 338 339 2072 2073 2073 2074 3072 3073 3074 3075 35 37 39 122 209 123 0 0 0 0 2166 2167 2168 2169 0 57 58 0 0
      0 0 0 1008 1009 1010 1011 1973 1977 1981 1985 2007 1353 2012 1784 1785 1786 1788 2322 2323 340 341 342 2057 2058 2071 2059 3076 3077 3078 3079 38 36 43 124 210 125 0 0 0 0 2170 2171 2172 2173 0 59 60 0 0
      0 0 0 1012 1013 1014 1015 1974 1978 1982 1986 2008 1354 2013 1789 1790 1791 1793 2334 2335 337 338 339 2057 2058 2058 2059 3080 3081 3082 3083 40 41 42 1345 1346 1344 2155 2164 2157 0 2174 2175 2176 2177 0 1742 1743 0 0
      0 0 0 1016 1017 1018 1019 1975 1979 1983 1987 2009 1821 2014 1794 1795 1796 1798 2346 2347 340 341 342 2062 2063 2063 2064 3084 3085 3086 3087 0 0 0 0 0 0 0 2162 0 0 2170 2171 2172 2173 0 0 0 0 0
      0 0 0 0 0 0 0 0 0 0 0 0 0 0 0 0 0 0 0 0 0 0 0 0 0 0 0 0 0 0 0 0 0 0 0 0 0 0 2162 0 0 2174 2175 2176 2177 0 0 0 0 0
      0 0 0 0 0 0 0 0 0 0 0 0 0 0 0 0 0 0 0 0 0 0 0 0 0 0 0 0 0 0 0 0 0 0 0 0 0 2155 2164 2157 0 2170 2171 2172 2173 0 2203 2204 2205 0
      0 0 0 0 0 0 0 0 0 0 0 0 0 0 0 0 0 0 0 0 0 0 0 0 0 0 0 0 0 0 0 0 0 0 0 0 0 0 2162 0 0 2174 2175 2176 2177 0 2206 2207 2208 0
      0 0 0 0 0 0 0 0 0 0 0 0 0 0 0 0 0 0 0 0 0 0 0 0 0 0 0 0 0 0 0 0 0 0 0 0 0 0 2162 0 0 2170 2171 2172 2173 0 2209 2210 2211 0
      0 0 0 0 0 0 0 0 0 0 0 0 0 0 0 0 0 0 0 0 0 0 0 0 0 0 0 0 0 0 0 0 0 0 0 0 0 0 2162 0 0 2174 2175 2176 2177 0 0 0 0 0
      0 0 0 0 0 0 0 0 0 0 0 0 0 0 0 0 0 0 0 0 0 0 0 0 0 0 0 0 0 0 0 0 0 0 0 0 0 2155 2164 2157 0 2170 2171 2172 2173 0 0 0 0 0
      0 0 0 0 0 0 0 0 0 0 0 0 0 0 0 0 0 0 0 0 0 0 0 0 0 0 0 0 0 0 0 0 0 0 0 0 0 0 2162 0 0 2174 2175 2176 2177 0 0 0 0 0
      2704 2705 2706 2707 2704 2705 2706 2707 2704 2705 2706 2707 2704 2705 2706 2707 2704 2705 2706 2707 2704 2705 2706 2707 2704 2705 2706 2707 3318 0 0 0 0 0 0 0 0 0 2162 0 0 2170 2171 2172 2173 0 0 0 0 0
      2720 2721 2722 2723 2720 2721 2722 2723 2720 2721 2722 2723 2720 2721 2722 2723 2720 2721 2722 2723 2720 2721 2722 2723 2720 2721 2722 2723 3326 3327 3328 0 0 2155 2164 2157 0 0 2162 0 0 2174 2175 2176 2177 0 0 0 0 0
      2736 2737 2738 2739 2736 2737 2738 2739 2736 2737 2738 2739 2736 2737 2738 2739 2736 2737 2738 2739 2736 2737 2738 2739 2736 2737 2738 2739 3337 3338 3339 3340 3318 0 2162 0 0 0 2162 0 0 2170 2171 2172 2173 0 0 0 0 0
      )
    )
  )
)
