(supertux-level
  (version 3)
  (name (_ "Tile Platform Test"))
  (author "Mathnerd314")
  (sector
    (name "main")
    (ambient-light
      (color 1 1 1)
    )
    (background
      (speed 0.5)
      (image "images/background/arctis.jpg")
    )
    (camera
      (name "Camera")
      (mode "normal")
    )
    (music
      (file "music/chipdisko.ogg")
    )
    (path
      (name "f9c6abed-431e-442b-b693-2e3466ba065a")
      (path
        (node
          (x 224)
          (y 192)
          (time 5)
        )
        (node
          (x 224)
          (y 472)
          (time 5)
        )
      )
    )
    (path
      (name "d6fa2d4e-adae-4bad-918e-910b4b833dd8")
      (path
        (node
          (x 86)
          (y 450)
        )
        (node
          (x 200)
          (y 450)
        )
      )
    )
    (path
      (name "428b3bab-4990-4fb7-9215-7838050dc9bd")
      (path
        (node
          (x 200)
          (y 450)
        )
        (node
          (x 86)
          (y 450)
        )
      )
    )
    (spawnpoint
      (name "main")
      (x 100)
      (y 100)
    )
    (tilemap
      (solid #t)
      (z-pos 0)
      (width 27)
      (height 19)
      (tiles
      0 0 0 0 0 0 0 0 0 0 0 0 0 0 0 0 0 0 0 0 0 0 0 0 0 0 0
      0 0 0 0 0 0 0 0 0 0 0 0 0 0 0 0 0 0 0 0 0 0 0 0 0 0 0
      0 0 0 0 0 0 0 0 0 0 0 0 0 0 0 0 0 0 0 0 0 0 0 0 0 0 0
      0 0 0 0 0 0 0 0 0 0 0 0 0 0 0 0 0 0 0 0 0 0 0 0 0 0 0
      0 0 0 0 0 0 0 0 0 0 0 0 0 0 0 0 0 0 0 0 0 0 0 0 0 0 0
      0 0 0 0 0 0 0 0 0 0 0 0 0 0 0 0 0 0 0 0 0 0 0 0 0 0 0
      0 0 0 0 0 0 0 0 0 0 0 0 0 0 0 0 0 0 0 0 0 0 0 0 0 0 0
      0 0 0 0 0 0 0 0 0 0 0 0 0 0 0 0 0 0 0 0 0 0 0 0 0 0 0
      0 0 0 0 0 0 0 0 0 0 0 0 0 0 0 0 0 0 0 0 0 0 0 0 0 0 0
      0 0 0 0 0 0 0 0 0 0 0 0 0 0 0 0 0 0 0 0 0 0 0 0 0 0 0
      0 0 0 0 0 0 0 0 0 0 0 0 0 0 0 0 0 0 0 0 0 0 0 0 0 0 0
      0 0 0 0 0 0 0 0 0 0 0 0 0 0 0 0 0 0 0 0 0 0 0 0 0 0 0
      0 0 0 0 0 0 0 0 0 0 0 0 0 0 0 0 0 0 0 0 0 0 0 0 0 0 0
      0 0 0 0 0 0 0 0 0 0 0 0 0 0 0 0 0 0 0 0 0 0 0 0 0 0 0
      0 0 0 0 0 0 0 0 0 0 0 0 0 0 0 0 0 0 0 0 0 0 0 0 0 0 0
      0 0 0 0 0 0 0 0 0 0 0 0 0 0 0 0 0 0 0 0 0 0 0 0 0 0 0
      7 8 8 8 8 8 8 8 8 8 8 8 8 8 8 8 8 8 8 8 9 0 0 0 0 0 0
      13 14 14 14 14 14 14 14 14 14 14 14 14 14 14 14 14 14 14 14 15 0 0 0 0 0 0
      10 11 11 11 11 11 11 11 11 11 11 11 11 11 11 11 11 11 11 11 12 0 0 0 0 0 0
      )
    )
    (tilemap
      (solid #t)
      (running #t)
      (z-pos 1)
      (name "platform1")
      (path-ref "f9c6abed-431e-442b-b693-2e3466ba065a")
      (width 5)
      (height 4)
      (tiles
      0 0 44 0 0
      7 8 8 8 9
      13 14 14 14 15
      16 17 17 17 18
      )
    )
    (tilemap
      (solid #t)
      (running #t)
      (z-pos 2)
      (name "platform2")
      (path-ref "d6fa2d4e-adae-4bad-918e-910b4b833dd8")
      (width 5)
      (height 1)
      (tiles
      27 28 28 28 29
      )
    )
    (tilemap
      (solid #t)
      (running #t)
      (z-pos 2)
      (name "platform3")
      (path-ref "428b3bab-4990-4fb7-9215-7838050dc9bd")
      (width 5)
      (height 1)
      (tiles
      27 28 28 28 29
      )
    )
  )
)
