(supertux-level
  (version 2)
  (name (_ "Unnamed"))
  (author "ingo")
  (sector
    (name "main")
    (ambient-light 1 1 1)
    (background
      (speed 0.125)
      (image-top "images/background/bluemountain-top.png")
      (image "images/background/bluemountain-middle.png")
      (image-bottom "images/background/bluemountain-bottom.png")
    )
    (camera
      (mode "normal")
    )
    (spawnpoint
      (name "main")
      (x 96)
      (y 96)
    )
    (tilemap
      (z-pos -100)
      (solid #f)
      (name "Background")
      (width 100)
      (height 20)
      (tiles
      0 0 0 0 0 0 0 0 0 0 0 0 0 0 0 0 0 0 0 0 0 0 0 0 0 0 0 0 0 0 0 0 0 0 0 0 0 0 0 0 0 0 0 0 0 0 0 0 0 0 0 0 0 0 0 0 0 0 0 0 0 0 0 0 0 0 0 0 0 0 0 0 0 0 0 0 0 0 0 0 0 0 0 0 0 0 0 0 0 0 0 0 0 0 0 0 0 0 0 0
      0 0 0 0 0 0 0 0 0 0 0 0 0 0 0 0 0 0 0 0 0 0 0 0 0 0 0 0 0 0 0 0 0 0 0 0 0 0 0 0 0 0 0 0 0 0 0 0 0 0 0 0 0 0 0 0 0 0 0 0 0 0 0 0 0 0 0 0 0 0 0 0 0 0 0 0 0 0 0 0 0 0 0 0 0 0 0 0 0 0 0 0 0 0 0 0 0 0 0 0
      0 0 0 0 0 0 0 0 0 0 0 0 0 0 2067 2068 2068 2068 2068 2069 0 0 0 0 0 0 0 0 0 0 0 0 0 0 0 0 0 0 0 0 0 0 0 0 0 0 0 0 0 0 0 0 0 0 0 0 0 0 0 0 0 0 0 0 0 0 0 0 0 0 0 0 0 0 0 0 0 0 0 0 0 0 0 0 0 0 0 0 0 0 0 0 0 0 0 0 0 0 0 0
      0 0 0 0 0 0 0 0 0 0 0 0 0 0 0 0 0 0 0 0 0 0 0 0 0 0 0 0 0 0 0 0 0 0 0 0 0 0 0 0 0 0 0 0 0 0 0 0 0 0 0 0 0 0 0 0 0 0 0 0 0 0 0 0 0 0 0 0 0 0 0 0 0 0 0 0 0 0 0 0 0 0 0 0 0 0 0 0 0 0 0 0 0 0 0 0 0 0 0 0
      0 0 0 0 0 0 0 0 0 0 0 0 0 0 2057 2050 2051 2058 2058 2059 0 0 0 0 0 0 0 0 0 0 0 0 0 0 0 0 0 0 0 0 0 0 0 0 0 0 0 0 0 0 0 0 0 0 0 0 0 0 0 0 0 0 0 0 0 0 0 0 0 0 0 0 0 0 0 0 0 0 0 0 0 0 0 0 0 0 0 0 0 0 0 0 0 0 0 0 0 0 0 0
      0 0 0 0 0 0 0 0 0 2067 2068 2069 0 0 2057 2055 2056 2050 2063 2064 0 0 0 0 0 0 0 0 0 0 0 0 0 0 0 0 0 0 0 0 0 0 0 0 0 0 0 0 0 0 0 0 0 0 0 0 0 0 0 0 2067 2068 2068 2068 2068 2068 2068 2069 0 0 0 0 0 0 0 0 0 0 0 0 0 0 0 0 0 0 0 0 0 0 0 0 0 0 0 0 0 0 0 0
      0 0 0 2067 2068 2069 0 0 0 0 0 0 0 0 2057 2058 2050 2064 0 0 0 0 2067 2068 2068 2068 2068 2069 0 0 0 0 0 0 0 0 0 0 0 0 0 0 0 0 0 0 0 0 0 0 0 0 0 0 0 0 0 0 0 0 0 0 0 0 0 0 0 0 0 0 0 0 0 0 0 0 2052 2054 0 2052 2054 0 0 0 0 0 0 0 0 0 0 0 0 0 0 0 0 0 0 0
      0 0 0 0 0 0 0 0 0 2057 2058 2059 0 2052 2056 2058 2059 0 0 0 0 0 2052 2053 2053 2053 2053 2054 0 0 0 0 0 0 0 0 0 0 0 0 0 0 0 0 0 0 0 0 0 0 0 0 0 0 0 0 0 0 0 0 2062 2063 2051 2061 2060 2061 2061 2059 0 0 0 0 0 0 2052 2053 2056 2055 2053 2056 2055 2053 2053 2054 0 0 0 0 0 0 0 0 0 0 0 0 0 0 0 0
      0 0 2052 2056 2058 2059 0 0 0 2057 2058 2059 0 2057 2058 2058 2055 2054 0 0 0 0 2057 2050 2063 2051 2058 2059 0 0 0 0 0 0 0 0 0 0 0 0 0 0 0 0 0 0 0 0 0 0 0 0 0 0 0 0 0 0 0 0 0 0 2057 2066 2065 2066 2066 2055 2054 0 0 0 0 0 2057 2061 2061 2060 2050 2051 2061 2060 2061 2059 0 0 0 0 0 0 0 0 0 0 0 0 0 0 0 0
      0 0 2057 2058 2058 2055 2054 0 2052 2056 2058 2059 0 2057 2058 2058 2058 2059 0 0 0 0 2057 2059 0 2057 2058 2059 0 0 0 2067 2068 2068 2068 2068 2069 0 0 0 0 0 0 0 0 0 0 0 0 0 0 2067 2068 2068 2068 2068 2069 0 0 0 0 0 2057 2061 2060 2061 2061 2058 2059 0 0 0 0 2052 2056 2050 2063 2063 2064 2062 2063 2051 2066 2059 0 0 0 0 0 0 0 0 0 0 0 0 0 0 0 0
      0 0 0 2062 2063 2064 0 0 0 2062 2063 2064 0 0 2062 2063 2064 2064 0 0 0 2052 2056 2055 2053 2056 2061 2059 0 0 0 0 0 0 0 0 0 0 0 0 0 0 0 0 0 0 0 0 0 0 0 2052 2053 2053 2053 2053 2054 0 0 0 0 2052 2056 2066 2065 2066 2066 2061 2059 0 0 0 0 2057 2058 2059 0 2067 2068 2069 0 2057 2061 2059 0 0 0 0 0 0 0 0 0 0 0 0 0 0 0 0
      0 0 0 0 0 0 0 0 0 0 0 0 0 0 0 0 0 0 0 0 0 2057 2060 2050 2051 2061 2058 2055 2054 0 0 2057 2050 2063 2051 2058 2059 0 0 0 0 0 0 0 0 0 0 0 0 0 0 2057 2060 2061 2060 2061 2059 0 0 0 0 2057 2075 2079 2079 2079 2076 2061 2055 2054 0 0 0 2057 2065 2055 2053 0 0 0 2053 2056 2066 2055 2054 0 0 0 0 0 0 0 0 0 0 0 0 0 0 0
      0 0 0 0 0 0 0 0 0 0 0 0 0 0 0 0 0 0 0 0 2052 2056 2065 2055 2056 2066 2061 2058 2059 0 0 2057 2059 0 2057 2058 2059 0 0 0 0 2067 2068 2068 2068 2068 2069 0 0 0 0 2057 2065 2050 2051 2070 2059 0 0 0 0 2057 0 0 0 0 0 2061 2058 2059 0 0 2052 2056 2060 2061 2060 2061 2061 2061 2060 2061 2060 2058 2059 0 0 0 0 0 0 0 0 0 0 0 0 0 0 0
      0 0 0 0 0 0 0 0 0 0 0 0 0 0 0 0 0 0 0 0 2057 2050 2051 2061 2060 2050 2063 2051 2055 2054 0 2057 2059 0 2057 2058 2059 0 0 0 0 0 0 0 0 0 0 0 0 0 0 2057 2065 2055 2056 2061 2059 0 0 0 0 2057 2066 2065 2061 2060 2066 2065 2066 2059 0 0 2057 2058 2065 2066 2065 2066 2066 2066 2065 2066 2065 2061 2059 0 0 0 0 0 0 0 0 0 0 0 0 0 0 0
      0 0 0 0 0 0 0 0 0 0 0 0 0 0 0 0 0 0 0 0 2057 2055 2056 2066 2065 2059 0 2057 2058 2059 0 2057 2059 0 2057 2058 2059 0 0 0 0 2057 2058 2071 2050 2051 2059 0 0 0 2052 2056 2065 2058 2070 2058 2055 2054 0 0 2052 2056 2061 2050 2063 2051 2061 2060 2061 2055 2054 0 0 0 0 0 0 0 0 0 0 0 0 0 0 0 0 0 0 0 0 0 0 0 0 0 0 0 0 0
      0 0 0 0 0 0 0 0 0 0 0 0 0 0 0 0 0 0 0 0 2057 2065 2060 2050 2051 2055 2053 2056 2061 2059 0 2057 2059 0 2057 2058 2059 0 0 0 0 2057 2058 2058 2055 2056 2059 0 0 0 2057 2058 2060 2071 2058 2058 2058 2059 0 0 2057 2058 2050 2064 0 2062 2051 2065 2066 2058 2059 0 0 0 0 0 0 0 0 0 0 0 0 0 0 0 0 0 0 0 0 0 0 0 0 0 0 0 0 0
      0 0 0 0 0 0 0 0 0 0 0 0 0 0 0 0 0 0 0 2052 2056 2061 2065 2055 2056 2065 2066 2065 2066 2055 2054 2057 2059 0 2057 2058 2059 0 0 0 0 2057 2071 2058 2058 2058 2059 0 0 2052 8 8 2065 2066 2065 2066 2071 2055 8 8 2056 2050 2064 0 0 0 2062 2051 2065 2071 2055 2054 0 0 0 0 0 0 0 0 0 0 0 0 0 0 0 0 0 0 0 0 0 0 0 0 0 0 0 0
      0 0 0 0 0 0 0 0 0 0 0 0 0 0 0 0 0 0 0 0 0 0 0 0 0 0 0 0 0 0 0 0 0 0 0 0 0 0 0 0 0 0 0 0 0 0 0 0 0 0 0 0 0 0 0 0 0 0 0 0 0 0 0 0 0 0 0 0 0 0 0 0 0 0 0 0 0 0 0 0 0 0 0 0 0 0 0 0 0 0 0 0 0 0 0 0 0 0 0 0
      0 0 0 0 0 0 0 0 0 0 0 0 0 0 0 0 0 0 0 0 0 0 0 0 0 0 0 0 0 0 0 0 0 0 0 0 0 0 0 0 0 0 0 0 0 0 0 0 0 0 0 0 0 0 0 0 0 0 0 0 0 0 0 0 0 0 0 0 0 0 0 0 0 0 0 0 0 0 0 0 0 0 0 0 0 0 0 0 0 0 0 0 0 0 0 0 0 0 0 0
      0 0 0 0 0 0 0 0 0 0 0 0 0 0 0 0 0 0 0 0 0 0 0 0 0 0 0 0 0 0 0 0 0 0 0 0 0 0 0 0 0 0 0 0 0 0 0 0 0 0 0 0 0 0 0 0 0 0 0 0 0 0 0 0 0 0 0 0 0 0 0 0 0 0 0 0 0 0 0 0 0 0 0 0 0 0 0 0 0 0 0 0 0 0 0 0 0 0 0 0
      )
    )
    (tilemap
      (z-pos 0)
      (solid #t)
      (name "Interactive")
      (width 100)
      (height 20)
      (tiles
      0 0 0 0 0 0 0 0 0 0 0 0 0 0 0 0 0 0 0 0 0 0 0 0 0 0 0 0 0 0 0 0 0 0 0 0 0 0 0 0 0 0 0 0 0 0 0 0 0 0 0 0 0 0 0 0 0 0 0 0 0 0 0 0 0 0 0 0 0 0 0 0 0 0 0 0 0 0 0 0 0 0 0 0 0 0 0 0 0 0 0 0 0 0 0 0 0 0 0 0
      0 0 0 0 0 0 0 0 0 0 0 0 0 0 0 0 0 0 0 0 0 0 0 0 0 0 0 0 0 0 0 0 0 0 0 0 0 0 0 0 0 0 0 0 0 0 0 0 0 0 0 0 0 0 0 0 0 0 0 0 0 0 0 0 0 0 0 0 0 0 0 0 0 0 0 0 0 0 0 0 0 0 0 0 0 0 0 0 0 0 0 0 0 0 0 0 0 0 0 0
      0 0 0 0 0 0 0 0 0 0 0 0 0 0 0 0 0 0 0 0 0 0 0 0 0 0 0 0 0 0 0 0 0 0 0 0 0 0 0 0 0 0 0 0 0 0 0 0 0 0 0 0 0 0 0 0 0 0 0 0 0 0 0 0 0 0 0 0 0 0 0 0 0 0 0 0 0 0 0 0 0 0 0 0 0 0 0 0 0 0 0 0 0 0 0 0 0 0 0 0
      0 0 0 0 0 0 0 0 0 0 0 0 0 0 2072 2073 2073 2073 2073 2074 0 0 0 0 0 0 0 0 0 0 0 0 0 0 0 0 0 0 0 0 0 0 0 0 0 0 0 0 0 0 0 0 0 0 0 0 0 0 0 0 0 0 0 0 0 0 0 0 0 0 0 0 0 0 0 0 0 0 0 0 0 0 0 0 0 0 0 0 0 0 0 0 0 0 0 0 0 0 0 0
      0 0 0 0 0 0 0 0 0 0 0 0 0 0 0 0 0 0 0 0 0 0 0 0 0 0 0 0 0 0 0 0 0 0 0 0 0 0 0 0 0 0 0 0 0 0 0 0 0 0 0 0 0 0 0 0 0 0 0 0 0 0 0 0 0 0 0 0 0 0 0 0 0 0 0 0 0 0 0 0 0 0 0 0 0 0 0 0 0 0 0 0 0 0 0 0 0 0 0 0
      0 0 0 0 0 0 0 0 0 0 0 0 0 0 0 0 0 0 0 0 0 0 0 0 0 0 0 0 0 0 0 0 0 0 0 0 0 0 0 0 0 0 0 0 0 0 0 0 0 0 0 0 0 0 0 0 0 0 0 0 0 0 0 0 0 0 0 0 0 0 0 0 0 0 0 0 0 0 0 0 0 0 0 0 0 0 0 0 0 0 0 0 0 0 0 0 0 0 0 0
      0 0 0 0 0 0 0 0 0 2072 2073 2074 0 0 0 0 0 0 0 0 0 0 0 0 0 0 0 0 0 0 0 0 0 0 0 0 0 0 0 0 0 0 0 0 0 0 0 0 0 0 0 0 0 0 0 0 0 0 0 0 2072 2073 2073 2073 2073 2073 2073 2074 0 0 0 0 0 0 0 0 0 0 0 0 0 0 0 0 0 0 0 0 0 0 0 0 0 0 0 0 0 0 0 0
      0 0 0 2072 2073 2074 0 0 0 0 0 0 0 0 0 0 0 0 0 0 0 0 2072 2073 2073 2073 2073 2074 0 0 0 0 0 0 0 0 0 0 0 0 0 0 0 0 0 0 0 0 0 0 0 0 0 0 0 0 0 0 0 0 0 0 0 0 0 0 0 0 0 0 0 0 0 0 0 0 0 0 0 0 0 0 0 0 0 0 0 0 0 0 0 0 0 0 0 0 0 0 0 0
      0 0 0 0 0 0 0 0 0 0 0 0 0 0 0 0 0 0 0 0 0 0 0 0 0 0 0 0 0 0 0 0 0 0 0 0 0 0 0 0 0 0 0 0 0 0 0 0 0 0 0 0 0 0 0 0 0 0 0 0 0 0 0 0 0 0 0 0 0 0 0 0 0 0 0 0 0 0 0 0 0 0 0 0 0 0 0 0 0 0 0 0 0 0 0 0 0 0 0 0
      7 8 8 8 8 8 8 8 8 8 8 8 8 8 8 8 8 8 9 0 0 0 0 0 0 0 0 0 0 0 0 0 0 0 0 0 0 0 0 0 0 0 0 0 0 0 0 0 0 0 0 0 0 0 0 0 0 0 0 0 0 0 0 0 0 0 0 0 0 0 0 0 0 0 0 0 0 0 0 0 0 0 0 0 0 0 0 0 0 0 0 0 0 0 0 0 0 0 0 0
      13 14 14 14 14 14 14 14 14 14 14 14 14 14 14 14 14 14 15 0 0 0 0 0 0 0 0 0 0 0 0 2072 2073 2073 2073 2073 2074 0 0 0 0 0 0 0 0 0 0 0 0 0 0 2072 2073 2073 2073 2073 2074 0 0 0 0 0 0 0 0 0 0 0 0 0 0 0 0 0 0 0 0 0 0 0 0 0 0 0 0 0 0 0 0 0 0 0 0 0 0 0 0 0 0 0
      10 11 11 11 11 11 11 11 11 11 11 11 11 11 11 11 11 11 12 0 0 0 0 0 0 0 0 0 0 0 0 0 0 0 0 0 0 0 0 0 0 0 0 0 0 0 0 0 0 0 0 0 0 0 0 0 0 0 0 0 0 0 0 0 0 0 0 0 0 0 0 0 0 0 0 0 0 2077 2073 2078 0 0 0 0 0 0 0 0 0 0 0 0 0 0 0 0 0 0 0 0
      16 17 17 17 17 17 17 17 17 17 31 11 11 11 11 11 11 11 12 0 0 0 0 0 0 0 0 0 0 0 0 0 0 0 0 0 0 0 0 0 0 0 0 0 0 0 0 0 0 0 0 0 0 0 0 0 0 0 0 0 0 0 2077 2073 2073 2073 2078 0 0 0 0 0 0 0 0 0 0 0 0 0 0 0 0 0 0 0 0 0 0 0 0 0 0 0 0 0 0 0 0 0
      0 0 0 0 0 0 0 0 0 0 10 11 11 11 11 11 11 11 12 0 0 0 0 0 0 0 0 0 0 0 0 0 0 0 0 0 0 0 0 0 0 2072 2073 2073 2073 2073 2074 0 0 0 0 0 0 0 0 0 0 0 0 0 0 0 0 0 0 0 0 0 0 0 0 0 7 8 8 8 8 8 8 8 8 8 8 8 8 8 8 8 8 8 8 8 8 8 8 8 8 8 8 8
      0 0 0 0 0 0 0 0 0 0 10 11 11 11 11 11 11 11 12 0 0 0 0 0 0 0 0 0 0 0 0 0 0 0 0 0 0 0 0 0 0 0 0 0 0 0 0 0 0 0 2085 2086 0 0 0 0 0 0 0 0 0 0 0 0 0 0 0 0 0 0 0 0 13 14 14 14 14 14 14 14 14 14 14 14 14 14 14 14 14 14 14 14 14 14 14 14 14 14 14 14
      0 0 0 0 0 0 0 0 0 0 10 11 11 11 11 11 11 11 12 0 0 0 0 0 0 0 0 0 0 0 0 0 0 0 0 0 0 0 0 0 0 0 0 0 0 0 0 0 0 0 2087 2088 0 0 0 0 0 0 2085 2086 0 0 0 0 0 0 0 0 0 0 0 0 10 11 11 11 11 11 11 11 11 11 11 11 11 11 11 11 11 11 11 11 11 11 11 11 11 11 11 11
      0 0 0 0 0 0 0 0 0 0 10 11 11 11 11 11 11 11 21 8 8 8 8 8 8 8 8 8 8 8 8 8 8 8 8 8 8 8 8 8 8 8 8 8 8 8 8 8 8 8 2087 2088 8 8 8 8 8 8 2087 2088 8 8 8 8 8 8 8 8 8 8 8 8 22 11 11 11 11 11 11 11 11 11 11 11 11 11 11 11 11 11 11 11 11 11 11 11 11 11 11 11
      0 0 0 0 0 0 0 0 0 0 16 17 17 17 17 31 11 11 20 14 14 14 14 14 14 14 14 14 14 14 14 14 14 14 14 14 14 14 14 14 14 14 14 14 14 14 14 14 14 14 14 14 14 14 14 14 14 14 14 14 14 14 14 14 14 14 14 14 14 14 14 14 23 11 11 11 11 11 11 11 11 11 11 11 11 11 11 11 11 11 11 11 11 11 11 11 11 11 11 11
      0 0 0 0 0 0 0 0 0 0 0 0 0 0 0 10 11 11 11 11 11 11 11 11 11 11 11 11 11 11 11 11 11 11 11 11 11 11 11 11 11 11 11 11 11 11 11 11 11 11 11 11 11 11 11 11 11 11 11 11 11 11 11 11 11 11 11 11 11 11 11 11 11 11 11 11 11 11 11 11 11 11 11 11 11 11 11 11 11 11 11 11 11 11 11 11 11 11 11 11
      0 0 0 0 0 0 0 0 0 0 0 0 0 0 0 10 11 11 11 11 11 11 11 11 11 11 11 11 11 11 11 11 11 11 11 11 11 11 11 11 11 11 11 11 11 11 11 11 11 11 11 11 11 11 11 11 11 11 11 11 11 11 11 11 11 11 11 11 11 11 11 11 11 11 11 11 11 11 11 11 11 11 11 11 11 11 11 11 11 11 11 11 11 11 11 11 11 11 11 11
      )
    )
    (tilemap
      (z-pos -200)
      (solid #f)
      (name "Paralax1")
      (speed 0.5)
      (path
        (node
          (x 0)
          (y 0)
        )
      )
      (width 100)
      (height 20)
      (tiles
      0 0 0 0 0 0 0 0 0 0 0 0 0 0 0 0 0 0 0 0 0 0 0 0 0 0 0 0 0 0 0 0 0 0 0 0 0 0 0 0 0 0 0 0 0 0 0 0 0 0 0 0 0 0 0 0 0 0 0 0 0 0 0 0 0 0 0 0 0 0 0 0 0 0 0 0 0 0 0 0 0 0 0 0 0 0 0 0 0 0 0 0 0 0 0 0 0 0 0 0
      0 0 0 0 0 0 0 0 0 0 0 0 0 0 0 0 0 0 0 0 0 0 0 0 0 0 0 0 0 0 0 0 0 0 0 0 0 0 0 0 0 0 0 0 0 0 0 0 0 0 0 0 0 0 0 0 0 0 0 0 0 0 0 0 0 0 0 0 0 0 0 0 0 0 0 0 0 0 0 0 0 0 0 0 0 0 0 0 0 0 0 0 0 0 0 0 0 0 0 0
      0 149 160 151 0 0 0 0 0 0 0 0 0 0 0 0 0 0 0 0 0 0 0 0 0 0 0 0 0 0 0 0 0 0 0 0 0 0 0 0 0 0 0 0 0 0 0 0 0 0 0 0 0 0 0 0 0 0 0 0 0 0 0 0 0 0 0 0 0 0 0 0 0 0 0 0 0 0 0 0 0 0 0 0 0 0 0 0 0 0 0 0 0 0 0 0 0 0 0 0
      0 152 153 154 0 0 0 0 0 0 0 0 0 0 0 0 0 0 0 0 0 0 0 0 0 0 0 0 0 0 0 0 0 0 0 0 0 0 0 0 0 0 0 0 0 0 0 0 0 0 0 0 0 0 0 0 0 0 0 0 0 0 0 0 0 0 0 0 0 0 0 0 0 0 0 0 0 0 0 0 0 0 0 0 0 0 0 0 0 0 0 0 0 0 0 0 0 0 0 0
      160 159 153 158 160 151 0 0 0 0 0 0 149 160 151 0 0 0 0 0 0 0 0 0 0 0 0 0 0 0 0 0 0 0 0 0 0 0 0 0 0 0 0 0 0 0 0 0 0 0 0 0 0 0 0 0 0 0 0 0 0 0 0 0 0 0 0 0 0 0 0 0 0 0 0 0 0 0 0 0 0 0 0 0 0 0 0 0 0 0 0 0 0 0 0 0 0 0 0 0
      153 153 153 153 153 154 0 0 0 0 0 0 152 153 154 0 0 0 0 0 0 0 0 0 0 0 0 0 0 0 0 0 0 0 0 0 0 0 0 0 0 0 0 0 0 0 0 0 0 0 0 0 0 0 0 0 0 0 0 0 0 0 0 0 0 0 0 0 0 0 0 0 0 0 0 0 0 0 0 0 0 0 0 0 0 0 0 0 0 0 0 0 0 0 0 0 0 0 0 0
      153 153 153 153 153 154 0 0 0 0 149 160 159 153 158 160 151 0 0 0 0 0 0 0 0 0 0 0 0 0 0 0 0 0 0 0 0 0 0 0 0 0 0 0 0 0 0 0 0 0 0 0 0 0 0 0 0 0 0 0 0 0 0 0 0 0 0 0 0 0 0 0 0 0 0 0 0 0 0 0 0 0 0 0 0 0 0 0 0 0 0 0 0 0 0 0 0 0 0 0
      153 153 153 153 153 154 0 0 0 0 152 153 153 153 153 153 154 0 0 0 0 0 0 0 0 0 0 0 0 0 0 0 0 0 0 0 0 0 0 0 0 0 0 0 0 0 0 0 0 149 160 151 0 0 0 0 0 0 0 0 0 0 0 0 0 0 0 0 0 0 0 0 0 0 0 0 0 0 0 0 0 0 0 0 0 0 0 0 0 0 0 0 0 0 0 0 0 0 0 0
      153 153 153 153 153 154 0 149 160 160 159 153 153 153 153 153 154 0 0 0 0 0 0 0 0 149 160 151 0 0 0 0 0 0 0 0 0 0 0 0 0 0 0 0 0 0 0 0 0 152 153 154 0 0 0 0 0 0 0 0 0 0 0 0 0 0 0 0 0 0 0 0 0 0 0 0 0 0 0 0 0 0 0 0 0 0 0 149 160 151 0 0 0 0 0 0 0 0 149 160
      153 153 153 153 153 154 0 152 153 153 153 153 153 153 153 153 154 0 0 0 0 0 0 0 0 152 153 154 0 0 0 0 0 0 0 0 149 160 151 0 0 0 0 0 0 0 0 149 160 159 153 158 160 151 0 0 0 0 0 0 0 0 0 0 0 0 0 0 0 0 0 0 0 0 0 0 149 160 151 0 0 0 0 0 0 0 0 152 153 154 0 0 0 0 0 0 0 0 152 153
      153 153 153 153 153 154 0 152 153 153 153 153 153 153 153 153 154 0 0 0 0 0 0 149 160 159 153 158 160 151 0 0 0 0 0 0 152 153 154 0 0 0 0 0 0 0 0 152 153 153 153 153 153 154 0 0 0 0 0 0 0 0 0 0 0 0 0 0 0 0 0 0 0 0 0 0 152 153 154 0 0 0 0 0 0 149 160 159 153 158 160 151 0 0 0 0 149 160 159 153
      153 153 153 153 153 154 0 152 153 153 153 153 153 153 153 153 154 0 0 0 0 0 0 152 153 153 153 153 153 154 0 0 0 0 149 160 159 153 158 160 151 0 0 0 149 160 160 159 153 153 153 153 153 154 0 0 0 0 0 0 0 0 0 149 160 151 0 0 0 0 0 0 0 0 149 160 159 153 158 160 151 0 0 0 0 152 153 153 153 153 153 154 0 0 0 0 152 153 153 153
      153 153 153 153 153 154 0 152 153 153 153 153 153 153 153 153 154 0 0 0 149 160 160 159 153 153 153 153 153 154 0 0 0 0 152 153 153 153 153 153 154 0 0 0 152 153 153 153 153 153 153 153 153 154 0 0 0 0 0 0 0 0 0 152 153 154 0 0 0 0 0 0 0 0 152 153 153 153 153 153 154 0 0 0 0 152 153 153 153 153 153 154 0 0 0 0 152 153 153 153
      153 153 153 153 153 154 0 152 153 153 153 153 153 153 153 153 154 0 0 0 152 153 153 153 153 153 153 153 153 154 0 149 160 160 159 153 153 153 153 153 154 0 0 0 152 153 153 153 153 153 153 153 153 154 0 0 0 0 0 0 0 149 160 159 153 158 160 151 0 0 0 0 0 0 152 153 153 153 153 153 154 0 0 0 0 152 153 153 153 153 153 158 160 151 0 0 152 153 153 153
      153 153 153 153 153 154 0 152 153 153 153 153 153 153 153 153 154 0 0 0 152 153 153 153 153 153 153 153 153 154 0 152 153 153 153 153 153 153 153 153 154 0 0 0 152 153 153 153 153 153 153 153 153 154 0 0 0 0 0 0 0 152 153 153 153 153 153 154 0 0 0 0 0 0 152 153 153 153 153 153 158 160 151 0 0 152 153 153 153 153 153 153 153 154 0 0 152 153 153 153
      153 153 153 153 153 154 0 152 153 153 153 153 153 153 153 153 154 0 0 0 152 153 153 153 153 153 153 153 153 154 0 152 153 153 153 153 153 153 153 153 154 0 0 0 152 153 153 153 153 153 153 153 153 154 0 0 0 0 0 0 0 152 153 153 153 153 153 154 0 0 0 0 0 0 152 153 153 153 153 153 153 153 154 0 0 152 153 153 153 153 153 153 153 154 0 0 152 153 153 153
      153 153 153 153 153 154 0 152 153 153 153 153 153 153 153 153 154 0 0 0 152 153 153 153 153 153 153 153 153 154 0 152 153 153 153 153 153 153 153 153 154 0 0 0 152 153 153 153 153 153 153 153 153 154 0 0 0 0 0 0 0 152 153 153 153 153 153 158 160 151 0 0 0 0 152 153 153 153 153 153 153 153 154 0 0 152 153 153 153 153 153 153 153 154 0 0 152 153 153 153
      153 153 153 153 153 154 0 152 153 153 153 153 153 153 153 153 154 0 0 0 152 153 153 153 153 153 153 153 153 154 0 152 153 153 153 153 153 153 153 153 154 0 0 0 152 153 153 153 153 153 153 153 153 154 0 0 0 0 0 0 0 152 153 153 153 153 153 153 153 154 0 0 0 0 152 153 153 153 153 153 153 153 154 0 0 152 153 153 153 153 153 153 153 154 0 0 152 153 153 153
      153 153 153 153 153 154 0 152 153 153 153 153 153 153 153 153 154 0 0 0 152 153 153 153 153 153 153 153 153 154 0 152 153 153 153 153 153 153 153 153 154 0 0 0 152 153 153 153 153 153 153 153 153 154 0 0 0 0 0 0 0 152 153 153 153 153 153 153 153 154 0 0 0 0 152 153 153 153 153 153 153 153 154 0 0 152 153 153 153 153 153 153 153 154 0 0 152 153 153 153
      153 153 153 153 153 154 0 152 153 153 153 153 153 153 153 153 154 0 0 0 152 153 153 153 153 153 153 153 153 154 0 152 153 153 153 153 153 153 153 153 154 0 0 0 152 153 153 153 153 153 153 153 153 154 0 0 0 0 0 0 0 152 153 153 153 153 153 153 153 154 0 0 0 0 152 153 153 153 153 153 153 153 154 0 0 152 153 153 153 153 153 153 153 154 0 0 152 153 153 153
      )
    )
    (tilemap
      (z-pos -300)
      (solid #f)
      (name "Paralax2")
      (speed 0.25)
      (path
        (node
          (x 0)
          (y 0)
        )
      )
      (width 100)
      (height 20)
      (tiles
      0 0 0 0 0 0 0 0 0 0 0 0 0 0 0 0 0 0 0 0 0 0 0 0 0 0 0 0 0 0 0 0 0 0 0 0 0 0 0 0 0 0 0 0 0 0 0 0 0 0 0 0 0 0 0 0 0 0 0 0 0 0 0 0 0 0 0 0 0 0 0 0 0 0 0 0 0 0 0 0 0 0 0 0 0 0 0 0 0 0 0 0 0 0 0 0 0 0 0 0
      0 0 0 0 0 0 0 0 0 0 0 0 0 0 0 0 0 0 0 0 0 0 0 0 0 0 0 0 0 0 0 0 0 0 0 0 0 0 0 0 0 0 0 0 0 0 0 0 0 0 0 0 0 0 0 0 0 0 0 0 0 0 0 0 0 0 0 0 0 0 0 0 0 0 0 0 0 0 0 0 0 0 0 0 0 0 0 0 0 0 0 0 0 0 0 0 0 0 0 0
      0 0 0 0 0 0 0 0 0 0 0 0 0 0 0 0 0 0 0 0 0 0 0 0 0 0 0 0 0 0 0 0 0 0 0 0 0 0 0 0 0 0 0 0 0 0 0 0 0 0 0 0 0 0 0 0 0 0 0 0 0 0 0 0 0 0 0 0 0 0 0 0 0 0 0 0 0 0 0 0 0 0 0 0 0 0 0 0 0 0 0 0 0 0 0 0 0 0 0 0
      0 0 0 0 0 0 0 0 0 0 0 0 0 0 0 0 0 0 0 0 0 0 0 0 0 0 0 0 0 0 0 0 0 0 0 0 0 0 0 0 0 0 0 0 0 0 0 0 0 0 0 0 0 0 0 0 0 0 0 0 0 0 0 0 0 0 0 0 0 0 0 0 0 0 0 0 0 0 0 0 0 0 0 0 0 0 0 0 0 0 0 0 0 0 0 0 0 0 0 0
      0 0 0 0 0 0 0 0 0 0 0 0 0 0 0 0 0 0 0 0 0 0 0 0 0 0 0 0 0 0 0 0 0 0 0 0 0 0 0 0 0 0 0 0 0 0 0 0 0 0 0 0 0 0 0 0 0 0 0 0 0 0 0 0 0 0 0 0 0 0 0 0 0 0 0 0 0 0 0 0 0 0 0 0 0 0 0 0 0 0 0 0 0 0 0 0 0 0 0 0
      0 0 0 0 0 0 0 0 0 0 0 0 0 0 0 0 0 0 0 0 0 0 0 0 0 0 0 0 0 0 0 0 0 0 0 0 0 0 0 0 0 0 0 0 0 0 0 0 0 0 0 0 0 0 0 0 0 0 0 0 0 0 0 0 0 0 0 0 0 0 0 0 0 0 0 0 0 0 0 0 0 0 0 0 0 0 0 0 0 0 0 0 0 0 0 0 0 0 0 0
      0 0 0 0 0 0 0 0 0 0 161 162 163 0 0 0 0 0 0 0 0 0 0 0 0 0 0 0 0 0 0 0 0 0 0 0 0 0 0 0 0 0 0 0 0 0 0 0 0 0 161 162 163 0 0 0 0 0 0 0 0 0 0 0 0 0 0 0 0 0 0 0 0 0 0 0 0 0 0 0 0 0 0 0 0 0 0 0 0 0 0 0 0 0 0 0 0 0 0 0
      0 0 0 0 0 0 0 0 0 0 164 165 166 0 0 0 0 0 0 0 0 0 0 0 0 0 0 0 0 0 0 0 0 0 0 0 0 0 0 0 0 0 0 0 0 0 0 0 0 0 164 165 166 0 0 0 0 0 0 0 0 0 0 0 0 0 0 0 0 0 0 0 0 0 0 0 0 0 0 0 0 0 0 0 0 0 0 0 0 0 0 0 0 0 0 0 0 0 0 0
      0 0 0 0 0 0 0 0 0 0 164 165 166 0 0 0 0 0 0 0 0 0 0 0 0 0 0 0 0 0 0 0 0 0 0 0 0 0 0 0 0 0 0 0 0 0 0 0 0 0 164 165 166 0 0 0 0 0 0 161 162 163 0 0 0 0 0 0 0 0 0 0 0 0 0 0 0 0 0 0 0 0 0 0 0 0 0 0 0 0 0 0 0 0 0 0 0 0 0 0
      0 0 0 0 0 0 0 0 0 0 164 165 170 163 0 0 0 0 0 0 0 0 161 162 163 0 0 0 0 0 0 0 0 161 162 163 0 0 0 0 0 0 0 0 0 0 0 0 0 0 164 165 170 163 0 0 0 0 0 164 165 166 0 0 0 0 0 0 0 0 0 0 0 0 0 0 0 0 0 0 0 0 0 0 0 0 0 0 0 0 0 0 0 0 0 0 0 0 0 0
      0 0 0 0 0 0 0 0 0 0 164 165 165 166 0 0 0 0 0 0 0 0 164 165 166 0 0 0 0 0 0 0 0 164 165 166 0 0 0 0 0 161 162 163 0 0 0 0 0 161 171 165 165 166 0 0 0 0 0 164 165 166 0 0 0 0 0 0 0 0 0 0 0 0 161 162 163 0 0 0 0 0 0 0 0 0 0 0 0 0 0 0 0 0 0 161 162 163 0 0
      0 0 161 162 163 0 0 0 0 0 164 165 165 166 0 0 0 0 0 0 0 0 164 165 166 0 0 0 0 0 0 0 0 164 165 166 0 0 0 0 0 164 165 166 0 0 0 0 0 164 165 165 165 166 0 0 0 0 0 164 165 170 163 0 0 0 0 0 0 0 0 0 0 0 164 165 166 0 0 0 0 0 0 0 0 0 0 0 0 0 0 0 0 0 0 164 165 166 0 0
      0 0 164 165 166 0 0 0 0 0 164 165 165 166 0 0 0 0 0 0 0 0 164 165 170 163 0 0 161 162 163 0 0 164 165 170 163 0 0 0 0 164 165 166 0 0 0 0 0 164 165 165 165 166 0 0 0 0 161 171 165 165 166 0 0 0 0 0 0 0 0 0 0 0 164 165 166 0 0 0 0 0 0 0 0 0 0 0 0 0 0 0 0 0 0 164 165 166 0 0
      0 0 164 165 166 0 0 0 0 0 164 165 165 166 0 0 0 0 0 0 0 161 171 165 165 166 0 0 164 165 166 0 161 171 165 165 166 0 0 0 0 164 165 170 163 0 0 0 0 164 165 165 165 166 0 0 0 0 164 165 165 165 166 0 0 0 0 161 162 162 162 162 162 162 171 165 170 162 162 163 0 0 0 0 0 0 0 0 161 162 162 162 162 162 162 171 165 170 162 162
      0 0 164 165 170 163 0 0 0 0 164 165 165 166 0 0 0 0 0 0 0 164 165 165 165 166 0 0 164 165 166 0 164 165 165 165 166 0 0 0 161 171 165 165 166 0 0 0 0 164 165 165 165 166 0 0 0 0 164 165 165 165 166 0 0 0 0 164 165 165 165 165 165 165 165 165 165 165 165 166 0 0 0 0 0 0 0 0 164 165 165 165 165 165 165 165 165 165 165 165
      0 0 164 165 165 166 0 0 0 0 164 165 165 166 0 0 0 0 0 0 0 164 165 165 165 166 0 0 164 165 170 163 164 165 165 165 166 0 0 0 164 165 165 165 166 0 0 0 0 164 165 165 165 166 0 0 0 0 164 165 165 165 166 0 0 0 0 164 165 165 165 165 165 165 165 165 165 165 165 166 0 0 0 0 0 0 0 0 164 165 165 165 165 165 165 165 165 165 165 165
      0 0 164 165 165 166 0 0 0 0 164 165 165 166 0 0 0 0 0 0 0 164 165 165 165 166 0 161 171 165 165 166 164 165 165 165 166 0 0 0 164 165 165 165 166 0 0 0 0 164 165 165 165 166 0 0 0 0 164 165 165 165 166 0 0 0 0 164 165 165 165 165 165 165 165 165 165 165 165 166 0 0 0 0 0 0 0 0 164 165 165 165 165 165 165 165 165 165 165 165
      0 0 164 165 165 166 0 0 0 0 164 165 165 166 0 0 0 0 0 0 0 164 165 165 165 166 0 164 165 165 165 166 164 165 165 165 166 0 0 0 164 165 165 165 166 0 0 0 0 164 165 165 165 166 0 0 0 0 164 165 165 165 166 0 0 0 0 164 165 165 165 165 165 165 165 165 165 165 165 166 0 0 0 0 0 0 0 0 164 165 165 165 165 165 165 165 165 165 165 165
      0 0 164 165 165 166 0 0 0 0 164 165 165 166 0 0 0 0 0 0 0 164 165 165 165 166 0 164 165 165 165 166 164 165 165 165 166 0 0 0 164 165 165 165 166 0 0 0 0 164 165 165 165 166 0 0 0 0 164 165 165 165 166 0 0 0 0 164 165 165 165 165 165 165 165 165 165 165 165 166 0 0 0 0 0 0 0 0 164 165 165 165 165 165 165 165 165 165 165 165
      0 0 164 165 165 166 0 0 0 0 164 165 165 166 0 0 0 0 0 0 0 164 165 165 165 166 0 164 165 165 165 166 164 165 165 165 166 0 0 0 164 165 165 165 166 0 0 0 0 164 165 165 165 166 0 0 0 0 164 165 165 165 166 0 0 0 0 164 165 165 165 165 165 165 165 165 165 165 165 166 0 0 0 0 0 0 0 0 164 165 165 165 165 165 165 165 165 165 165 165
      )
    )
  )
)
