;; Generated by Flexlay Editor
(supertux-level
  (version 1)
  (author "Torfi")
  (name "Still too easy")
  (width  200)
  (height 15)
  (start_pos_x    100)
  (start_pos_y    170)
  (background "arctis2.jpg")
  (music "Mortimers_chipdisko.mod")
  (bkgd_red_top    0)
  (bkgd_green_top  0)
  (bkgd_blue_top   0)
  (bkgd_red_bottom    255)
  (bkgd_green_bottom  255)
  (bkgd_blue_bottom   255)
  (time  300)
  (gravity  10.0)
  (particle_system "")
  (theme "antarctica")
  (interactive-tm
   10 11 11 11 11 11 11 11 11 11 11 11 11 11 11 11 11 11 11 11 11 11 11 11 11 11 11 11 11 11 11 11 11 11 11 11 11 11 11 11 11 11 11 11 11 11 11 11 11 11 11 11 11 11 11 11 11 11 11 11 11 11 11 11 11 11 19 12 0  0  0  0  0  0  0  0  0  0  0  0  0  0  0  0  0  0  0  0  0  0  0  0  0  0  0  0  0  0  0  0  0  0  0  0  0  0  0  0  0  0  0  0  0  0  0  0  0  0  10 11 11 11 11 11 11 11 11 11 11 11 11 11 11 11 11 11 11 11 11 11 11 12 10 11 11 11 11 11 11 11 12 10 11 11 11 11 11 11 11 11 11 11 11 11 11 11 11 11 11 11 11 11 11 11 11 11 11 11 11 11 11 11 11 11 11 11 11 11 11 11 11 11 11 11 11 11 11 12 0  0  
   10 11 19 11 30 17 17 17 17 17 17 17 31 11 11 11 11 30 17 17 31 11 11 11 30 17 17 17 17 31 11 30 17 17 17 17 17 17 17 17 17 17 17 17 31 11 11 30 17 17 17 17 17 17 17 17 17 17 31 11 11 11 11 11 30 17 17 18 0  0  0  0  0  0  0  0  0  0  0  0  0  0  0  0  0  0  0  0  0  0  0  0  0  0  0  0  0  0  0  0  0  0  0  0  0  0  0  0  0  0  0  0  0  0  0  0  0  0  16 17 31 11 11 11 11 11 11 11 11 11 11 30 17 17 31 11 30 17 17 17 17 18 16 0  0  0  0  0  0  0  18 16 17 17 17 17 17 17 31 11 11 11 11 11 30 17 17 17 17 17 17 17 31 11 11 11 11 11 11 11 11 11 11 11 11 11 11 11 11 11 11 11 11 11 11 11 11 12 0  0  
   10 11 11 11 12 0  0  0  0  0  0  0  10 11 11 30 17 18 0  0  16 17 17 31 12 0  0  0  0  16 17 18 0  44 44 0  0  0  0  0  0  0  0  0  16 17 17 18 0  0  0  0  0  0  0  0  0  0  16 31 11 11 11 30 18 0  0  0  0  0  0  0  0  0  0  0  0  0  0  0  0  0  0  0  0  0  0  0  0  0  44 44 0  0  0  0  0  0  0  0  0  0  44 44 44 0  0  0  0  0  0  0  0  0  0  0  0  0  0  0  10 19 11 11 11 11 11 11 11 30 17 18 0  0  16 17 18 0  0  0  0  0  0  0  0  44 0  44 0  0  0  0  0  0  0  0  0  0  16 31 11 30 17 17 18 0  0  0  0  0  0  0  16 17 31 11 11 11 11 11 11 11 11 11 11 11 11 11 11 11 11 11 11 11 11 11 11 12 0  0  
   16 17 17 17 18 0  0  44 0  0  0  0  16 17 17 18 0  0  0  0  0  0  0  16 18 0  0  0  0  0  0  7  8  8  8  8  9  0  0  0  7  8  9  0  0  0  0  0  0  0  0  7  8  8  8  9  0  0  0  16 31 11 30 18 0  0  0  0  0  0  0  7  8  9  0  0  0  0  0  0  0  0  0  0  0  44 44 44 0  0  27 29 0  0  0  0  0  0  0  0  0  0  27 28 29 0  0  0  0  0  0  0  0  0  0  0  0  0  0  0  10 11 11 11 11 30 17 17 17 18 0  0  7  8  9  0  0  0  0  0  0  83 83 10 11 11 11 11 11 12 44 44 44 7  9  0  0  0  0  16 31 12 0  0  44 44 0  0  0  0  0  0  0  0  16 17 17 17 31 11 11 11 11 11 11 11 11 11 11 11 11 11 11 11 11 11 11 12 0  0  
   0  0  0  0  0  0  7  8  9  0  0  0  0  0  7  8  8  8  8  8  9  0  0  0  0  0  0  0  0  0  7  114 14 14 14 14 113 9  0  0  13 14 113 8  8  8  9  0  0  7  9  13 14 14 14 15 0  0  0  0  16 17 18 0  0  0  7  9  0  0  0  13 14 113 9  0  0  0  0  0  0  0  0  0  0  27 28 29 0  0  0  0  0  0  0  0  0  0  0  0  0  0  0  0  0  0  0  0  0  0  0  0  0  0  0  0  0  0  0  0  10 11 11 11 11 12 0  0  0  0  0  0  13 14 15 0  0  0  0  0  0  0  0  16 17 17 17 31 11 12 44 44 44 13 15 0  0  0  0  0  10 12 0  0  7  9  0  0  0  0  0  0  0  0  0  0  0  0  16 31 30 17 17 17 31 11 11 11 11 11 11 11 11 11 11 11 11 12 0  0  
   0  0  0  0  0  0  13 14 15 0  0  0  0  7  114 14 14 14 14 14 15 0  0  0  0  0  0  0  0  0  13 23 11 115 116 11 20 15 0  0  10 11 20 14 14 14 113 8  9  13 15 16 17 31 11 12 0  0  0  44 44 44 7  9  0  0  13 15 0  0  0  16 31 20 15 0  0  0  0  0  0  0  0  0  0  0  0  0  0  0  0  0  0  0  0  0  0  0  0  0  0  0  0  0  0  0  0  0  0  0  0  0  0  0  0  0  7  9  0  103 10 11 11 11 30 18 0  0  0  0  0  7  22 30 18 0  0  0  0  0  0  0  0  0  0  0  0  10 11 12 44 44 44 10 21 9  0  0  0  0  10 12 0  0  13 15 0  0  0  0  0  0  0  0  0  0  0  0  0  16 18 0  0  0  10 11 11 11 11 11 11 11 11 11 11 11 11 12 0  0  
   7  8  8  8  8  9  10 30 18 0  0  7  9  13 23 11 11 11 11 11 21 9  0  0  0  7  9  0  0  0  10 11 11 117 118 11 11 12 0  0  10 11 11 11 19 11 20 14 15 16 18 0  0  16 17 18 0  0  7  8  8  8  114 113 8  8  22 12 0  0  0  0  10 11 12 0  0  0  0  0  0  0  0  0  0  0  0  0  0  0  0  0  0  0  0  0  0  0  0  0  0  0  0  0  0  0  0  0  0  0  0  0  0  0  0  0  13 15 0  0  10 11 30 17 18 0  0  44 44 0  0  13 23 12 0  0  0  0  0  0  0  7  8  8  8  9  0  10 11 21 8  8  8  22 20 15 0  0  0  0  10 12 0  0  10 12 0  0  0  0  0  0  0  0  0  0  0  0  0  0  0  0  0  0  16 133 17 17 17 17 17 11 11 11 11 11 11 12 0  0  
   13 14 14 14 14 15 16 18 0  0  0  13 15 16 17 17 17 17 31 11 20 15 0  0  7  114 113 9  0  0  16 31 11 11 11 11 30 18 0  0  16 17 17 31 11 11 11 11 12 0  0  7  9  0  0  0  0  0  13 14 14 14 23 20 14 14 23 12 0  0  0  0  10 30 18 0  0  0  0  0  0  0  0  0  0  0  0  0  0  0  0  0  0  0  0  0  0  0  0  0  0  0  0  0  0  0  0  0  0  0  0  0  0  0  0  0  10 21 8  8  22 11 12 0  0  7  8  8  8  8  8  22 11 21 9  0  0  0  0  0  0  13 14 14 14 15 0  10 11 20 14 14 14 23 30 18 0  0  0  0  16 18 0  0  16 18 0  0  0  0  0  0  0  7  9  0  0  0  0  0  0  0  0  0  0  133 0  0  0  0  0  0  0  0  132 132 11 12 0  0  
   10 11 11 11 30 18 0  0  0  0  0  16 18 0  0  0  0  0  10 11 11 12 0  0  13 23 20 15 0  0  0  16 17 17 17 17 18 0  7  9  0  0  0  10 11 11 11 30 18 0  0  13 15 0  0  0  0  0  16 17 17 17 31 11 11 30 17 18 0  0  0  0  16 18 0  0  0  0  0  0  0  0  0  0  0  0  0  0  0  0  0  0  0  0  0  0  0  0  0  0  0  0  0  0  0  0  0  0  0  0  0  0  0  0  0  0  10 20 14 14 23 30 18 0  0  13 14 14 14 14 14 23 11 20 15 0  0  0  0  0  0  16 31 11 30 18 0  10 11 11 11 11 11 11 12 0  0  0  0  0  0  0  0  0  0  0  0  0  0  0  0  0  0  13 15 0  0  0  0  0  0  0  0  7  8  133 8  8  8  8  8  0  0  0  132 132 11 12 0  0  
   10 11 30 17 18 0  0  0  0  0  0  0  0  0  0  0  0  0  16 17 17 18 0  0  10 11 11 12 0  0  0  0  0  0  0  0  0  0  13 15 0  0  0  10 11 30 17 18 0  7  8  22 12 0  0  0  0  0  0  0  0  0  16 17 17 18 0  0  0  0  0  0  0  0  0  0  0  0  0  0  0  0  0  0  0  0  0  0  0  0  0  0  0  0  27 28 28 28 28 29 102 0  0  0  0  0  0  0  0  0  0  0  0  0  0  0  16 31 11 30 17 18 0  0  0  16 31 11 30 17 17 31 11 30 18 0  0  0  0  0  0  0  10 11 12 0  0  10 11 30 17 17 31 11 21 9  0  0  0  7  8  8  8  8  8  9  0  0  0  0  0  0  0  10 12 0  0  0  0  0  0  0  0  13 14 14 14 14 14 14 14 23 11 11 11 11 11 12 0  0  
   10 11 12 102 0  0  0  0  7  9  0  0  0  0  0  0  0  0  0  0  0  7  8  8  22 11 11 12 0  0  0  44 44 0  0  0  7  8  22 12 0  0  0  16 17 18 44 44 7  114 14 23 12 0  0  0  7  8  8  9  0  0  0  0  0  0  7  9  0  0  0  7  8  8  8  8  9  0  0  0  0  0  0  0  0  0  0  0  0  0  0  0  0  0  0  0  0  0  0  0  0  0  0  0  0  0  0  0  0  0  0  0  0  0  0  0  0  16 17 18 0  0  0  0  0  0  16 17 18 0  0  16 17 18 0  0  0  0  0  0  0  0  16 17 18 0  0  10 30 18 0  0  16 31 20 15 0  0  0  13 14 14 14 14 14 15 0  0  0  7  8  9  0  10 12 7  9  0  0  0  0  7  8  22 11 11 11 11 11 11 11 11 11 11 11 11 11 12 0  0  
   10 11 12 0  0  0  0  0  13 15 0  0  0  0  0  0  0  44 44 44 0  13 14 14 23 11 30 18 0  0  7  8  8  9  0  0  13 14 23 12 0  0  0  0  0  7  8  8  114 23 11 11 12 0  0  0  13 14 14 15 0  0  44 44 0  7  114 15 0  0  0  13 14 14 14 14 113 9  0  0  0  0  0  0  0  0  0  27 28 28 28 28 29 0  0  0  0  0  0  0  0  0  0  0  0  0  0  0  0  0  0  0  0  0  0  7  8  8  8  8  8  8  8  8  9  0  0  0  0  0  0  0  0  0  0  0  0  0  0  0  0  0  0  0  0  0  0  16 18 0  0  0  0  16 17 18 0  0  0  16 31 11 11 11 11 12 0  0  0  13 14 15 0  10 21 114 15 0  0  0  0  13 14 23 11 11 11 11 11 11 11 11 11 11 11 11 11 12 0  0  
   10 11 21 8  8  9  0  0  16 18 0  0  0  0  0  0  0  7  8  8  8  22 11 19 11 11 12 0  0  0  13 14 14 15 0  0  10 11 11 12 0  0  0  0  7  114 14 14 23 11 11 30 18 0  0  0  10 19 11 12 0  7  8  8  8  114 23 21 8  8  8  22 11 11 11 11 20 113 9  0  0  0  0  0  0  0  0  0  0  0  0  0  0  0  0  0  0  0  0  0  0  0  0  0  0  0  27 28 28 28 29 0  0  0  0  13 14 14 14 14 14 14 14 14 113 8  8  9  7  8  8  8  8  8  9  0  0  0  0  0  0  7  8  8  8  8  8  8  9  0  0  0  0  7  8  8  9  0  0  0  10 11 11 11 11 12 0  0  0  10 30 18 0  10 20 23 12 0  0  0  7  22 11 11 11 11 11 11 11 11 11 11 11 11 11 11 11 12 0  0  
   10 11 20 14 14 15 0  0  0  0  0  0  0  0  0  0  0  13 14 14 14 23 11 11 11 11 12 0  0  0  10 11 11 12 0  0  16 17 17 18 0  0  0  0  13 23 11 11 11 11 30 18 0  0  0  0  10 11 30 18 0  13 14 14 14 23 11 20 14 14 14 23 11 11 11 11 11 20 15 0  0  0  0  0  0  0  0  0  0  0  0  0  0  0  0  0  0  0  0  0  27 28 29 0  0  0  0  0  0  0  0  0  0  0  0  16 31 11 11 11 11 11 11 11 20 14 14 15 13 14 14 14 14 14 15 0  0  0  0  0  0  13 14 14 14 14 14 14 113 9  0  0  7  114 14 14 15 0  0  0  16 31 11 11 30 18 0  0  0  10 12 0  0  16 31 30 18 0  0  0  13 23 11 11 11 11 11 11 11 11 11 11 11 11 11 11 11 12 0  0  
   10 11 11 11 11 12 0  0  0  0  0  0  0  0  0  0  0  10 11 11 11 11 11 11 11 11 12 0  0  0  16 17 17 18 0  0  0  0  0  0  0  0  0  0  10 11 30 17 17 17 18 0  0  0  0  0  10 11 12 0  0  10 11 11 11 11 11 11 11 11 11 11 11 11 11 11 11 11 12 0  0  0  0  0  0  0  0  0  0  0  0  0  0  0  0  0  0  0  0  0  0  0  0  0  0  0  0  0  0  0  0  0  0  0  0  0  16 17 31 11 11 11 11 11 11 11 30 18 16 31 11 11 11 30 18 0  0  0  0  0  0  16 17 31 11 11 11 11 20 15 0  0  13 23 11 11 12 0  0  0  0  10 11 11 12 0  0  0  0  10 12 0  0  0  10 12 0  0  0  0  16 31 11 11 11 11 11 11 11 11 11 11 11 11 11 30 17 18 0  0  
      )

  (background-tm
   0  0  0  0  0  0  0  0  0  0  0  0  0  0  0  0  0  0  0  0  0  0  0  0  0  0  0  0  0  0  0  0  0  0  0  0  0  0  0  0  0  0  0  0  0  0  0  0  0  0  0  0  0  0  0  0  0  0  0  0  0  0  0  0  0  0  0  0  0  0  0  0  0  0  0  0  0  0  0  0  0  0  0  0  0  0  0  0  0  0  0  0  0  0  0  0  0  0  0  0  0  0  0  0  0  0  0  0  0  0  0  0  0  0  0  0  0  0  0  0  0  0  0  0  0  0  0  0  0  0  0  0  0  0  0  0  0  0  0  0  0  0  0  0  0  0  0  0  0  0  0  0  0  0  0  0  0  0  0  0  0  0  0  0  0  0  0  0  0  0  0  0  0  0  0  0  0  0  0  0  0  0  0  0  0  0  0  0  0  0  0  0  0  0  0  0  0  0  0  0  
   0  0  0  0  0  0  0  0  0  0  0  0  0  0  0  0  0  0  0  0  0  0  0  0  0  0  0  0  0  0  0  0  0  0  0  0  0  0  0  0  0  0  0  0  0  0  0  0  0  0  0  0  0  0  0  0  0  0  0  0  0  0  0  0  0  0  0  0  0  0  0  0  0  0  0  0  0  0  0  0  0  0  0  0  0  0  0  0  0  0  0  0  0  0  0  0  0  0  0  0  0  0  0  0  0  0  0  0  0  0  0  0  0  0  0  0  0  0  0  0  0  0  0  0  0  0  0  0  0  0  0  0  0  0  0  0  0  0  0  0  0  0  0  0  0  0  0  0  0  0  0  0  0  0  0  0  0  0  0  0  0  0  0  0  0  0  0  0  0  0  0  0  0  0  0  0  0  0  0  0  0  0  0  0  0  0  0  0  0  0  0  0  0  0  0  0  0  0  0  0  
   0  0  0  0  0  0  0  0  0  0  0  0  0  0  0  0  0  0  0  0  0  0  0  0  0  0  0  0  0  0  0  0  0  0  0  0  0  0  0  0  0  0  0  0  0  0  0  0  0  0  0  0  0  0  0  0  0  0  0  0  0  0  0  0  0  0  0  0  0  0  0  0  0  0  0  0  0  0  0  0  0  0  0  0  0  0  0  0  0  0  0  0  0  0  0  0  0  0  0  0  0  0  0  0  0  0  0  0  0  0  0  0  0  0  0  0  0  0  0  0  0  0  0  0  0  0  0  0  0  0  0  0  0  0  0  0  0  0  0  0  0  0  0  0  0  0  0  0  0  0  0  0  0  0  0  0  0  0  0  0  0  0  0  0  0  0  0  0  0  0  0  0  0  0  0  0  0  0  0  0  0  0  0  0  0  0  0  0  0  0  0  0  0  0  0  0  0  0  0  0  
   0  0  0  0  0  0  0  0  0  0  0  0  0  0  0  0  0  0  0  0  0  0  0  0  0  0  0  0  0  0  0  0  0  0  0  0  0  0  0  0  0  24 0  0  0  0  0  0  0  0  0  0  0  0  0  0  0  0  0  0  0  0  0  0  0  0  0  0  0  0  0  0  0  0  0  0  0  0  0  0  0  0  0  0  0  0  0  0  0  0  0  0  0  0  0  0  0  0  0  0  0  0  0  0  0  0  0  0  0  0  0  0  0  0  0  0  0  0  0  0  0  0  0  0  0  0  0  0  0  0  0  0  0  0  0  0  0  0  0  0  0  0  0  0  0  0  0  0  0  0  0  0  0  0  0  0  0  0  0  0  0  0  0  0  0  0  0  0  0  0  0  0  0  0  0  0  0  0  0  0  0  0  0  0  0  0  0  0  0  0  0  0  0  0  0  0  0  0  0  0  
   0  0  0  0  0  0  0  0  0  0  0  0  0  0  0  0  0  0  0  25 0  0  0  0  0  0  0  0  0  0  0  0  0  0  0  0  0  0  0  0  0  0  0  0  0  0  0  0  0  0  0  0  0  0  0  0  0  0  0  0  0  0  0  0  0  0  0  0  0  0  0  0  0  0  0  0  0  0  0  0  0  0  0  0  0  0  0  0  0  0  0  0  0  0  0  0  0  0  0  0  0  0  0  0  0  0  0  0  0  0  0  0  0  0  0  0  0  0  0  0  0  0  0  0  0  0  0  0  0  0  0  0  0  0  0  0  0  0  0  0  0  0  0  0  0  0  0  0  0  0  0  0  0  0  0  0  0  0  0  0  0  0  0  0  24 0  0  0  0  0  0  0  0  0  0  0  0  0  0  0  0  0  0  0  0  0  0  0  0  0  0  0  0  0  0  0  0  0  0  0  
   0  0  0  0  0  0  0  0  0  0  0  0  0  0  0  0  0  0  0  0  0  0  0  0  0  0  0  0  0  0  0  0  0  0  0  0  0  0  0  0  0  0  0  0  0  0  0  0  0  0  0  0  0  0  0  0  0  0  0  0  0  0  0  0  0  0  0  0  0  0  0  0  0  0  0  0  0  0  0  0  0  0  0  0  0  0  0  0  0  0  0  0  0  0  0  0  0  0  0  0  0  0  0  0  0  0  0  0  0  0  0  0  0  0  0  0  0  0  0  0  0  0  0  0  0  0  0  0  0  0  0  0  0  0  0  0  0  0  0  0  0  0  0  0  0  0  0  0  0  0  0  0  0  0  0  0  0  0  0  0  0  0  0  0  0  0  0  0  0  0  0  0  0  0  0  0  0  0  0  0  0  0  0  0  0  0  0  0  0  0  0  0  0  0  0  0  0  0  0  0  
   0  0  24 0  0  0  0  0  0  0  0  0  0  0  0  0  0  0  0  0  0  0  0  0  0  0  0  0  0  0  0  0  0  0  0  0  0  0  0  0  0  0  0  0  0  0  0  0  0  0  0  0  0  0  0  0  0  0  0  0  0  0  0  0  0  24 0  0  0  0  0  0  0  0  0  0  0  0  0  0  0  0  0  0  0  0  0  0  0  0  0  0  0  0  0  0  0  0  0  0  0  0  0  0  0  0  0  0  0  0  0  0  0  0  0  0  0  0  0  0  0  0  0  0  0  0  0  0  106 107 108 0  0  0  0  0  0  0  0  0  0  0  0  0  0  0  0  0  0  0  24 0  0  0  0  0  0  0  0  0  0  0  0  0  0  0  0  0  0  0  0  0  0  0  0  0  0  0  0  0  0  0  0  0  130 17 0  0  0  0  10 11 0  0  0  0  0  0  0  0  
   0  0  0  0  0  0  0  0  0  0  0  0  0  0  0  0  0  0  0  0  0  0  0  0  0  0  0  24 0  0  0  0  0  0  0  0  0  0  0  0  0  0  0  0  0  0  0  0  0  0  0  0  0  0  0  0  0  0  0  0  0  0  0  0  0  0  0  0  0  0  0  0  0  0  0  0  0  0  0  0  0  0  0  0  0  0  0  0  0  0  0  0  0  0  0  0  0  0  0  0  0  0  0  0  0  0  0  0  0  0  0  0  0  0  0  0  0  0  0  0  0  0  0  0  0  0  24 0  109 110 111 0  0  0  0  0  0  0  0  0  0  0  0  0  0  0  0  0  0  0  0  0  0  0  0  0  0  0  0  0  0  0  0  0  0  0  0  0  0  0  0  0  0  0  0  0  0  0  0  0  0  0  0  0  129 0  0  0  0  0  10 11 0  0  0  0  0  0  0  0  
   0  0  0  0  0  0  0  0  0  0  0  0  0  0  0  0  0  0  0  0  0  0  0  0  0  0  0  0  0  0  0  0  0  0  0  0  0  0  0  0  0  0  0  0  0  0  0  0  0  0  0  0  0  0  0  0  0  0  0  0  0  0  0  0  0  0  0  0  0  0  0  0  0  0  0  0  0  0  0  0  0  0  0  0  0  0  0  0  0  0  0  0  0  0  0  0  0  0  0  0  0  0  0  0  0  0  0  0  0  0  0  0  0  0  0  0  0  0  0  0  0  0  0  0  0  0  0  0  0  0  0  0  0  0  0  0  0  0  0  0  0  0  0  0  0  0  0  0  0  0  0  0  0  0  0  0  0  0  0  0  0  0  0  0  0  0  0  0  0  0  0  0  0  0  0  0  0  0  0  0  0  0  0  0  129 8  0  0  0  0  10 11 0  0  0  0  0  0  0  0  
   0  0  0  0  0  0  0  0  0  0  0  0  0  0  0  0  0  0  0  0  0  0  0  0  0  0  0  0  0  0  0  0  0  0  0  0  0  0  0  0  0  0  0  0  0  0  0  0  0  25 0  0  0  0  0  0  0  0  0  0  0  0  0  0  0  0  0  0  0  0  0  0  0  0  0  0  0  0  0  0  0  0  0  0  0  0  0  0  0  0  0  0  0  0  0  0  0  0  0  0  0  0  0  0  0  0  0  0  0  0  0  0  0  0  0  0  0  0  0  0  0  0  0  0  0  0  0  0  0  0  0  0  0  0  0  0  0  0  0  0  0  0  0  0  0  0  0  0  0  0  0  0  0  0  0  0  0  0  0  0  25 0  0  0  0  0  0  0  0  0  0  0  0  0  0  0  0  0  0  0  0  0  0  0  0  0  0  0  0  0  10 11 0  0  0  0  0  0  0  0  
   0  0  0  0  0  0  0  0  0  0  0  0  0  0  0  0  0  0  0  0  0  0  0  0  0  0  0  0  0  0  0  0  0  0  0  0  0  0  0  0  0  0  0  0  0  0  0  0  0  0  0  0  0  0  0  0  0  0  0  0  0  0  0  0  0  0  24 0  0  0  0  0  0  0  0  0  0  0  0  0  0  0  0  0  0  0  0  0  0  0  0  0  0  0  0  0  0  0  0  0  0  0  0  0  0  0  0  0  0  0  0  0  0  0  0  0  0  0  0  0  0  0  0  0  0  0  0  0  0  0  0  0  0  0  0  0  0  0  0  0  0  0  0  0  0  0  0  0  0  0  0  0  0  0  0  0  0  0  0  0  0  0  0  0  0  0  0  0  0  0  0  0  0  0  0  0  0  0  0  0  0  0  0  0  0  0  0  0  0  0  0  0  0  0  0  0  0  0  0  0  
   0  0  0  0  0  0  0  0  0  0  0  0  0  0  0  0  0  0  106 107 108 0  0  0  0  0  0  0  0  0  0  0  0  0  0  0  0  0  0  0  0  0  0  0  0  0  0  0  0  0  0  0  0  0  0  0  0  0  0  0  0  0  0  0  0  0  0  0  106 107 108 0  0  0  0  0  0  0  0  0  0  0  0  0  0  0  0  0  0  0  0  0  0  0  0  0  0  0  0  0  0  0  0  0  0  0  0  0  0  0  0  0  0  0  0  0  0  0  0  0  0  0  0  0  0  0  0  0  0  0  0  0  0  0  0  0  0  0  0  0  0  0  0  0  0  0  0  0  0  0  0  0  0  0  0  0  0  0  0  0  0  0  0  0  0  0  0  0  0  0  0  0  0  0  0  0  0  0  0  0  0  0  0  0  0  0  0  0  0  0  0  0  0  0  0  0  0  0  0  0  
   0  0  0  0  25 0  0  0  0  0  0  0  0  0  0  0  0  0  109 110 111 0  0  0  0  0  0  0  0  0  0  0  0  0  0  0  0  0  0  0  0  0  0  0  0  0  0  0  0  0  0  0  0  0  0  0  0  0  0  0  0  0  0  0  0  0  0  0  109 110 111 0  0  0  0  0  0  0  0  0  0  0  0  0  0  0  0  0  0  0  0  0  0  0  0  0  0  0  0  0  0  0  0  0  0  0  0  0  0  0  0  0  0  0  0  0  0  0  0  0  0  0  0  0  0  0  0  0  0  0  0  0  0  0  24 0  0  0  0  0  0  0  0  0  0  0  0  0  0  0  0  0  0  0  0  0  0  0  0  0  0  0  0  0  0  0  0  0  0  0  0  0  0  0  0  0  0  0  0  0  24 0  0  0  0  0  0  0  0  0  0  0  0  0  0  0  0  0  0  0  
   0  0  0  0  0  0  0  0  0  0  0  0  0  0  0  0  0  0  0  0  0  0  0  0  0  0  0  0  0  0  0  0  0  0  0  0  0  0  0  0  0  0  0  0  0  0  0  0  0  0  0  0  0  0  0  0  0  0  0  0  0  0  0  0  0  0  0  0  0  0  0  0  0  0  0  0  0  0  0  0  0  0  0  0  0  0  0  0  0  0  0  0  0  0  0  0  0  0  0  0  0  0  0  0  0  0  0  0  0  0  0  0  0  0  0  0  0  0  0  0  0  0  0  0  0  0  0  0  0  0  0  0  0  0  0  0  0  0  0  0  0  0  0  0  0  0  0  0  0  0  0  0  0  0  0  0  0  0  0  0  0  0  0  0  0  0  0  0  0  0  0  0  0  0  0  0  0  0  0  0  0  0  0  0  0  0  0  0  0  0  0  0  0  0  0  0  0  0  0  0  
   0  0  0  0  0  0  0  0  0  0  0  0  0  0  0  0  0  0  0  0  0  0  0  0  0  0  0  0  0  0  0  0  0  0  0  0  0  0  0  0  0  0  0  0  0  0  0  0  0  0  0  0  0  0  0  0  0  0  0  0  0  0  0  0  0  0  0  0  0  0  0  0  0  0  0  0  0  0  0  0  0  0  0  0  0  0  0  0  0  0  0  0  0  0  0  0  0  0  0  0  0  0  0  0  0  0  0  0  0  0  0  0  0  0  0  0  0  0  0  0  0  0  0  0  0  0  0  0  0  0  0  0  0  0  0  0  0  0  0  0  0  0  0  0  0  0  0  0  0  0  0  0  0  0  0  0  0  0  0  0  0  0  0  0  0  0  0  0  0  0  0  0  0  0  0  0  0  0  0  0  0  0  0  0  0  0  0  0  0  0  0  0  0  0  0  0  0  0  0  0  
      )

  (foreground-tm
   0  0  0  0  0  0  0  0  0  0  0  0  0  0  0  0  0  0  0  0  0  0  0  0  0  0  0  0  0  0  0  0  0  0  0  0  0  0  0  0  0  0  0  0  0  0  0  0  0  0  0  0  0  0  0  0  0  0  0  0  0  0  0  0  0  0  0  0  0  0  0  0  0  0  0  0  0  0  0  0  0  0  0  0  0  0  0  0  0  0  0  0  0  0  0  0  0  0  0  0  0  0  0  0  0  0  0  0  0  0  0  0  0  0  0  0  0  0  0  0  0  0  0  0  0  0  0  0  0  0  0  0  0  0  0  0  0  0  0  0  0  0  10 11 11 11 11 11 11 11 12 0  0  0  0  0  0  0  0  0  0  0  0  0  0  0  0  0  0  0  0  0  0  0  0  0  0  0  0  0  0  0  0  0  0  0  0  0  0  0  0  0  0  0  0  0  0  0  0  0  
   0  0  0  0  0  0  0  0  0  0  0  0  0  0  0  0  0  0  0  0  0  0  0  0  0  0  0  0  0  0  0  0  0  0  0  0  0  0  0  0  0  0  0  0  0  0  0  0  0  0  0  0  0  0  0  0  0  0  0  0  0  0  0  0  0  0  0  0  0  0  0  0  0  0  0  0  0  0  0  0  0  0  0  0  0  0  0  0  0  0  0  0  0  0  0  0  0  0  0  0  0  0  0  0  0  0  0  0  0  0  0  0  0  0  0  0  0  0  0  0  0  0  0  0  0  0  0  0  0  0  0  0  0  0  0  0  0  0  0  0  0  0  16 31 11 11 11 19 11 30 18 0  0  0  0  0  0  0  0  0  0  0  0  0  0  0  0  0  0  0  0  0  0  0  0  0  0  0  0  0  0  0  0  0  0  0  0  0  0  0  0  0  0  0  0  0  0  0  0  0  
   0  0  0  0  0  0  0  0  0  0  0  0  0  0  0  0  0  0  0  0  0  0  0  0  0  0  0  0  0  0  0  0  0  0  0  0  0  0  0  0  0  0  0  0  0  0  0  0  0  0  0  0  0  0  0  0  0  0  0  0  0  0  0  0  0  0  0  0  0  0  0  0  0  0  0  0  0  0  0  0  0  0  0  0  0  0  0  0  0  0  0  0  0  0  0  0  0  0  0  0  0  0  0  0  0  0  0  0  0  0  0  0  0  0  0  0  0  0  0  0  0  0  0  0  0  0  0  0  0  0  0  0  0  0  0  0  0  0  0  0  0  0  0  10 11 11 11 11 11 12 0  0  0  0  0  0  0  0  0  0  0  0  0  0  0  0  0  0  0  0  0  0  0  0  0  0  0  0  0  0  0  0  0  0  0  0  0  0  0  0  0  0  0  0  0  0  0  0  0  0  
   0  0  0  0  0  0  0  0  0  0  0  0  0  0  0  0  0  0  0  0  0  0  0  0  0  0  0  0  0  0  0  0  0  0  0  0  0  0  0  0  0  0  0  0  0  0  0  0  0  0  0  0  0  0  0  0  0  0  0  0  0  0  0  0  0  0  0  0  0  0  0  0  0  0  0  0  0  0  0  0  0  0  0  0  0  0  0  0  0  0  0  0  0  0  0  0  0  0  0  0  0  0  0  0  0  0  0  0  0  0  0  0  0  0  0  0  0  0  0  0  0  0  0  0  0  0  0  0  0  0  0  0  0  0  0  0  0  0  0  0  0  0  0  10 11 11 11 11 11 12 0  0  0  0  0  0  0  0  0  0  0  0  0  0  0  0  0  0  0  0  0  0  0  0  0  0  0  0  0  0  0  0  0  0  0  0  0  0  0  0  0  0  0  0  0  0  0  0  0  0  
   0  0  0  0  0  0  0  0  0  0  0  0  0  0  0  0  0  0  0  0  0  0  0  0  0  0  0  0  0  0  0  0  0  0  0  0  0  0  0  0  0  0  0  0  0  0  0  0  0  0  0  0  0  0  0  0  0  0  0  0  0  0  0  0  0  0  0  0  0  0  0  0  0  0  0  0  0  0  0  0  0  0  0  0  0  0  0  0  0  0  0  0  0  0  0  0  0  0  0  0  0  0  0  0  0  0  0  0  0  0  0  0  0  0  0  0  0  0  0  0  0  0  0  0  0  0  0  0  0  0  0  0  0  0  0  0  0  0  0  0  0  0  0  0  0  0  0  0  0  0  0  0  0  0  0  0  0  0  0  0  0  0  0  0  0  0  0  0  0  0  0  0  0  0  0  0  0  0  0  0  0  0  0  0  0  0  0  0  0  0  0  0  0  0  0  0  0  0  0  0  
   0  0  0  0  0  0  0  0  0  0  0  0  0  0  0  0  0  0  0  0  0  0  0  0  0  0  0  0  0  0  0  0  0  0  0  0  0  0  0  0  0  0  0  0  0  0  0  0  0  0  0  0  0  0  0  0  0  0  0  0  0  0  0  0  0  0  0  0  0  0  0  0  0  0  0  0  0  0  0  0  0  0  0  0  0  0  0  0  0  0  0  0  0  0  0  0  0  0  0  0  0  0  0  0  0  0  0  0  0  0  0  0  0  0  0  0  0  0  0  0  0  0  0  0  0  0  0  0  0  0  0  0  0  0  0  0  0  0  0  0  0  0  0  0  0  0  0  0  0  0  0  0  0  0  0  0  0  0  0  0  0  0  0  0  0  0  0  0  0  0  0  0  0  0  0  0  0  0  0  0  0  0  0  0  0  0  0  0  0  0  0  0  0  0  0  0  0  0  0  0  
   0  0  0  0  0  0  0  0  0  0  0  0  0  0  0  0  0  0  0  0  0  0  0  0  0  0  0  0  0  0  0  0  0  0  0  0  0  0  0  0  0  0  0  0  0  0  0  0  0  0  0  0  0  0  0  0  0  0  0  0  0  0  0  0  0  0  0  0  0  0  0  0  0  0  0  0  0  0  0  0  0  0  0  0  0  0  0  0  0  0  0  0  0  0  0  0  0  0  0  0  0  0  0  0  0  0  0  0  0  0  0  0  0  0  0  0  0  0  0  0  0  0  0  0  0  0  0  0  0  0  0  0  0  0  0  0  0  0  0  0  0  0  0  0  0  0  0  0  0  0  0  0  0  0  0  0  0  0  0  0  0  0  0  0  0  0  0  0  0  0  0  0  0  0  0  0  0  0  0  0  0  0  0  0  0  0  130 0  0  0  0  31 11 11 11 11 11 0  0  0  
   0  0  0  0  0  0  0  0  0  0  0  0  0  0  0  0  0  0  0  0  0  0  0  0  0  0  0  0  0  0  0  0  0  0  0  0  0  0  0  0  0  0  0  0  0  0  0  0  0  0  0  0  0  0  0  0  0  0  0  0  0  0  0  0  0  0  0  0  0  0  0  0  0  0  0  0  0  0  0  0  0  0  0  0  0  0  0  0  0  0  0  0  0  0  0  0  0  0  0  0  0  0  0  0  0  0  0  0  0  0  0  0  0  0  0  0  0  0  0  0  0  0  0  0  0  0  0  0  0  0  0  0  0  0  0  0  0  0  0  0  0  0  0  0  0  0  0  0  0  0  0  0  0  0  0  0  0  0  0  0  0  0  0  0  0  0  0  0  0  0  0  0  0  0  0  0  0  0  0  0  0  0  0  0  0  0  129 0  0  0  0  10 11 11 11 11 11 0  0  0  
   0  0  0  0  0  0  0  0  0  0  0  0  0  0  0  0  0  0  0  0  0  0  0  0  0  0  0  0  0  0  0  0  0  0  0  0  0  0  0  0  0  0  0  0  0  0  0  0  0  0  0  0  0  0  0  0  0  0  0  0  0  0  0  0  0  0  0  0  0  0  0  0  0  0  0  0  0  0  0  0  0  0  0  0  0  0  0  0  0  0  0  0  0  0  0  0  0  0  0  0  0  0  0  0  0  0  0  0  0  0  0  0  0  0  0  0  0  0  0  0  0  0  0  0  0  0  0  0  0  0  0  0  0  0  0  0  0  0  0  0  0  0  0  0  0  0  0  0  0  0  0  0  0  0  0  0  0  0  0  0  0  0  0  0  0  0  0  0  0  0  0  0  0  0  0  0  0  0  0  0  0  0  0  0  0  0  129 0  0  0  0  22 11 11 11 11 11 0  0  0  
   0  0  0  0  0  0  0  0  0  0  0  0  0  0  0  0  0  0  0  0  0  0  0  0  0  0  0  0  0  0  0  0  0  0  0  0  0  0  0  0  0  0  0  0  0  0  0  0  0  0  0  0  0  0  0  0  0  0  0  0  0  0  0  0  0  0  0  0  0  0  0  0  0  0  0  0  0  0  0  0  0  0  0  0  0  0  0  0  0  0  0  0  0  0  0  0  0  0  0  0  0  0  0  0  0  0  0  0  0  0  0  0  0  0  0  0  0  0  0  0  0  0  0  0  0  0  0  0  0  0  0  0  0  0  0  0  0  0  0  0  0  0  0  0  0  0  0  0  0  0  0  0  0  0  0  0  0  0  0  0  0  0  0  0  0  0  0  0  0  0  0  0  0  0  0  0  0  0  0  0  0  0  0  0  0  0  0  0  0  0  0  23 11 11 11 11 11 0  0  0  
   0  0  0  0  0  0  0  0  0  0  0  0  0  0  0  0  0  0  0  0  0  0  0  0  0  0  0  0  0  0  0  0  0  0  0  0  0  0  0  0  0  0  0  0  0  0  0  0  0  0  0  0  0  0  0  0  0  0  0  0  0  0  0  0  0  0  0  0  0  0  0  0  0  0  0  0  0  0  0  0  0  0  0  0  0  0  0  0  0  0  0  0  0  0  0  0  0  0  0  0  0  0  0  0  0  0  0  0  0  0  0  0  0  0  0  0  0  0  0  0  0  0  0  0  0  0  0  0  0  0  0  0  0  0  0  0  0  0  0  0  0  0  0  0  0  0  0  0  0  0  0  0  0  0  0  0  0  0  0  0  0  0  0  0  0  0  0  0  0  0  0  0  0  0  0  0  0  0  0  0  0  0  0  0  0  0  0  0  0  0  0  0  0  0  0  0  0  0  0  0  
   0  0  0  0  0  0  0  0  0  0  0  0  0  0  0  0  0  0  0  0  0  0  0  0  0  0  0  0  0  0  0  0  0  0  0  0  0  0  0  0  0  0  0  0  0  0  0  0  0  0  0  0  0  0  0  0  0  0  0  0  0  0  0  0  0  0  0  0  0  0  0  0  0  0  0  0  0  0  0  0  0  0  0  0  0  0  0  0  0  0  0  0  0  0  0  0  0  0  0  0  0  0  0  0  0  0  0  0  0  0  0  0  0  0  0  0  0  0  0  0  0  0  0  0  0  0  0  0  0  0  0  0  0  0  0  0  0  0  0  0  0  0  0  0  0  0  0  0  0  0  0  0  0  0  0  0  0  0  0  0  0  0  0  0  0  0  0  0  0  0  0  0  0  0  0  0  0  0  0  0  0  0  0  0  0  0  0  0  0  0  0  0  0  0  0  0  0  0  0  0  
   0  0  0  0  0  0  0  0  0  0  0  0  0  0  0  0  0  0  0  0  0  0  0  0  0  0  0  0  0  0  0  0  0  0  0  0  0  0  0  0  0  0  0  0  0  0  0  0  0  0  0  0  0  0  0  0  0  0  0  0  0  0  0  0  0  0  0  0  0  0  0  0  0  0  0  0  0  0  0  0  0  0  0  0  0  0  0  0  0  0  0  0  0  0  0  0  0  0  0  0  0  0  0  0  0  0  0  0  0  0  0  0  0  0  0  0  0  0  0  0  0  0  0  0  0  0  0  0  0  0  0  0  0  0  0  0  0  0  0  0  0  0  0  0  0  0  0  0  0  0  0  0  0  0  0  0  0  0  0  0  0  0  0  0  0  0  0  0  0  0  0  0  0  0  0  0  0  0  0  0  0  0  0  0  0  0  0  0  0  0  0  0  0  0  0  0  0  0  0  0  
   0  0  0  0  0  0  0  0  0  0  0  0  0  0  0  0  0  0  0  0  0  0  0  0  0  0  0  0  0  0  0  0  0  0  0  0  0  0  0  0  0  0  0  0  0  0  0  0  0  0  0  0  0  0  0  0  0  0  0  0  0  0  0  0  0  0  0  0  0  0  0  0  0  0  0  0  0  0  0  0  0  0  0  0  0  0  0  0  0  0  0  0  0  0  0  0  0  0  0  0  0  0  0  0  0  0  0  0  0  0  0  0  0  0  0  0  0  0  0  0  0  0  0  0  0  0  0  0  0  0  0  0  0  0  0  0  0  0  0  0  0  0  0  0  0  0  0  0  0  0  0  0  0  0  0  0  0  0  0  0  0  0  0  0  0  0  0  0  0  0  0  0  0  0  0  0  0  0  0  0  0  0  0  0  0  0  0  0  0  0  0  0  0  0  0  0  0  0  0  0  
   0  0  0  0  0  0  0  0  0  0  0  0  0  0  0  0  0  0  0  0  0  0  0  0  0  0  0  0  0  0  0  0  0  0  0  0  0  0  0  0  0  0  0  0  0  0  0  0  0  0  0  0  0  0  0  0  0  0  0  0  0  0  0  0  0  0  0  0  0  0  0  0  0  0  0  0  0  0  0  0  0  0  0  0  0  0  0  0  0  0  0  0  0  0  0  0  0  0  0  0  0  0  0  0  0  0  0  0  0  0  0  0  0  0  0  0  0  0  0  0  0  0  0  0  0  0  0  0  0  0  0  0  0  0  0  0  0  0  0  0  0  0  0  0  0  0  0  0  0  0  0  0  0  0  0  0  0  0  0  0  0  0  0  0  0  0  0  0  0  0  0  0  0  0  0  0  0  0  0  0  0  0  0  0  0  0  0  0  0  0  0  0  0  0  0  0  0  0  0  0  
      )

  (reset-points
   )
  (objects
    (snowball  (x 142) (y 373))
    (mriceblock  (x 562) (y 115))
    (money  (x 1808) (y 290))
    (flyingsnowball  (x 1328) (y 403))
    (flyingsnowball  (x 4816) (y 369))
    (flyingsnowball  (x 5697) (y 345))
    (money  (x 3950) (y 309))
    (snowball  (x 4627) (y 179))
    (snowball  (x 5456) (y 309))
    (mrbomb  (x 2869) (y 308))
    (mrbomb  (x 3471) (y 343))
    (flyingsnowball  (x 418) (y 372))
    (mriceblock  (x 2034) (y 373))
    (money  (x 3028) (y 229))
    (snowball  (x 4112) (y 372))
    (stalactite  (x 1057) (y 265))
    (mriceblock  (x 2324) (y 83))
    (mriceblock  (x 4146) (y 208))
    (money  (x 5199) (y 240))
    (snowball  (x 1453) (y 115))
    (snowball  (x 1714) (y 81))
  )
   )


;; EOF ;;
