(supertux-level
  (version 3)
  (name (_ "...Where Everything Is Possible"))
  (author "Carsten Wirtz")
  (license "CC-BY-SA 4.0 International")
  (target-time 78)
  (allow-item-pocket "inherit")
  (icon "")
  (icon-locked "")
  (statistics
    (enable-coins #t)
    (enable-secrets #t)
  )
  (sector
    (name "main")
    (ambient-light
      (color 1 1 1)
    )
    (background
      (scroll-offset-y 150)
      (color 1 0.82 0.85)
      (speed 0)
      (image-top "/images/background/misc/transparent_up.png")
      (image "/images/background/antarctic/ice_mountains_panorama.png")
      (z-pos -250)
    )
    (background
      (color 1 0.8 0.8)
      (scroll-speed-x -0.1)
      (speed 0)
      (image "/images/background/misc/skybox.png")
      (z-pos -290)
    )
    (background
      (color 1 0.8 0.8)
      (scroll-speed-x -2)
      (speed 0)
      (image "/images/background/misc/clouds.png")
      (z-pos -280)
    )
    (background
      (color 1 1 1)
      (alignment "bottom")
      (scroll-speed-x -20)
      (speed 0.25)
      (image "/images/background/arcticskies/arcticskies3.png")
      (z-pos -200)
    )
    (background
      (scroll-offset-y 220)
      (color 1 0.9 0.9)
      (speed 0.1)
      (image-top "/images/background/misc/transparent_up.png")
      (image "/images/background/antarctic/ice_mountains.png")
      (z-pos -220)
    )
    (background
      (scroll-offset-y 15)
      (color 1 1 1 0.8)
      (alignment "bottom")
      (scroll-speed-x -50)
      (speed 1.2)
      (image "/images/background/arcticskies/arcticskies3.png")
      (z-pos 200)
    )
    (bonusblock
      (type "purple")
      (z-pos 51)
      (x 5792)
      (y 1696)
    )
    (bonusblock
      (type "orange")
      (z-pos 51)
      (x 9184)
      (y 1024)
    )
    (bonusblock
      (z-pos 51)
      (contents "firegrow")
      (x 10096)
      (y 1280)
    )
    (camera
      (name "Camera")
      (mode "normal")
    )
    (crystallo
      (z-pos 50)
      (glinting #f)
      (radius 80)
      (x 9728)
      (y 1088)
    )
    (decal
      (z-pos -10)
      (sprite "/images/decal/snow/igloo_bg.png")
      (x 13760)
      (y 1664)
    )
    (decal
      (z-pos 100)
      (sprite "/images/decal/snow/igloo_fg.png")
      (x 13760)
      (y 1664)
    )
    (firefly
      (z-pos 0)
      (x 6976)
      (y 1952)
    )
    (flyingsnowball
      (z-pos 50)
      (x 5280)
      (y 1728)
      (glinting #f)
    )
    (flyingsnowball
      (z-pos 50)
      (x 4480)
      (y 2112)
      (glinting #f)
    )
    (goldbomb
      (z-pos 50)
      (x 10528)
      (y 1088)
      (glinting #t)
    )
    (gradient
      (top_color 0.8 0.45 0.72)
      (bottom_color 1 1 0.6)
    )
    (haywire
      (z-pos 50)
      (x 8160)
      (y 1248)
      (glinting #f)
    )
    (jumpy
      (z-pos 50)
      (x 6368)
      (y 1664)
      (glinting #f)
    )
    (jumpy
      (type "metal")
      (z-pos 50)
      (x 8816)
      (y 1184)
      (glinting #f)
    )
    (jumpy
      (type "metal")
      (z-pos 50)
      (x 9040)
      (y 1152)
      (glinting #f)
    )
    (jumpy
      (z-pos 50)
      (x 6528)
      (y 1632)
      (glinting #t)
    )
    (mrbomb
      (z-pos 50)
      (x 5856)
      (y 1792)
      (glinting #f)
    )
    (mrbomb
      (z-pos 50)
      (x 5856)
      (y 2176)
      (glinting #f)
    )
    (mrtree
      (z-pos 50)
      (x 7680)
      (y 864)
      (glinting #f)
    )
    (music
      (file "/music/antarctic/sunset.music")
    )
    (owl
      (z-pos 51)
      (glinting #f)
      (carry "skydive")
      (x 11552)
      (y 1408)
    )
    (particles-clouds
    )
    (path
      (name "gen17082970553141885826000")
      (path
        (mode "oneshot")
        (adapt_speed #f)
        (node
          (x 992)
          (y 2144)
          (time 4.266667)
          (speed 300)
          (easing "EaseQuadInOut")
        )
        (node
          (x 2272)
          (y 2144)
        )
      )
    )
    (path
      (name "gen17082986323141945523920")
      (path
        (adapt_speed #f)
        (node
          (x 6048)
          (y 1856)
          (time 2.133333)
          (speed 150)
          (easing "EaseQuadInOut")
        )
        (node
          (x 6048)
          (y 2176)
          (time 2.133333)
          (speed 150)
          (easing "EaseQuadInOut")
        )
      )
    )
    (path
      (name "gen17083029163141945525936")
      (path
        (adapt_speed #f)
        (node
          (x 12528)
          (y 1376)
          (time 2.4)
          (speed 200)
          (easing "EaseQuadInOut")
        )
        (node
          (x 12528)
          (y 1856)
          (time 2.4)
          (speed 200)
          (easing "EaseQuadInOut")
        )
      )
    )
    (path
      (name "gen17083033413141945525488")
      (path
        (adapt_speed #f)
        (node
          (x 11200)
          (y 768)
          (bezier_after_x 11328)
          (bezier_after_y 704)
          (time 1.762717)
          (speed 150)
          (easing "EaseQuadInOut")
        )
        (node
          (x 11456)
          (y 768)
          (bezier_after_x 11328)
          (bezier_after_y 704)
          (time 1.762717)
          (speed 150)
          (easing "EaseQuadInOut")
        )
      )
    )
    (path
      (name "gen17083043623141945523024")
      (path
        (adapt_speed #f)
        (node
          (x 7248)
          (y 800)
          (time 1.28)
          (speed 50)
          (easing "EaseQuadInOut")
        )
        (node
          (x 7248)
          (y 736)
          (time 1.28)
          (speed 50)
          (easing "EaseQuadInOut")
        )
      )
    )
    (platform
      (z-pos 50)
      (handle
        (scale_x 0)
        (scale_y 0)
        (offset_x 0)
        (offset_y 0)
      )
      (running #f)
      (path-ref "gen17082970553141885826000")
    )
    (platform
      (z-pos 50)
      (handle
        (scale_x 0)
        (scale_y 0)
        (offset_x 0)
        (offset_y 0)
      )
      (path-ref "gen17082986323141945523920")
    )
    (platform
      (z-pos 50)
      (handle
        (scale_x 0)
        (scale_y 0)
        (offset_x 0)
        (offset_y 0)
      )
      (path-ref "gen17083029163141945525936")
    )
    (platform
      (z-pos 50)
      (handle
        (scale_x 0)
        (scale_y 0)
        (offset_x 0)
        (offset_y 0)
      )
      (path-ref "gen17083033413141945525488")
    )
    (platform
      (z-pos 50)
      (handle
        (scale_x 0)
        (scale_y 0)
        (offset_x 0)
        (offset_y 0)
      )
      (path-ref "gen17083043623141945523024")
    )
    (rock
      (type "large")
      (z-pos 50)
      (x 9664)
      (y 1216)
    )
    (rock
      (type "large")
      (z-pos 50)
      (x 9728)
      (y 1216)
    )
    (rock
      (type "large")
      (z-pos 50)
      (x 4208)
      (y 1728)
    )
    (rock
      (type "large")
      (z-pos 50)
      (x 4272)
      (y 1728)
    )
    (scripttrigger
      (oneshot #t)
      (script "Camera.set_scale(1.5);
//Effect.sixteen_to_nine(0);

//Tux.use_scripting_controller(true);
//Tux.do_scripting_controller(\"right\", true);")
      (button #f)
      (width 96)
      (height 192)
      (x 416)
      (y 1952)
    )
    (scripttrigger
      (oneshot #t)
      (script "Tux.use_scripting_controller(true);
Tux.do_scripting_controller(\"right\", true);")
      (button #f)
      (width 32)
      (height 128)
      (x 768)
      (y 2016)
    )
    (scripttrigger
      (oneshot #t)
      (script "Tux.do_scripting_controller(\"right\", false);
//Effect.four_to_three(4);
wait(1);
Camera.ease_scale(1, 3, \"EaseQuadOut\");")
      (button #f)
      (width 32)
      (height 2144)
      (x 960)
      (y 0)
    )
    (scripttrigger
      (oneshot #t)
      (script "Tux.use_scripting_controller(false);")
      (button #f)
      (width 32)
      (height 2880)
      (x 2272)
      (y 0)
    )
    (scripttrigger
      (oneshot #t)
      (script "upside_barrier.fade(0, 0);")
      (button #f)
      (width 1568)
      (height 32)
      (x 6272)
      (y 1376)
    )
    (secretarea
      (width 96)
      (height 320)
      (x 11872)
      (y 1184)
    )
    (sequencetrigger
      (sequence "endsequence")
      (width 32)
      (height 2496)
      (x 13280)
      (y -640)
    )
    (sequencetrigger
      (sequence "stoptux")
      (width 64)
      (height 2496)
      (x 14016)
      (y -640)
    )
    (smartball
      (z-pos 50)
      (x 3840)
      (y 2176)
      (glinting #t)
    )
    (smartball
      (z-pos 50)
      (x 3392)
      (y 1760)
      (glinting #f)
    )
    (spawnpoint
      (name "main")
      (x 448)
      (y 2080)
    )
    (stalactite
      (glinting #f)
      (z-pos -1)
      (x 4288)
      (y 1824)
    )
    (tarantula
      (z-pos 50)
      (x 11424)
      (y 1056)
      (glinting #f)
      (static #t)
      (flip #t)
    )
    (tilemap
      (solid #f)
      (z-pos -100)
      (width 445)
      (height 90)
      (tiles -23109 0 130 -444 0 129 -444 0 129 -444 0 129 -444 0 129 -440 0 106 107 108 0 129 -26 0 106 107 108 -13 0 106 107 108 -387 0 24 0 2621 -2 0 5203 5204 0 109 110 111 0 4967 -4 0 2621 -2 0 2622 -3 0 24 -14 0 109 110 111 -13 0 109 110 111 0 24 -3125 0 141 142 -441 0 5203 5204 143 144 24 -10650 0)
    )
    (tilemap
      (solid #t)
      (z-pos 0)
      (width 445)
      (height 90)
      (tiles -217 0 10 11 12 -442 0 10 11 12 -442 0 10 11 12 -442 0 10 11 12 -441 0 5254 5245 11 5247 5255 -440 0 5260 -3 11 5261 -440 0 5380 -3 11 5381 -440 0 10 -3 11 12 -440 0 10 11 5369 5368 12 -440 0 10 11 5369 19 12 -440 0 10 5368 5369 11 12 -440 0 10 -2 11 5368 12 -440 0 10 11 -2 5368 12 -440 0 10 11 5369 11 12 -440 0 10 -3 11 12 -440 0 10 5368 5369 11 12 -439 0 5254 5245 -3 11 5247 5255 -438 0 5260 -2 11 -2 5369 11 5261 -438 0 5380 11 5368 -3 11 5381 -438 0 10 -2 11 1539 -2 11 12 -437 0 5254 5245 -5 11 5247 5255 -436 0 5260 11 -2 5369 11 5368 -2 11 5261 -11 0 7 -9 8 9 -21 0 7 9 -6 0 7 8 9 -21 0 7 -10 8 9 -12 0 7 -10 8 9 -30 0 7 9 -21 0 7 -9 8 9 -260 0 5242 5266 -4 11 5369 -2 11 5267 5243 -10 0 13 -7 14 3990 14 15 -5 0 7 9 -7 0 7 9 -5 0 13 15 -4 0 7 8 114 14 15 -5 0 7 -9 8 9 -5 0 13 -2 3989 -7 14 3990 15 -5 0 7 9 -5 0 13 -7 14 3988 -2 14 15 -5 0 7 -8 8 9 -15 0 13 15 -13 0 7 8 9 -5 0 13 -6 14 3990 3989 14 15 -260 0 5378 -2 11 5369 -2 11 5368 -3 11 5379 -10 0 10 11 5369 -4 11 5368 -2 11 12 -5 0 13 15 -7 0 13 15 -5 0 10 12 -4 0 13 14 23 11 12 -5 0 13 -2 14 -2 3989 -3 14 3990 14 15 -5 0 16 -2 17 3991 31 5369 -3 11 5368 11 12 -5 0 13 15 -5 0 10 -2 5369 5368 11 5368 5369 -3 11 5369 12 -5 0 13 14 3990 -6 14 15 -15 0 10 12 -11 0 7 8 114 14 15 -5 0 10 -2 11 5368 -2 11 5368 11 5368 11 12 -260 0 10 -2 11 5369 -3 11 5369 5368 11 12 -10 0 16 -3 17 -2 3991 -3 17 3991 18 -5 0 10 12 -7 0 10 12 -5 0 10 12 -3 0 7 22 30 17 31 12 -5 0 10 11 5368 11 5368 -4 11 5368 12 -9 0 16 -5 17 31 12 -5 0 10 12 -5 0 16 3991 -8 17 31 12 -5 0 10 -2 11 5369 -3 11 5368 11 12 -15 0 10 12 -11 0 13 3990 23 5369 12 -5 0 16 3991 -3 17 3991 -2 17 3991 31 12 -260 0 16 -4 17 -2 3991 -3 17 18 -26 0 16 18 -7 0 10 12 -5 0 10 12 -3 0 13 23 12 0 10 12 -5 0 10 30 -6 17 3991 17 18 -15 0 10 12 -5 0 10 12 -6 0 -2 44 0 -2 44 0 -2 44 0 10 12 -5 0 10 30 -5 17 3991 17 18 -15 0 10 12 -10 0 7 22 30 17 31 12 -14 0 10 12 -306 0 10 12 -5 0 10 12 -2 0 7 22 30 18 0 10 12 -5 0 10 12 -24 0 10 12 -5 0 10 12 -6 0 -2 44 0 -2 44 0 -2 44 0 10 12 -5 0 10 12 -23 0 10 12 -10 0 13 23 12 0 10 12 -14 0 10 12 -306 0 10 12 -5 0 10 12 -2 0 13 23 12 -2 0 10 12 -5 0 10 12 -14 0 7 -2 8 9 -5 0 7 22 12 -5 0 10 12 -5 0 7 -9 8 22 12 -5 0 10 12 -13 0 7 -2 8 9 -4 0 7 8 22 12 -5 0 7 9 -2 0 7 22 30 18 0 10 12 -10 0 78 105 78 0 10 12 -283 0 7 -7 8 9 -9 0 44 -4 0 10 12 -5 0 10 12 0 7 22 30 18 -2 0 10 12 -5 0 10 12 -2 0 -3 83 -9 0 13 -2 14 15 -5 0 13 23 12 -5 0 10 12 -5 0 13 3989 14 3990 -6 14 23 12 -5 0 10 12 -13 0 13 3990 14 15 -4 0 13 14 23 12 -5 0 13 15 -2 0 13 23 12 -2 0 10 12 -14 0 10 12 -283 0 13 14 3990 -5 14 15 -5 0 7 9 -7 0 10 12 -5 0 10 12 0 13 23 12 -3 0 10 12 -5 0 10 12 -14 0 10 5368 11 12 -5 0 10 5368 12 -5 0 10 12 -5 0 10 -2 11 5368 5369 -2 5368 -2 11 5368 11 12 -5 0 10 12 -13 0 10 30 17 18 -4 0 16 -2 17 18 -5 0 10 12 0 7 22 30 18 -2 0 10 12 -14 0 10 12 -283 0 10 30 -3 17 -3 3991 18 -5 0 13 15 -5 0 44 0 10 12 -5 0 10 21 8 22 30 18 -3 0 10 12 -5 0 10 12 -14 0 10 30 17 18 -5 0 16 17 18 -5 0 16 18 -5 0 10 30 -9 17 18 -5 0 10 12 -13 0 10 12 -15 0 10 12 0 13 23 12 -3 0 10 12 -7 0 7 9 -5 0 10 12 -265 0 44 -17 0 10 12 -12 0 16 18 -7 0 10 12 -5 0 10 20 14 23 12 -4 0 10 12 -5 0 10 12 -14 0 10 12 -22 0 10 12 -15 0 10 12 -13 0 10 12 -15 0 10 21 8 22 30 18 -3 0 10 12 -7 0 13 15 -2 0 3037 -2 0 10 12 -283 0 10 12 -16 0 44 -4 0 10 12 -5 0 10 11 5369 30 18 -4 0 10 12 -5 0 16 18 -14 0 10 12 -22 0 10 12 -15 0 10 12 -13 0 10 12 -15 0 10 20 14 23 12 -4 0 10 12 -7 0 10 12 -5 0 10 12 -283 0 10 12 -2 0 102 -2 0 7 9 -14 0 10 12 -5 0 10 11 5368 12 -5 0 10 12 -21 0 10 12 -22 0 10 12 -15 0 16 18 -13 0 10 12 -8 0 7 9 -5 0 10 11 5369 30 18 -4 0 10 12 -7 0 10 12 -5 0 10 12 -265 0 44 -15 0 7 8 22 12 -5 0 13 15 -5 0 7 9 -7 0 10 12 -5 0 10 5369 30 18 -5 0 16 18 -21 0 10 21 -9 8 9 -5 0 7 9 -5 0 10 21 -9 8 9 -20 0 10 21 -8 8 114 15 -5 0 10 11 5369 12 -5 0 10 12 -5 0 7 8 22 12 -5 0 10 12 -281 0 13 3989 23 12 -5 0 10 12 -5 0 13 113 -7 8 22 12 -5 0 10 11 12 -29 0 10 20 -2 14 3990 14 3989 3990 -3 14 15 -5 0 13 15 -5 0 10 20 -9 14 15 -20 0 10 20 -7 14 3990 23 12 -5 0 10 5369 30 18 -5 0 10 12 -5 0 13 3990 23 12 -5 0 10 12 -281 0 16 3991 17 18 -5 0 16 18 -5 0 10 20 -7 14 23 12 -5 0 16 17 18 -29 0 16 -4 17 3991 17 3991 -3 17 18 -5 0 10 12 -5 0 16 -3 17 3991 -3 17 3991 17 3991 18 -20 0 16 -10 17 18 -5 0 10 5368 12 -6 0 10 12 -5 0 16 -2 17 18 -5 0 16 18 -265 0 44 -31 0 16 -4 17 3991 -4 17 18 -54 0 16 18 -54 0 16 17 18 -6 0 16 18 -456 0 44 -714 0 44 -34 0 78 -3 83 78 -114 0 128 -465 0 44 -714 0 44 -619 0 44 -714 0 44 -619 0 44 -714 0 44 -1218 0 -2 83 0 -2 83 -111 0 44 -405 0 105 -3 0 105 -668 0 2947 -137 0 7 -7 8 9 -20 0 7 -7 8 9 -21 0 7 -2 8 9 -5 0 7 -2 8 9 -24 0 7 -10 8 9 -317 0 7 9 -11 0 7 9 -5 0 13 3990 -2 14 3990 -2 14 3989 15 -5 0 7 9 -13 0 13 3990 -6 14 15 -5 0 7 9 -7 0 7 9 -5 0 13 3989 14 15 -5 0 13 -2 14 15 -5 0 7 -7 8 9 -10 0 13 14 3988 -2 14 3990 -5 14 15 -5 0 7 9 -7 0 7 9 -301 0 13 15 -11 0 13 15 -5 0 10 30 -3 17 3991 17 3991 18 -5 0 13 15 -13 0 10 30 -3 17 -2 3991 17 18 -5 0 13 15 -5 0 44 0 13 15 -5 0 10 11 5369 12 -5 0 10 11 5369 12 -5 0 13 -2 3989 14 -2 3988 14 3990 15 -10 0 10 -3 11 5369 -2 11 -2 5369 11 5368 12 -5 0 13 15 -7 0 13 15 -176 0 7 -44 8 -8 0 2909 2910 -7 8 2913 2914 -61 0 10 12 -11 0 16 18 -5 0 16 18 -12 0 10 12 -13 0 10 12 -12 0 10 12 -7 0 10 12 -5 0 10 -2 11 12 -5 0 10 -2 11 12 -5 0 10 30 17 3991 -3 17 3991 18 -10 0 16 -2 17 3991 17 31 30 -4 17 18 -5 0 10 12 -7 0 10 12 -176 0 13 -4 14 3989 -4 14 3989 -7 14 3990 -6 14 -2 3990 -8 14 3988 -9 14 -6 0 3141 3142 2911 2912 -7 14 2915 2916 1832 1827 -59 0 10 12 -32 0 10 12 -13 0 10 12 -12 0 10 12 0 44 -5 0 10 12 -5 0 10 30 17 18 -5 0 16 17 31 12 -5 0 10 12 -22 0 10 12 -10 0 10 12 -7 0 10 12 -176 0 5370 11 -3 5368 -4 11 5369 -3 5368 5369 11 5368 -3 11 5368 -7 11 5368 11 5368 11 5368 11 -2 5369 5368 -2 5369 5368 -3 11 5369 11 5369 -5 0 1837 3145 3146 1834 -2 11 5368 -6 11 1835 1836 1831 1832 1827 -57 0 10 12 -5 0 102 -26 0 10 12 -13 0 16 18 -12 0 10 12 -7 0 10 12 -5 0 10 12 -9 0 10 12 -5 0 10 12 0 -2 44 -19 0 10 12 -10 0 10 12 -7 0 10 12 -176 0 2934 2925 2926 -5 11 5369 -2 11 5368 -4 11 5368 -3 11 5368 -2 11 5368 11 5368 -2 11 5369 -2 11 5368 11 5368 -4 11 5368 -2 11 5369 5368 -2 11 -4 0 1837 1839 3148 -2 11 2929 2930 -6 17 2925 2926 11 1835 1836 1831 2917 2918 9 -54 0 10 12 -11 0 7 9 -5 0 7 -2 8 9 -10 0 10 12 -3 0 -2 83 -22 0 10 12 -5 0 44 0 10 12 -5 0 10 12 -9 0 10 12 -5 0 10 12 0 -2 44 -19 0 10 12 -10 0 10 12 -7 0 10 12 -178 0 2928 17 2925 2926 -5 11 5369 11 5368 -3 11 5368 -3 11 5368 11 5368 -2 11 5368 11 5369 5368 -2 11 19 5368 11 -2 5369 5368 -4 11 5368 -2 11 -3 0 3150 1839 1841 -2 11 2940 2931 -8 0 2928 2925 2926 11 1835 2919 2920 15 -54 0 16 18 -11 0 13 15 -5 0 13 3989 14 113 8 9 -8 0 10 12 -27 0 16 18 -7 0 10 12 -5 0 10 12 -9 0 10 12 -5 0 10 21 -3 8 9 -18 0 10 12 -10 0 10 12 -7 0 10 12 -181 0 2928 17 2925 2926 -5 11 5369 -3 11 5368 -4 11 5369 -3 11 5369 11 5369 11 5369 -2 11 5369 -2 11 5368 -3 11 5369 11 5368 5369 -2 0 3153 3154 1841 -3 11 2941 -11 0 2928 2925 2926 11 2929 5373 -60 0 7 8 9 -4 0 10 12 -5 0 10 5369 11 20 14 15 -8 0 10 12 -13 0 7 9 -15 0 44 -5 0 10 12 -5 0 10 12 -9 0 10 12 -5 0 10 20 -3 14 15 -18 0 10 12 -10 0 10 12 -7 0 10 12 -184 0 2928 17 2925 2926 -2 11 5368 -4 11 5368 -2 11 5368 11 5368 -2 11 -2 5368 -2 11 5369 -3 11 5368 -5 11 5369 11 5368 5369 1826 1829 3157 3158 -3 11 30 2942 -13 0 2928 17 2931 -61 0 13 14 15 -4 0 10 12 -5 0 10 30 17 3991 17 18 -8 0 10 12 -13 0 13 15 -21 0 10 12 -5 0 10 12 -9 0 10 12 -5 0 10 -3 11 5369 12 -18 0 10 12 -10 0 10 12 -7 0 10 12 -187 0 2928 2933 11 -2 5368 -4 11 5369 5368 5369 -2 11 5368 11 5369 5368 11 5369 -3 11 -2 5368 11 5369 -2 11 5369 11 5369 -2 11 1830 1833 1834 -3 11 5368 12 -72 0 7 9 -4 0 16 17 18 -4 0 10 12 -5 0 10 12 0 -2 44 -9 0 16 18 -2 0 -2 78 -2 105 -7 0 10 12 -12 0 7 9 -7 0 10 12 -5 0 10 12 -9 0 10 12 -5 0 10 30 17 3991 17 18 -18 0 10 12 -10 0 10 12 -3 0 3037 -3 0 10 12 -188 0 2934 2925 2926 11 5368 5369 -2 11 5368 -7 11 5369 11 5369 -2 11 5369 -2 11 5368 -3 11 5369 11 5368 5369 11 1834 -5 11 5369 21 -22 8 9 -49 0 13 15 -11 0 10 12 -5 0 10 12 0 -2 44 -24 0 10 12 -12 0 13 15 -7 0 10 12 -5 0 10 12 -9 0 10 12 -5 0 10 12 0 -2 44 -19 0 10 12 -10 0 10 12 -7 0 10 12 -190 0 2928 2933 11 5368 11 -2 5368 11 -2 5369 -4 11 -2 5368 -3 11 5369 11 5369 11 -2 5369 5368 11 5368 -10 11 20 3990 -4 14 3990 -3 14 3989 -2 14 3990 -2 14 3990 -6 14 15 -49 0 10 12 0 44 0 44 0 44 0 44 0 44 0 10 12 -5 0 10 21 -6 8 9 -20 0 10 21 -6 8 9 -5 0 10 12 -7 0 10 12 -5 0 10 12 -9 0 10 12 -5 0 10 12 0 -2 44 -19 0 10 12 -10 0 10 12 -7 0 10 12 -191 0 2934 2933 11 5368 -3 11 -2 5368 11 5369 -2 11 19 -3 11 5369 -3 11 5368 -2 5369 5368 11 5368 5369 -3 11 5369 -2 11 5368 5369 5368 -3 11 5368 -4 11 5368 11 5369 -2 11 5369 -2 11 5369 -2 11 5368 -3 11 5371 -49 0 10 21 -11 8 22 12 -5 0 10 20 -6 14 15 -5 0 7 -8 8 9 -5 0 10 20 -6 14 15 -5 0 10 21 -7 8 22 12 -5 0 10 12 -9 0 10 12 -5 0 10 21 -6 8 9 -15 0 10 12 -10 0 10 21 -7 8 22 12 -192 0 2934 2925 2926 11 -2 5368 5369 5368 11 5368 5369 5368 5369 5368 -2 11 5369 -2 11 5368 -5 11 5369 -6 11 5369 11 5368 -2 11 5369 -4 11 5369 11 5368 -8 11 5368 5369 -2 11 2929 2930 2936 -49 0 10 20 -11 14 23 12 -5 0 10 5369 11 5369 -2 11 5369 11 12 -5 0 13 -8 14 15 -5 0 10 -2 11 5368 5369 5368 -2 11 12 -5 0 10 20 -7 14 23 12 -5 0 10 12 -9 0 10 12 -5 0 10 20 3990 -5 14 15 -15 0 10 12 -10 0 10 20 -2 14 3988 -4 14 23 12 -194 0 2928 2933 -5 11 -2 5369 -8 11 5368 -3 11 5369 11 5368 5369 -4 11 -2 5368 11 5368 -3 11 5368 -3 11 5368 -2 5369 5368 -3 11 5368 -4 11 2929 2930 17 2931 -51 0 10 -2 5369 -2 11 -2 5369 11 5368 11 5368 5369 -2 11 12 -5 0 16 3991 -3 17 3991 -2 17 18 -5 0 10 -8 11 12 -5 0 16 -4 17 3991 17 3991 18 -5 0 10 5369 -2 11 5368 5369 -2 11 5368 11 12 -5 0 16 18 -9 0 16 18 -5 0 10 -6 11 5368 12 -15 0 16 18 -10 0 10 -5 11 5369 -2 11 5368 12 -195 0 2934 2933 -2 11 5369 5368 -7 11 5368 5369 5368 -6 11 5369 -4 11 -2 5369 11 5368 -4 11 5369 11 -3 5368 -2 11 5368 -5 11 2929 2930 17 2931 -54 0 16 -13 17 18 -19 0 16 17 3991 -3 17 3991 -2 17 18 -19 0 16 -9 17 18 -23 0 16 -7 17 18 -27 0 16 17 3991 -5 17 3991 17 18 -196 0 2934 2937 11 5369 5368 5369 5368 11 5369 -3 11 -2 5368 11 5369 -3 11 5368 -2 11 5368 5369 -7 11 5368 -6 11 5368 -2 11 5368 5369 11 2929 2930 17 2931 -398 0 2938 -2 11 5368 5369 5368 5369 5368 -2 11 5368 -2 11 5368 -4 11 5369 11 5368 5369 -9 11 5368 -2 5369 5368 -2 11 -4 5369 11 2935 2931 -401 0 2939 2933 -3 11 -2 5369 5368 -2 5369 11 -2 5368 11 -3 5369 5368 11 5369 -2 11 -4 5368 11 -2 5369 11 5369 11 5369 11 5369 -3 11 5368 11 2929 2930 2936 -403 0 2934 2937 11 5369 -5 11 5368 5369 5368 11 -3 5369 5368 11 5368 -2 11 5368 5369 5368 11 -2 5368 11 -2 5368 11 5369 -3 11 5368 -2 11 2935 2931 -406 0 2938 11 5369 -2 11 5368 5369 5368 -3 11 5369 -4 11 5368 -2 11 5369 -2 11 5369 -2 11 5368 5369 5368 11 5368 -2 5369 -4 11 2935 2936 -407 0 2939 2933 -3 11 -2 5369 5368 -3 11 5368 -3 11 5369 -3 11 5368 -2 11 -2 5369 -3 11 5369 -3 11 5368 5369 11 2929 2930 2936 -409 0 2934 2937 11 5369 -6 11 5369 -4 11 5368 11 5368 -2 11 -2 5369 11 5368 11 5369 -2 11 5368 -3 11 2935 2931 -412 0 2938 11 5368 -2 11 5368 -2 11 5369 11 5368 -2 5369 5368 11 5369 11 5369 11 5369 -2 11 5369 -3 11 5369 -3 11 2935 2936 -413 0 2939 2937 -3 11 5368 -2 11 5369 11 5368 -2 5369 5368 -2 11 5368 11 5368 -2 11 5369 -3 11 5368 -2 5369 11 2940 2936 -415 0 2938 -7 11 5369 -5 11 5368 11 5369 -3 11 -2 5368 11 5369 11 5369 5368 11 2941 -416 0 2939 2933 -2 11 5369 -4 11 5369 -3 11 5369 5368 -2 11 5368 -7 11 5369 11 2935 2942 -417 0 2934 2937 11 5369 -3 11 5368 -6 11 5369 5368 -7 11 5368 11 2940 2936 -419 0 2938 -2 11 5368 5369 5368 11 5368 -5 11 -2 5369 5368 -2 11 -2 5369 -4 11 2941 -420 0 2939 2937 11 -2 5368 -2 11 5368 -12 11 5368 5369 11 2935 2942 -421 0 2938 11 -3 5369 -3 11 5369 -7 11 5368 11 -2 5368 11 2940 2936 -422 0 2939 2937 -4 11 5369 11 5368 -3 11 19 5368 5369 11 5368 -2 11 5369 11 2941 -424 0 2938 -5 11 5368 -2 11 5368 -2 11 5368 5369 11 -2 5369 5368 11 2940 2942 -424 0 2939 2937 11 -2 5369 5368 11 5369 11 5368 -5 11 5369 5368 -2 11 2941 -426 0 2938 11 -3 5368 -2 11 1539 11 5368 11 5368 -2 11)
    )
    (tilemap
      (solid #f)
      (z-pos 100)
      (width 445)
      (height 90)
      (tiles -23111 0 130 -444 0 129 -444 0 129 -444 0 129 -444 0 129 -444 0 129 -444 0 4967 -14268 0)
    )
    (tilemap
      (solid #f)
      (z-pos -110)
      (width 445)
      (height 90)
      (tiles -10088 0 2052 -5 2053 2054 -49 0 2052 2054 -325 0 2052 2054 -5 0 2052 2054 -5 0 2052 -8 2053 2054 -38 0 2062 -5 2063 2064 -49 0 2057 2059 -15 0 2052 2054 -16 0 2052 2054 -290 0 2057 2059 -5 0 2057 2059 -5 0 2057 2050 -7 2063 2064 -31 0 2052 2054 -61 0 2057 2059 -15 0 2057 2059 -16 0 2057 2059 -290 0 2057 2059 -5 0 2057 2059 -5 0 2057 2059 -39 0 2057 2059 -61 0 2057 2059 -15 0 2057 2059 -16 0 2057 2059 -290 0 2057 2059 -5 0 2057 2059 -5 0 2057 2059 -39 0 2057 2059 -61 0 2057 2059 -15 0 2057 2059 -16 0 2057 2059 -290 0 2057 2059 -5 0 2057 2059 -5 0 2057 2059 -39 0 2057 2059 -61 0 2057 2059 -15 0 2057 2059 -16 0 2057 2059 -290 0 2057 2059 -5 0 2057 2059 -5 0 2057 2059 -39 0 2057 2059 -8 0 2052 -5 2053 2054 -46 0 2062 2064 0 2052 -5 2053 2054 2052 2054 -5 0 2062 2064 -16 0 2057 2059 -290 0 2062 2064 -5 0 2057 2059 -5 0 2057 2059 -39 0 2057 2059 -8 0 2062 -5 2063 2064 -7 0 2052 2054 -40 0 2062 -5 2063 2064 2057 2059 -23 0 2057 2059 -297 0 2057 2059 -5 0 2057 2059 -39 0 2057 2059 -22 0 2057 2059 -47 0 2057 2059 -23 0 2057 2059 -297 0 2057 2059 -5 0 2057 2059 -30 0 2052 2054 -7 0 2057 2059 -22 0 2057 2059 -47 0 2057 2059 -23 0 2062 2064 -297 0 2057 2059 -5 0 2057 2059 -30 0 2057 2059 -7 0 2057 2059 -22 0 2057 2059 -22 0 2052 2054 -23 0 2057 2059 -322 0 2057 2059 -5 0 2057 2059 -23 0 2052 2054 -5 0 2057 2059 -7 0 2057 2059 -22 0 2057 2059 -22 0 2057 2059 -23 0 2057 2059 -316 0 2052 -5 2053 2056 2059 -5 0 2057 2059 -23 0 2057 2059 -5 0 2057 2059 -7 0 2057 2059 -22 0 2057 2059 -22 0 2057 2059 -23 0 2062 2064 -24 0 2052 -5 2053 2054 -285 0 2062 -6 2063 2064 -5 0 2062 2064 -23 0 2057 2059 -5 0 2057 2059 -7 0 2057 2059 -22 0 2062 2064 -22 0 2057 2059 -49 0 2062 -5 2063 2064 -323 0 2062 2064 -5 0 2062 2064 -7 0 2062 2064 -46 0 2062 2064 -9097 0 2052 2054 -5 0 2052 2054 -42 0 2052 -7 2053 2054 -61 0 2052 -7 2053 2054 -315 0 2057 2059 -5 0 2057 2059 -42 0 2062 -7 2063 2064 -9 0 2052 2053 2054 0 2052 2053 2054 -45 0 2062 -7 2063 2064 -315 0 2057 2059 -5 0 2057 2059 -27 0 2052 2054 -31 0 2062 2051 2059 0 2057 2050 2064 -286 0 2185 -7 2199 2186 -74 0 2057 2059 -5 0 2057 2059 -27 0 2057 2059 -32 0 2057 2055 2053 2056 2059 -285 0 2185 2199 2200 2181 2180 2179 2180 2189 2197 2189 2198 2199 2186 -59 0 2052 2054 -11 0 2057 2059 -5 0 2057 2059 -27 0 2057 2059 -12 0 2052 2054 -18 0 2062 2051 2070 2050 2064 -284 0 2185 2200 2196 2182 2183 2184 2181 2180 2182 2183 2184 -2 2187 2198 2199 2186 -57 0 2057 2059 -11 0 2062 2064 -5 0 2062 2064 0 2052 2053 2054 -23 0 2057 2059 -12 0 2057 2059 -19 0 2062 2063 2064 -285 0 2192 2195 2179 2190 0 2192 2195 2188 2190 0 2192 2179 -2 2197 2181 2198 2186 -56 0 2057 2059 -21 0 2062 2063 2064 -23 0 2057 2059 -12 0 2057 2059 -306 0 2185 2200 2180 2181 2190 0 2192 2180 2195 2190 0 2192 2196 2188 2181 2187 2182 2194 -56 0 2057 2059 -4 0 2052 2053 2054 -25 0 2052 2054 -13 0 2062 2064 -12 0 2057 2059 -306 0 2192 2179 2197 2195 2198 2199 2200 2196 2180 2198 2199 2200 2195 2180 -2 2179 2190 -57 0 2057 2059 -4 0 2057 2058 2059 -25 0 2057 2059 -27 0 2057 2059 -306 0 2192 2179 2187 2181 2197 2195 2187 2195 2197 2180 2196 2195 2196 2180 -2 2196 2198 2186 -56 0 2062 2064 -4 0 2057 2070 2059 -25 0 2057 2059 -27 0 2062 2064 -306 0 2193 -16 2183 2194 -62 0 2057 2058 2059 -25 0 2057 2059 -415 0 2057 2060 2059 -25 0 2057 2059 -415 0 2062 2063 2064 -25 0 2062 2064 -9229 0)
    )
    (tilemap
      (solid #t)
      (z-pos 10)
      (name "upside_barrier")
      (width 445)
      (height 90)
      (tiles -17637 0 -2 1311 -462 0 -6 1311 -413 0 -2 1311 -21528 0)
    )
    (tilemap
      (solid #t)
      (z-pos -1)
      (width 445)
      (height 90)
      (tiles -10155 0 4105 4106 -19 0 4104 4105 -373 0 4105 4106 -47 0 4110 4111 -14 0 4105 4106 -3 0 4114 4115 -373 0 4110 4111 -23 0 -8 5401 -16 0 4110 4111 -12 0 5401 0 4110 4111 -378 0 4110 4111 -23 0 -8 5405 -16 0 4110 4111 -12 0 5405 0 4110 4111 -378 0 4110 4111 -47 0 4110 4111 -11 0 5401 -2 0 4115 4116 -320 0 4104 4105 -56 0 4110 4111 -47 0 4110 4111 -11 0 5405 -324 0 4109 4110 -41 0 4105 4106 -3 0 4104 4105 -8 0 4110 4111 -47 0 4115 4116 -10 0 5401 -325 0 4109 4110 -41 0 4115 4116 -3 0 4114 4115 -8 0 4115 4116 -3 0 4104 4105 -54 0 5405 -325 0 4109 4110 -61 0 4109 4110 -53 0 5401 -326 0 4109 4110 -61 0 4109 4110 -53 0 5405 -326 0 4109 4110 -61 0 4109 4110 -52 0 5401 -327 0 4114 4115 -61 0 4109 4110 -52 0 5405 -390 0 4114 4115 -51 0 5401 -322 0 -7 5400 -63 0 -12 5401 -20 0 -12 5401 -8 0 5405 -322 0 -7 5404 -63 0 -12 5405 -20 0 -12 5405 -8248 0 -4 5400 -5 0 -4 5400 -432 0 -4 5404 -5 0 -4 5404 -417 0 4105 4106 -5 0 4104 4105 -436 0 4110 4111 -5 0 4109 4110 -436 0 4110 4111 -5 0 4109 4110 -436 0 4110 4111 -5 0 4109 4110 -436 0 4115 4116 -5 0 4109 4110 -443 0 4109 4110 -443 0 4109 4110 -443 0 4114 4115 -1313 0 -7 5400 -438 0 -7 5404 -7 0 -7 5400 -438 0 -7 5404 -9193 0)
    )
    (unstable_tile
      (z-pos 0)
      (x 4256)
      (y 2048)
    )
    (unstable_tile
      (z-pos 0)
      (x 4288)
      (y 2048)
    )
    (unstable_tile
      (z-pos 0)
      (x 4320)
      (y 2048)
    )
    (unstable_tile
      (z-pos 0)
      (x 11008)
      (y 1024)
    )
    (unstable_tile
      (z-pos 0)
      (x 10976)
      (y 1024)
    )
    (unstable_tile
      (z-pos 0)
      (x 11104)
      (y 896)
    )
    (unstable_tile
      (z-pos 0)
      (x 11136)
      (y 896)
    )
    (unstable_tile
      (z-pos 0)
      (x 11936)
      (y 672)
    )
    (unstable_tile
      (z-pos 0)
      (x 11968)
      (y 672)
    )
    (unstable_tile
      (z-pos 0)
      (x 12064)
      (y 576)
    )
    (unstable_tile
      (z-pos 0)
      (x 12096)
      (y 576)
    )
    (unstable_tile
      (z-pos 0)
      (x 12224)
      (y 576)
    )
    (unstable_tile
      (z-pos 0)
      (x 12256)
      (y 576)
    )
    (walkingleaf
      (z-pos 50)
      (x 9184)
      (y 864)
      (glinting #t)
    )
    (walkingleaf
      (z-pos 50)
      (x 12576)
      (y 832)
      (glinting #t)
    )
  )
)
