; Generated by Flexlay Editor
(supertux-worldmap
  (properties
    (name (_ "Bonus Island I"))
    (music "music/salcon.ogg")
  )
  (spawnpoint
    (name "main")
    (x 35)
    (y 2)
  )
  (tilemap
    (width 70)
    (height 50)
    (layer "interactive")
    (solid #t)
    (speed 1.000000)
    (tiles 9 9 9 9 9 9 9 9 9 9 9 9 9 9 9 9 9 9 9 9 9 9 9 9 9 9 9 9 9 9 9 11 16 16 16 16 16 16 16 12 9 9 9 9 9 9 9 9 9 9 9 9 9 9 9 9 9 9 9 9 9 9 9 9 9 9 9 9 9 9 9 9 9 9 9 9 9 9 9 9 9 9 9 9 9 9 9 9 9 9 9 9 9 9 9 9 9 9 9 9 9 15 24 25 26 58 24 26 19 17 9 9 9 9 9 9 9 9 9 9 9 9 9 9 9 9 9 9 9 9 9 9 9 9 9 9 9 9 9 9 9 9 9 9 9 9 9 9 9 9 9 9 9 9 9 9 9 9 9 9 9 9 9 9 9 9 9 9 9 9 9 15 30 29 28 59 31 27 19 17 9 9 9 9 9 9 9 9 9 9 9 9 9 9 9 9 9 9 9 9 9 9 9 9 9 9 9 9 9 9 9 9 9 9 9 9 9 9 9 9 9 9 9 9 9 9 9 9 9 9 9 9 9 9 9 9 9 9 9 11 16 22 19 19 19 47 30 28 19 23 16 12 9 9 9 9 9 9 9 9 9 9 9 9 9 9 9 9 9 9 9 9 9 9 9 9 9 9 9 9 9 9 9 9 9 9 9 9 9 9 9 9 9 9 9 9 9 9 9 9 9 9 9 9 9 9 9 9 9 15 19 19 19 19 60 47 60 19 19 19 19 17 9 9 9 9 9 9 9 9 9 9 9 9 9 9 9 9 9 9 9 9 9 9 9 9 9 9 9 9 9 9 9 9 9 9 9 9 9 9 9 9 9 9 9 9 9 9 9 9 9 9 9 9 9 9 9 9 9 15 19 48 40 43 40 45 40 43 40 39 19 17 9 9 9 9 9 9 9 9 9 9 9 9 9 9 9 9 9 9 9 9 9 9 9 9 9 9 9 9 9 9 9 9 9 9 9 9 9 9 9 9 9 9 9 9 9 9 9 9 9 9 9 9 9 9 9 9 9 15 19 47 19 47 19 47 19 47 19 47 19 17 9 9 9 9 9 9 9 9 9 9 9 9 9 9 9 9 9 9 9 9 9 9 9 9 9 9 9 9 9 9 9 9 9 9 9 9 9 9 9 9 9 9 9 9 9 9 9 9 9 9 9 9 9 9 9 9 9 15 19 47 19 47 19 47 19 47 19 47 19 17 9 9 9 9 9 9 9 9 9 9 9 9 9 9 9 9 9 9 9 9 9 9 9 9 9 9 9 9 9 9 9 9 9 9 9 9 9 9 9 9 9 9 9 9 9 9 9 9 9 9 9 9 9 9 9 9 9 15 19 68 19 68 19 68 19 68 19 68 19 17 9 9 9 9 9 9 9 9 11 16 12 9 9 9 9 9 9 9 9 9 9 9 9 9 9 9 9 9 9 9 9 9 9 9 9 9 9 9 9 9 9 9 9 9 9 9 9 9 9 9 9 9 9 9 9 9 9 14 18 18 18 18 18 18 18 18 18 18 18 13 9 9 9 9 9 9 9 9 15 58 17 9 9 9 9 9 9 9 9 9 9 9 9 9 9 9 9 9 9 9 9 9 9 9 9 9 9 9 9 9 9 9 9 11 16 12 9 9 9 9 9 9 11 12 9 9 9 9 9 9 9 9 9 9 9 9 9 9 9 9 9 9 9 9 9 9 9 11 22 59 23 12 9 9 9 9 9 9 9 9 9 9 9 9 9 9 9 9 9 9 9 9 9 9 9 9 9 9 9 9 9 9 9 14 18 13 9 9 9 9 9 9 15 23 12 9 9 9 9 9 9 9 9 9 9 9 9 9 9 9 11 16 12 9 9 9 9 15 60 47 60 17 9 9 9 9 11 12 9 9 9 9 9 9 9 9 9 9 9 9 9 9 9 9 9 9 9 9 9 9 9 9 9 9 9 9 9 11 16 12 9 9 15 19 17 9 9 9 9 9 9 9 9 9 9 9 9 9 9 9 15 19 17 9 9 9 9 14 21 47 20 13 9 9 11 16 22 23 12 9 9 9 9 9 9 9 9 9 9 9 9 9 9 9 9 9 9 9 9 9 9 9 9 9 9 9 9 15 58 17 9 9 14 18 13 9 9 9 9 9 9 9 9 9 9 9 9 9 9 9 15 19 23 12 9 9 11 16 22 47 23 16 12 9 14 21 20 18 13 9 9 9 9 9 9 9 9 9 9 9 9 9 9 9 9 9 9 9 9 9 9 9 9 9 11 16 16 22 59 23 16 16 16 16 12 9 9 9 9 9 9 9 9 9 9 9 9 9 9 9 14 18 18 13 9 9 15 19 19 47 19 19 17 9 9 14 13 9 9 9 9 9 9 9 9 9 9 9 9 9 9 9 9 9 9 9 9 9 9 9 9 9 9 9 15 19 19 19 47 19 19 48 40 39 17 9 9 9 11 12 9 9 9 9 9 9 9 9 9 9 9 9 9 9 9 9 14 21 19 37 40 39 23 16 12 9 9 9 9 9 9 9 9 9 9 9 9 9 9 9 9 9 9 9 9 9 9 9 9 9 9 9 9 9 14 18 21 19 47 19 19 47 19 47 17 9 9 9 14 13 9 11 16 12 9 9 9 9 9 9 9 9 9 9 9 9 9 15 19 19 19 47 19 20 13 9 9 9 9 9 9 9 9 9 9 9 9 9 9 9 9 9 9 9 9 9 9 9 9 9 9 9 9 9 9 9 14 21 37 40 40 42 19 47 17 9 9 9 9 9 9 15 58 17 9 9 9 9 9 9 9 9 9 11 16 16 16 22 19 19 19 47 19 23 12 9 9 9 9 9 9 9 9 9 9 9 9 9 9 9 9 9 9 9 9 9 9 9 9 9 9 9 9 9 9 11 16 22 19 60 19 19 19 47 17 9 9 9 9 11 16 22 59 23 16 12 9 9 9 9 9 9 9 15 48 40 40 40 40 39 19 37 40 39 23 12 9 9 9 9 9 9 9 9 9 9 9 9 9 9 9 9 9 9 9 9 9 9 9 9 9 9 9 9 11 22 19 19 19 19 19 19 19 47 17 9 9 9 9 15 19 19 47 19 19 23 12 9 9 9 9 9 9 15 47 19 19 19 19 47 19 19 19 47 19 17 9 9 9 9 9 9 9 9 9 9 9 9 9 9 9 9 9 9 9 9 9 9 9 9 11 16 12 9 15 48 40 40 40 40 40 40 40 42 17 9 9 9 9 14 21 19 37 40 40 39 17 9 9 9 9 9 9 15 47 19 19 19 19 37 40 40 40 42 19 17 9 9 9 9 9 9 9 9 9 9 9 9 9 9 9 9 9 9 9 9 9 9 9 9 15 19 17 9 15 47 19 19 19 19 20 21 19 20 13 9 9 9 9 9 14 21 19 19 19 47 17 9 9 9 9 9 9 15 37 40 39 19 19 19 19 19 19 19 19 17 9 9 9 9 9 9 9 9 9 9 9 9 9 9 9 9 9 9 9 9 9 9 9 9 14 18 13 9 15 37 40 39 19 20 13 14 18 13 9 9 9 9 9 9 9 15 19 19 19 47 17 9 9 9 9 9 9 15 19 19 37 40 40 40 40 40 39 19 20 13 9 9 9 9 9 9 9 9 9 9 9 9 9 9 9 9 9 9 9 9 9 9 9 9 9 9 9 9 14 18 21 47 20 13 9 9 9 9 9 9 9 9 9 9 9 15 19 48 40 42 23 12 9 9 9 9 9 14 21 19 19 19 20 18 18 21 47 20 13 9 9 9 9 9 9 9 9 9 9 9 9 9 9 9 9 9 9 9 9 9 9 9 9 9 9 9 9 9 9 9 15 68 17 9 9 9 9 9 9 9 9 9 9 9 9 14 21 47 19 19 19 17 9 9 9 9 9 9 14 18 18 18 13 9 9 15 47 17 9 9 9 9 9 9 9 9 9 9 9 9 9 9 9 9 9 9 9 9 9 9 9 9 9 9 9 9 9 9 9 9 14 18 13 9 9 9 9 9 9 9 9 9 9 9 9 9 15 47 20 18 18 13 9 9 9 9 9 9 9 9 9 9 9 9 9 15 68 17 9 9 9 9 9 9 9 9 9 9 9 9 9 9 9 9 9 9 9 9 9 9 9 11 16 12 9 9 9 9 9 9 9 9 9 9 9 9 11 16 16 12 9 9 9 9 9 9 15 68 17 9 9 9 9 9 9 9 9 9 9 9 9 9 9 9 9 14 18 13 9 9 9 9 9 9 9 9 9 9 9 9 9 9 9 9 9 9 9 9 9 9 9 14 21 17 9 9 9 9 9 9 9 9 9 9 9 9 14 21 20 13 9 9 9 9 9 9 14 18 13 9 9 9 9 9 9 9 9 9 9 9 9 9 9 9 9 9 9 9 9 9 11 16 16 12 9 9 9 9 9 9 9 9 9 9 9 9 9 9 9 9 9 9 14 13 9 9 9 9 9 9 9 9 9 9 9 9 9 14 13 9 9 9 9 9 9 9 9 9 9 9 9 9 11 16 16 12 9 9 9 9 9 9 9 9 9 9 9 9 9 9 15 19 19 17 9 9 9 9 9 9 9 9 9 9 9 9 9 9 9 9 9 9 9 9 9 9 11 16 12 9 9 9 9 9 9 9 9 9 9 9 9 9 11 16 12 9 9 9 9 9 9 9 15 19 19 23 12 9 9 9 9 9 9 9 9 9 9 9 9 9 15 19 20 13 9 9 9 9 9 9 9 9 9 9 9 9 9 9 9 9 9 9 11 16 12 9 15 58 17 9 9 9 9 9 9 9 9 9 9 9 9 9 15 19 17 9 9 9 9 9 9 9 15 19 19 19 17 9 9 9 9 9 9 9 9 9 9 9 9 9 14 18 13 9 9 9 9 9 9 9 9 9 9 9 9 9 9 9 9 9 9 11 22 19 23 12 15 59 23 16 16 12 9 9 9 9 9 9 9 9 9 9 14 18 13 9 9 9 9 9 9 9 14 21 19 20 13 9 9 9 9 9 9 9 9 9 9 11 16 12 9 9 9 9 9 9 9 9 9 9 9 9 9 9 9 9 9 9 9 9 9 15 19 19 19 23 22 47 48 40 39 17 9 9 9 9 9 9 9 9 9 9 9 9 9 9 9 9 9 9 9 9 9 15 19 17 9 9 9 9 9 9 9 9 9 9 9 15 58 17 9 9 9 9 9 9 9 9 9 9 9 9 9 9 9 9 9 9 9 9 9 15 19 48 40 40 40 42 47 19 47 17 9 9 9 11 16 12 9 9 9 9 9 9 9 9 9 9 9 9 9 9 9 14 18 13 9 9 9 9 9 9 9 9 9 9 11 22 59 23 16 16 16 16 16 12 9 9 9 9 9 9 9 9 9 9 9 9 9 9 9 14 21 47 19 19 60 19 47 19 47 23 12 9 9 14 18 13 9 9 9 9 9 9 9 9 9 9 9 9 9 9 9 9 9 9 9 9 9 9 9 9 9 9 11 16 22 19 37 40 40 40 39 19 19 17 9 9 9 9 9 9 9 9 9 9 9 9 9 9 9 9 15 37 40 40 40 40 42 19 47 19 17 9 9 9 9 9 9 9 9 9 9 11 16 12 9 9 9 9 9 9 9 9 9 9 9 9 9 9 9 9 9 9 15 24 25 25 26 19 19 19 47 19 19 17 9 9 9 9 9 9 9 9 9 9 9 9 9 9 9 9 15 19 19 19 19 24 25 26 47 19 17 9 9 9 9 9 9 9 9 9 9 15 58 17 9 9 9 9 9 9 9 9 9 9 9 9 9 9 9 9 9 9 15 31 32 32 27 48 40 40 42 19 20 13 9 9 9 9 9 9 9 9 9 9 9 9 9 9 9 9 15 19 19 19 19 30 29 28 47 20 13 9 9 9 9 9 9 9 9 9 9 15 59 17 9 9 9 9 9 9 9 9 9 9 9 9 9 9 9 9 9 9 15 30 29 29 28 47 19 19 20 18 13 9 9 9 9 9 9 9 9 9 9 9 9 9 9 9 9 9 14 21 48 40 40 40 40 40 42 17 9 9 9 9 9 9 11 16 16 16 16 22 47 17 9 9 9 9 9 9 9 9 9 11 16 16 12 9 9 9 9 9 14 18 21 19 19 47 19 19 23 12 9 9 9 9 9 9 9 9 9 9 9 9 9 9 9 9 9 11 16 22 47 19 19 19 19 19 19 17 9 9 9 9 9 9 15 69 40 40 40 40 61 64 63 63 63 63 63 63 63 63 63 62 67 19 23 12 9 9 9 9 9 9 14 21 19 47 19 19 19 23 12 9 9 9 9 9 9 9 9 9 9 9 9 9 9 9 9 15 19 19 37 40 40 40 40 40 39 17 9 9 9 9 9 9 14 18 18 18 18 21 47 17 9 9 9 9 9 9 9 9 9 15 19 19 19 17 9 9 9 9 9 9 9 15 19 37 40 40 39 19 17 9 9 9 9 9 9 9 9 9 9 9 9 9 9 9 9 14 21 19 19 19 19 19 19 19 47 23 12 9 9 9 9 9 9 9 9 9 9 15 47 17 9 9 9 9 9 9 9 9 9 14 18 18 18 13 9 9 9 9 9 9 9 15 19 19 19 19 47 19 17 9 9 9 9 9 9 9 9 9 9 9 9 9 9 9 9 9 14 18 18 18 18 18 18 21 47 20 13 9 9 9 9 9 9 9 11 16 16 22 47 23 16 16 12 9 9 9 9 9 9 9 9 9 9 9 9 9 9 9 9 9 9 14 18 18 18 21 47 20 13 9 9 9 9 9 9 9 9 9 9 9 9 9 9 9 9 9 9 9 9 9 9 9 9 15 68 17 9 9 9 9 9 9 9 9 15 19 19 19 37 40 39 19 17 9 9 9 9 9 9 9 9 9 9 9 9 9 9 9 9 9 9 9 9 9 9 15 68 17 9 9 9 9 9 9 9 9 9 9 9 9 9 9 9 9 9 9 9 9 9 9 9 9 9 14 18 13 9 9 9 9 9 11 16 12 15 19 19 49 50 51 47 19 17 9 9 9 9 9 9 9 9 9 9 9 9 9 9 9 9 9 9 9 9 9 9 14 18 13 9 9 9 9 9 9 9 9 9 9 9 9 9 9 9 9 9 9 9 9 9 9 9 9 9 9 9 9 9 9 9 9 11 22 20 13 15 60 19 52 53 54 47 60 17 9 9 9 9 9 9 9 9 9 9 9 9 9 9 9 9 9 9 9 9 9 9 9 9 9 9 9 9 9 9 9 9 9 9 9 9 9 9 9 9 9 9 9 9 9 9 9 9 9 9 9 9 9 9 9 9 9 14 21 17 9 15 19 19 55 56 57 42 19 17 9 9 9 9 9 9 9 9 9 9 9 9 9 9 9 9 9 9 9 9 9 9 9 9 9 9 9 9 9 9 9 9 9 9 9 9 9 9 9 9 9 9 9 9 9 9 9 9 9 9 9 9 9 9 9 9 9 9 14 13 9 15 19 19 19 19 19 19 19 17 9 9 9 9 9 9 9 9 9 9 9 9 9 9 9 9 9 9 9 9 9 9 9 9 9 9 9 9 9 9 9 9 9 9 9 9 9 9 9 9 9 9 9 9 9 9 9 9 9 9 9 9 9 9 9 9 9 9 9 9 9 14 18 18 18 18 18 18 18 13 9 9 9 9 9 9 9 9 9 9 9 9 9 9 9 9 9 9 9 9 9 9 9 9 9 9 9 9 9 9 9 9 9 9 9 9 9 9 9 9 9 9 9 9 9 9 9 9 9 9 9 9 9 9 9 9 9 9 9 9 9 9 9 9 9 9 9 9 9 9 9 9 9 9 9 9 9 9 9 9 9 9 9 9 9 9 9 9 9 9 9 9 9 9 9 9 9 9 9 9 9 9 9)
  )
  (level
    (x 35)
    (y 4)
    (name "bonus-level1.stl")
  )
  (level
    (x 32)
    (y 41)
    (name "bonus-level2.stl")
  )
  (level
    (x 30)
    (y 39)
    (name "bonus-level3.stl")
  )
  (level
    (x 32)
    (y 46)
    (extro-script "
display_text_file(\"extro.txt\")
")
    (name "bonus-level4.stl")
  )
  (level
    (x 44)
    (y 39)
    (name "bonus-level5.stl")
  )
  (level
    (x 12)
    (y 33)
    (name "abednego-level1.stl")
  )
  (level
    (x 15)
    (y 35)
    (name "abednego-level2.stl")
  )
  (level
    (x 18)
    (y 36)
    (name "abednego-level3.stl")
  )
  (level
    (x 16)
    (y 40)
    (name "abednego-level4.stl")
  )
  (level
    (x 21)
    (y 17)
    (name "matr1x-level1.stl")
  )
  (level
    (x 25)
    (y 18)
    (name "matr1x-level2.stl")
  )
  (level
    (x 20)
    (y 20)
    (name "matr1x-level3.stl")
  )
  (level
    (x 35)
    (y 20)
    (name "thompson-level1.stl")
  )
  (level
    (x 37)
    (y 22)
    (name "thompson-level2.stl")
  )
  (level
    (x 58)
    (y 34)
    (name "torfi-level1.stl")
  )
  (level
    (x 57)
    (y 38)
    (name "torfi-level2.stl")
  )
  (level
    (x 59)
    (y 40)
    (name "torfi-level3.stl")
  )
  (level
    (x 51)
    (y 14)
    (name "wansti-level1.stl")
  )
  (level
    (x 53)
    (y 16)
    (name "wansti-level2.stl")
  )
  (level
    (x 52)
    (y 20)
    (name "wansti-level3.stl")
  )
  (level
    (x 47)
    (y 18)
    (name "wansti-level4.stl")
  )
  (level
    (x 50)
    (y 22)
    (name "wansti-level5.stl")
  )
  (special-tile
    (x 33)
    (y 39)
    (map-message (_ "You found a secret place!"))
    (passive-message #t)
    (apply-to-direction "west-north-south")
  )
  (special-tile
    (x 35)
    (y 5)
    (map-message (_ "Hint: Use igloos to get back here."))
    (passive-message #t)
    (apply-to-direction "north")
  )
  (special-tile
    (x 33)
    (y 8)
    (map-message (_ "Warp to Matr1x' Sector"))
    (teleport-to-x 20)
    (teleport-to-y 14)
  )
  (special-tile
    (x 31)
    (y 8)
    (map-message (_ "Warp to Thompson's Domain"))
    (teleport-to-x 34)
    (teleport-to-y 18)
  )
  (special-tile
    (x 35)
    (y 8)
    (map-message (_ "Warp to the SuperTux Team Island"))
    (teleport-to-x 51)
    (teleport-to-y 10)
  )
  (special-tile
    (x 37)
    (y 8)
    (map-message (_ "Warp to Abednego's Area"))
    (teleport-to-x 15)
    (teleport-to-y 31)
  )
  (special-tile
    (x 39)
    (y 8)
    (map-message (_ "Warp to Torfi's Territory"))
    (teleport-to-x 56)
    (teleport-to-y 33)
  )
  (special-tile
    (x 19)
    (y 24)
    (map-message (_ "Leave Matrix' Sector"))
    (teleport-to-x 32)
    (teleport-to-y 37)
  )
  (special-tile
    (x 35)
    (y 26)
    (map-message (_ "Leave Thompson's Domain"))
    (teleport-to-x 35)
    (teleport-to-y 2)
  )
  (special-tile
    (x 54)
    (y 25)
    (map-message (_ "Leave SuperTux Team Island"))
    (teleport-to-x 35)
    (teleport-to-y 2)
  )
  (special-tile
    (x 18)
    (y 43)
    (map-message (_ "Leave Abednego's Area"))
    (teleport-to-x 35)
    (teleport-to-y 2)
  )
  (special-tile
    (x 60)
    (y 43)
    (map-message (_ "Leave Torfi's Territory"))
    (teleport-to-x 35)
    (teleport-to-y 2)
  )
  (special-tile
    (x 27)
    (y 39)
    (map-message (_ "Warp home"))
    (teleport-to-x 35)
    (teleport-to-y 2)
  )
  (special-tile
    (x 15)
    (y 31)
    (teleport-to-x 35)
    (teleport-to-y 2)
  )
  (special-tile
    (x 34)
    (y 18)
    (teleport-to-x 35)
    (teleport-to-y 2)
  )
  (special-tile
    (x 20)
    (y 14)
    (teleport-to-x 35)
    (teleport-to-y 2)
  )
  (special-tile
    (x 51)
    (y 10)
    (teleport-to-x 35)
    (teleport-to-y 2)
  )
  (special-tile
    (x 56)
    (y 33)
    (teleport-to-x 35)
    (teleport-to-y 2)
  )
)
