;; Generated with Flexlay Editor
(supertux-worldmap
  (properties 
    (name  "Bonus Island")
    (start_pos_x 35)
    (start_pos_y 2))
  (tilemap 
    (width  70)
    (height 40)
    (data
       9  9  9  9  9  9  9  9  9  9  9  9  9  9  9  9  9  9  9  9  9  9  9  9  9  9  9  9  9  9  9  11 16 16 16 16 16 16 16 12 9  9  9  9  9  9  9  9  9  9  9  9  9  9  9  9  9  9  9  9  9  9  9  9  9  9  9  9  9  9  
       9  9  9  9  9  9  9  9  9  9  9  9  9  9  9  9  9  9  9  9  9  9  9  9  9  9  9  9  9  9  9  15 24 25 26 58 24 26 19 17 9  9  9  9  9  9  9  9  9  9  9  9  9  9  9  9  9  9  9  9  9  9  9  9  9  9  9  9  9  9  
       9  9  9  9  9  9  9  11 16 16 12 9  9  9  9  9  9  9  9  9  9  9  9  9  9  9  9  9  9  9  9  15 30 29 28 59 31 27 19 17 9  9  9  9  9  9  9  9  9  9  9  9  9  9  9  9  9  9  9  9  9  9  9  9  9  9  9  9  9  9  
       9  9  9  9  9  9  11 22 19 19 23 12 9  9  9  9  9  9  9  9  9  9  9  9  9  9  9  9  9  9  9  15 19 24 26 47 30 28 19 17 9  9  9  9  9  9  9  9  9  9  9  9  9  9  9  9  9  9  9  9  9  9  9  9  9  9  9  9  9  9  
       9  9  9  9  9  9  15 19 20 21 20 13 9  9  9  9  9  9  11 16 16 16 16 16 16 16 16 16 16 16 16 22 19 30 28 47 19 19 19 23 16 16 16 16 16 16 16 16 16 16 16 16 16 16 16 16 16 16 16 16 12 9  9  9  9  9  9  9  9  9  
       9  9  9  9  9  9  15 19 17 14 13 9  9  9  9  9  9  9  15 48 40 40 40 40 40 40 40 40 40 40 40 40 40 40 40 45 40 40 40 40 40 40 40 40 40 40 40 40 40 40 40 40 40 40 40 40 40 40 40 39 17 9  9  9  9  9  9  9  9  9  
       9  9  9  9  9  9  14 18 13 9  9  9  9  9  9  9  9  9  15 47 20 18 18 21 19 19 19 19 19 19 19 19 19 19 60 47 60 19 19 19 20 18 18 18 18 18 18 18 18 18 18 18 18 18 18 18 18 18 21 47 17 9  9  9  9  9  9  9  9  9  
       9  9  9  9  9  9  9  9  9  9  9  9  11 16 16 16 16 16 22 47 17 9  9  15 19 48 40 40 40 40 40 40 40 40 40 45 40 40 40 39 17 9  9  9  9  9  9  9  9  9  9  9  9  9  9  9  9  9  15 47 17 9  9  9  9  9  9  9  9  9  
       9  9  9  9  9  9  9  9  9  9  9  9  15 48 40 40 40 40 40 42 17 9  9  15 19 47 20 18 21 19 20 18 21 19 19 47 20 18 21 47 17 9  9  9  9  9  9  9  9  9  9  9  9  9  9  9  9  9  15 47 17 9  9  9  9  9  9  9  9  9  
       9  9  9  9  9  11 16 16 16 16 16 16 22 47 20 18 18 18 18 18 13 9  9  15 48 42 17 9  14 18 13 9  14 21 19 47 17 9  15 47 17 9  9  11 16 16 16 16 16 16 16 16 12 9  9  9  9  9  15 47 17 9  9  9  9  9  9  9  9  9  
       9  9  9  9  9  15 48 40 40 40 40 40 40 42 17 9  9  9  9  9  9  9  9  15 47 20 13 9  9  9  9  11 16 22 19 47 17 9  15 47 17 11 16 22 48 40 40 6  40 39 19 19 17 9  9  9  9  9  15 47 17 9  9  9  9  9  9  9  9  9  
       9  9  9  9  9  15 47 20 18 18 18 18 18 18 13 9  9  9  9  11 16 12 9  15 47 17 9  9  11 12 9  14 21 19 19 47 23 16 22 47 23 22 60 19 47 19 19 19 19 47 19 19 17 9  9  9  9  11 22 47 23 12 9  9  9  9  9  9  9  9  
       9  9  9  9  9  15 47 17 9  9  9  9  9  9  9  9  9  9  9  14 18 13 9  15 47 17 9  9  15 23 12 9  14 21 19 37 40 40 39 37 40 40 6  40 42 19 48 40 40 42 19 20 13 9  9  9  9  15 60 47 60 17 9  9  9  9  9  9  9  9  
       9  9  9  9  9  15 47 17 9  9  9  9  9  9  9  9  9  9  9  9  9  9  9  15 47 17 9  9  15 19 17 9  9  14 18 18 18 21 47 20 18 21 60 19 19 19 47 19 19 20 18 13 9  9  9  9  9  14 21 47 20 13 9  9  9  9  9  9  9  9  
       9  9  9  9  11 22 47 23 12 11 16 16 16 16 12 9  9  9  9  9  9  9  9  15 47 17 9  9  14 18 13 9  9  9  9  9  9  15 47 17 9  14 18 21 19 19 47 19 19 23 12 9  9  9  9  9  11 16 22 47 23 16 12 9  9  9  9  9  9  9  
       9  9  9  9  15 19 47 19 23 22 48 6  40 39 17 9  9  9  9  9  11 16 16 22 47 23 16 16 16 16 12 9  9  9  9  9  9  15 47 17 9  9  9  14 21 19 7  19 19 19 23 12 9  9  9  9  15 19 19 7  19 19 17 9  9  9  9  9  9  9  
       9  9  9  9  15 19 47 19 19 19 47 19 19 47 17 9  9  9  9  9  15 19 19 19 47 19 19 48 40 39 17 9  9  9  9  9  9  15 47 17 9  9  9  9  15 19 37 40 40 39 19 17 9  9  9  9  14 21 19 37 40 39 23 16 12 9  9  9  9  9  
       9  9  9  9  14 21 47 19 19 48 42 19 19 47 23 12 9  9  9  9  14 18 21 19 7  19 19 47 19 47 17 9  9  9  9  11 16 22 47 23 16 12 9  9  15 19 19 19 19 47 19 17 9  9  9  9  9  15 19 19 19 47 19 20 13 9  9  9  9  9  
       9  9  9  9  9  15 37 6  40 42 24 25 26 47 19 17 9  11 12 9  9  9  14 21 37 40 40 42 19 47 17 9  9  9  9  15 19 19 7  19 19 23 12 9  14 18 18 18 21 47 20 13 9  11 16 16 16 22 19 19 19 47 19 23 12 9  9  9  9  9  
       9  9  9  9  9  15 19 19 19 19 31 32 27 47 19 17 9  14 13 9  9  11 16 22 19 60 19 19 19 7  17 9  9  9  9  14 21 19 37 40 40 39 17 9  9  9  9  9  15 47 17 9  9  15 48 40 40 40 40 39 19 37 40 39 23 12 9  9  9  9  
       9  9  9  9  9  15 19 60 19 19 30 29 28 47 20 13 9  9  9  9  11 22 19 19 19 19 19 19 19 47 17 9  9  9  9  9  14 21 19 19 19 47 17 9  9  9  9  11 22 47 17 9  9  15 47 19 19 19 19 47 19 19 19 47 19 17 9  9  9  9  
       9  9  9  9  9  14 21 48 40 6  40 40 40 42 17 9  9  9  9  9  15 48 40 40 40 6  40 40 40 42 17 9  9  9  9  9  9  15 19 19 19 47 17 9  9  9  9  15 19 47 17 9  9  15 47 19 19 19 19 37 6  40 40 42 19 17 9  9  9  9  
       9  9  9  9  11 16 22 47 19 19 19 19 19 19 17 9  9  9  9  9  15 47 19 19 19 19 20 21 19 20 13 9  9  9  9  9  9  15 19 48 6  42 23 12 9  9  9  15 19 47 17 9  9  15 37 40 39 19 19 19 19 19 19 19 19 17 9  9  9  9  
       9  9  9  9  15 19 19 37 40 40 40 40 6  39 17 9  9  9  9  9  15 37 40 39 19 20 13 14 18 13 9  9  9  9  9  9  9  14 21 47 19 19 19 17 9  9  11 22 19 47 17 9  9  15 19 19 37 6  40 40 40 40 39 19 20 13 9  9  9  9  
       9  9  9  9  14 21 19 19 19 19 19 19 19 47 23 12 9  9  9  9  14 18 21 47 20 13 9  9  9  9  9  9  9  9  9  9  9  9  15 47 20 18 18 13 9  9  14 21 19 47 17 9  9  14 21 19 19 19 20 18 18 21 47 20 13 9  9  9  9  9  
       9  9  9  9  9  14 18 18 18 18 18 18 21 47 20 13 9  9  9  9  9  9  15 47 17 9  9  9  9  9  9  9  9  9  9  9  9  9  15 47 17 9  9  9  9  9  9  14 21 47 17 9  9  9  14 18 18 18 13 9  9  15 47 17 9  9  9  9  9  9  
       9  9  9  9  9  9  9  9  9  9  9  9  15 47 17 9  9  9  9  9  9  9  15 47 17 9  9  9  9  9  9  9  9  9  9  9  9  9  15 47 17 9  9  9  9  9  9  9  15 47 17 9  9  9  9  9  9  9  9  9  9  15 47 17 9  9  9  9  9  9  
       9  9  9  9  9  9  9  9  9  9  9  9  15 47 23 16 16 16 16 16 16 16 22 47 23 16 16 16 16 16 16 16 16 16 16 16 16 16 22 47 23 16 16 16 16 16 16 16 22 47 23 16 16 16 16 16 16 16 16 16 16 22 47 17 9  9  9  9  9  9  
       9  9  9  9  9  9  9  9  9  9  9  9  15 37 40 40 40 40 40 40 40 40 40 44 40 40 40 40 40 40 40 40 40 40 40 43 40 40 40 44 40 40 40 40 40 40 40 40 40 44 40 40 40 40 40 40 40 40 40 40 40 40 42 17 9  9  9  9  9  9  
       9  9  9  9  9  9  9  9  9  9  9  9  14 18 18 18 18 18 18 18 18 18 18 18 18 18 18 18 18 18 18 18 18 18 21 47 20 18 18 18 18 18 18 18 18 18 18 18 18 18 18 18 18 18 18 18 18 18 18 18 18 18 18 13 9  9  9  9  9  9  
       9  9  9  9  9  9  9  9  9  9  9  9  9  9  9  9  9  9  9  9  9  9  9  9  9  9  9  9  9  9  9  9  9  9  15 47 17 9  9  9  9  9  9  9  9  9  9  9  9  9  9  9  9  9  9  9  9  9  9  9  9  9  9  9  9  9  9  9  9  9  
       9  9  9  9  9  9  9  9  9  9  9  9  9  9  9  9  9  9  9  9  9  9  9  9  9  9  9  9  9  9  9  9  9  9  15 47 17 9  9  9  9  9  9  9  9  9  9  9  9  9  9  9  9  9  9  9  9  9  9  9  9  9  9  9  9  9  9  9  9  9  
       9  9  9  9  9  9  9  9  9  9  9  9  9  9  9  9  9  9  9  9  9  9  9  9  9  9  9  9  9  9  9  11 16 16 22 47 23 16 16 12 9  9  9  9  9  9  9  9  9  9  9  9  9  9  9  9  9  9  9  9  9  9  9  9  9  9  9  9  9  9  
       9  9  9  9  9  9  9  9  9  9  9  9  9  9  9  9  9  9  9  9  9  9  9  9  9  9  9  9  9  9  9  15 19 19 19 37 40 39 19 17 9  9  9  9  9  9  9  9  9  9  9  9  9  9  9  9  9  9  9  9  9  9  9  9  9  9  9  9  9  9  
       9  9  9  9  9  9  9  9  9  9  9  9  9  9  9  9  9  9  9  9  9  9  9  9  9  9  9  9  9  9  9  15 19 19 49 50 51 47 19 17 9  9  9  9  9  9  9  9  9  9  9  9  9  9  9  9  9  9  9  9  9  9  9  9  9  9  9  9  9  9  
       9  9  9  9  9  9  9  9  9  9  9  9  9  9  9  9  9  9  9  9  9  9  9  9  9  9  9  9  9  9  9  15 60 19 52 53 54 47 60 17 9  9  9  9  9  9  9  9  9  9  9  9  9  9  9  9  9  9  9  9  9  9  9  9  9  9  9  9  9  9  
       9  9  9  9  9  9  9  9  9  9  9  9  9  9  9  9  9  9  9  9  9  9  9  9  9  9  9  9  9  9  9  15 19 19 55 56 57 42 19 17 9  9  9  9  9  9  9  9  9  9  9  9  9  9  9  9  9  9  9  9  9  9  9  9  9  9  9  9  9  9  
       9  9  9  9  9  9  9  9  9  9  9  9  9  9  9  9  9  9  9  9  9  9  9  9  9  9  9  9  9  9  9  15 19 19 19 19 19 19 19 17 9  9  9  9  9  9  9  9  9  9  9  9  9  9  9  9  9  9  9  9  9  9  9  9  9  9  9  9  9  9  
       9  9  9  9  9  9  9  9  9  9  9  9  9  9  9  9  9  9  9  9  9  9  9  9  9  9  9  9  9  9  9  14 18 18 18 18 18 18 18 13 9  9  9  9  9  9  9  9  9  9  9  9  9  9  9  9  9  9  9  9  9  9  9  9  9  9  9  9  9  9  
       9  9  9  9  9  9  9  9  9  9  9  9  9  9  9  9  9  9  9  9  9  9  9  9  9  9  9  9  9  9  9  9  9  9  9  9  9  9  9  9  9  9  9  9  9  9  9  9  9  9  9  9  9  9  9  9  9  9  9  9  9  9  9  9  9  9  9  9  9  9  
           ))

	   (levels
    (level (name "bonus1/abednego-level1.stl")
           (x 7)
           (y 18))
    (level (name "bonus1/abednego-level2.stl")
           (x 11)
           (y 15))
    (level (name "bonus1/abednego-level3.stl")
           (x 9)
           (y 21))
    (level (name "bonus1/abednego-level4.stl")
           (x 12)
           (y 23))
    (level (name "bonus1/matr1x-level1.stl")
           (x 24)
           (y 17))
    (level (name "bonus1/matr1x-level2.stl")
           (x 29)
           (y 19))
    (level (name "bonus1/matr1x-level3.stl")
           (x 25)
           (y 21))
    (level (name "bonus1/thompson-level1.stl")
           (x 38)
           (y 18))
    (level (name "bonus1/thompson-level2.stl")
           (x 40)
           (y 22))
    (level (name "bonus1/torfi-level1.stl")
           (x 42)
           (y 12))
    (level (name "bonus1/torfi-level2.stl")
           (x 47)
           (y 10))
    (level (name "bonus1/torfi-level3.stl")
           (x 46)
           (y 15))
    (level (name "bonus1/wansti-level1.stl")
           (x 59)
           (y 15))
    (level (name "bonus1/wansti-level2.stl")
           (x 60)
           (y 21))
    (level (name "bonus1/wansti-level3.stl")
           (x 57)
           (y 23))
    (level (name "bonus1/castle.stl")
           (x 35)
           (y 36))

           (extro-filename "extro.txt"))
  )
)

