(supertux-level
  (version 3)
  (name (_ "The Graveyard Shift"))
  (author "Daniel Ward")
  (contact "weluvgoatz@gmail.com")
  (license "GPL 2+ / CC-by-sa 3.0")
  (allow-item-pocket "inherit")
  (icon "")
  (icon-locked "")
  (statistics
    (enable-coins #t)
    (enable-secrets #t)
  )
  (sector
    (name "main")
    (ambient-light
      (color 1 1 1)
    )
    (background
      (color 1 1 1)
      (alignment "bottom")
      (speed 0.05)
      (image "images/background/halloween/mountain_panorama.png")
      (z-pos -150)
    )
    (background
      (color 1 1 1)
      (speed 0)
      (image "images/background/halloween/sky.png")
    )
    (background
      (color 1 1 1)
      (alignment "bottom")
      (speed 1.5)
      (speed-y 0)
      (image "images/background/halloween/fog.png")
      (z-pos 100)
    )
    (background
      (color 1 1 1)
      (alignment "bottom")
      (speed 0.25)
      (image "images/background/halloween/fog.png")
      (z-pos -105)
    )
    (background
      (color 1 1 1)
      (speed 0)
      (fill #t)
      (image "images/background/misc/vignette.png")
      (z-pos 200)
    )
    (bonusblock
      (z-pos 51)
      (contents "explode")
      (x 2768)
      (y 480)
    )
    (bonusblock
      (type "orange")
      (z-pos 51)
      (x 4448)
      (y 864)
    )
    (bonusblock
      (type "purple")
      (z-pos 51)
      (x 6080)
      (y 416)
    )
    (bouncingsnowball
      (type "fatbat")
      (z-pos 50)
      (x 5600)
      (y 704)
      (glinting #f)
    )
    (bouncingsnowball
      (type "fatbat")
      (z-pos 50)
      (x 7232)
      (y 768)
      (glinting #f)
    )
    (bouncingsnowball
      (type "fatbat")
      (z-pos 50)
      (x 7072)
      (y 768)
      (glinting #f)
    )
    (camera
      (name "Camera")
      (mode "normal")
    )
    (coin
      (z-pos -49)
      (x 1664)
      (y 896)
    )
    (coin
      (z-pos -49)
      (x 1632)
      (y 928)
    )
    (coin
      (z-pos -49)
      (x 1600)
      (y 960)
    )
    (coin
      (z-pos -49)
      (x 1568)
      (y 960)
    )
    (coin
      (z-pos -49)
      (x 1600)
      (y 928)
    )
    (coin
      (z-pos -49)
      (x 1632)
      (y 896)
    )
    (corrupted_granito
      (type "skullyhop")
      (z-pos 50)
      (x 9872)
      (y 2016)
      (glinting #f)
    )
    (crusher
      (type "corrupted-krush")
      (z-pos 50)
      (x 2752)
      (y 896)
    )
    (crusher
      (type "corrupted-krush")
      (z-pos 50)
      (x 8032)
      (y 432)
    )
    (crusher
      (type "corrupted-krush")
      (z-pos 50)
      (direction "right")
      (x 7840)
      (y 1184)
    )
    (crusher
      (type "corrupted-krush")
      (z-pos 50)
      (direction "right")
      (x 8832)
      (y 1088)
    )
    (crusher
      (type "corrupted-krosh")
      (z-pos 50)
      (x 9824)
      (y 640)
    )
    (firefly
      (z-pos 0)
      (x 10752)
      (y 1984)
    )
    (music
      (file "/music/misc/halloween_1.music")
    )
    (path
      (name "gen17678444051423004015248")
      (path
        (mode "oneshot")
        (adapt_speed #f)
        (node
          (x 9824)
          (y 2096)
          (easing "EaseQuadOut")
        )
        (node
          (x 9824)
          (y 1968)
        )
      )
    )
    (platform
      (z-pos 50)
      (handle
        (scale_x 0)
        (scale_y 0)
        (offset_x 0)
        (offset_y 0)
      )
      (running #f)
      (name "skeletor")
      (path-ref "gen17678444051423004015248")
    )
    (scripttrigger
      (oneshot #t)
      (script "
Tux.deactivate();
Camera.set_mode(\"manual\");
Tux.walk(320);
wait(1);
Tux.walk(0);
Tux.set_dir(false);
start_cutscene();
pause_music(3);
Effect.sixteen_to_nine(1);
wait(1);
Tux.set_dir(false);
wait(0.5);
Camera.scroll_to(Camera.get_x(), Camerabert.get_y(), 1);
wait(4);
Camera.start_earthquake(2, 0.05);
Camera.ease_scale_anchor(1.6, 2, 7, \"EaseQuadInOut\");
wait(4);
Camera.stop_earthquake();
skeletor.goto_node(1);
wait(2.5);
Effect.fade_out(1);
wait(2);
Camera.set_scale(1);
Effect.fade_in(1);
Camera.set_mode(\"normal\");
foreach(name, torch in sector) {
    if(startswith(name, \"torch\")) {
      torch.set_burning(true);
    }
  }
Tux.activate();
Effect.four_to_three(1);
resume_music(3);
end_cutscene();")
      (button #f)
      (width 32)
      (height 352)
      (x 9776)
      (y 736)
    )
    (scripttrigger
      (name "skeletor.goto_node(1);")
      (button #f)
      (width 32)
      (height 384)
      (x 10752)
      (y 1664)
    )
    (secretarea
      (width 128)
      (height 96)
      (x 7136)
      (y 320)
    )
    (sequencetrigger
      (sequence "endsequence")
      (width 32)
      (height 752)
      (x 10976)
      (y 1296)
    )
    (smartball
      (type "pumpkin")
      (z-pos 50)
      (x 2176)
      (y 1056)
      (glinting #f)
    )
    (smartball
      (type "pumpkin")
      (z-pos 50)
      (x 6144)
      (y 1136)
      (glinting #f)
    )
    (snowball
      (type "bumpkin")
      (z-pos 50)
      (x 2304)
      (y 1056)
      (glinting #f)
    )
    (snowball
      (type "bumpkin")
      (z-pos 50)
      (x 2432)
      (y 1056)
      (glinting #f)
    )
    (spawnpoint
      (name "main")
      (x 416)
      (y 800)
    )
    (spawnpoint
      (x 6880)
      (y 992)
    )
    (spawnpoint
      (x 8752)
      (y 1024)
    )
    (spawnpoint
      (name "Camerabert")
      (x 9184)
      (y 1408)
    )
    (tilemap
      (solid #t)
      (z-pos -1)
      (width 700)
      (height 90)
      (tiles -173 0 -2 48 -699 0 48 -53 0 -10 48 -636 0 48 -46 0 -8 48 -2 0 -2 48 -4 0 -8 48 -629 0 -2 48 -40 0 -6 48 -8 0 -2 48 -12 0 -4 48 -627 0 -2 48 -23 0 -19 48 -11 0 48 -16 0 -8 48 -621 0 -3 48 -19 0 -3 48 -17 0 -3 48 -8 0 -2 48 -23 0 -3 48 -621 0 -2 48 -16 0 -3 48 -21 0 -2 48 -7 0 48 -26 0 -4 48 -619 0 -3 48 -12 0 -3 48 -24 0 48 -5 0 -3 48 -29 0 -3 48 -619 0 -2 48 -10 0 -2 48 -26 0 -2 48 -4 0 -2 48 -32 0 48 -620 0 -12 48 -28 0 -6 48 -19 0 44 -8 0 44 -4 0 -2 48 -682 0 44 -16 0 48 -626 0 44 0 44 -55 0 44 -7 0 44 0 44 -2 0 -3 48 -624 0 44 -5 0 44 -65 0 -2 48 -651 0 -22 48 -10 0 -6 48 -4 0 -6 48 -628 0 44 -3 0 44 -12 0 -9 48 -17 0 48 0 48 -10 0 48 -4 0 48 -4 0 -7 48 -629 0 44 -11 0 -4 48 -7 0 -21 48 -10 0 -6 48 -4 0 -2 48 -4 0 -2 48 -637 0 -4 48 -6 0 -5 48 -47 0 -2 48 -626 0 3159 102 3159 -6 0 -2 48 -5 0 -5 48 -52 0 48 -634 0 -2 48 -2 0 -5 48 -49 0 44 0 44 -4 0 -2 48 -521 0 102 -2 3159 83 -107 0 -6 48 -60 0 -2 48 -21 0 -7 48 -7 0 -19 48 -577 0 -5 48 -56 0 44 -5 0 48 -17 0 -6 48 -5 0 -7 48 0 -8 48 -4 0 -7 48 -566 0 -15 48 -63 0 48 -11 0 -7 48 -16 0 -10 48 -4 0 -8 48 -564 0 -2 48 -12 0 -2 48 -56 0 -3 3159 -4 0 48 -9 0 -3 48 -24 0 -8 48 -4 0 -11 48 -460 0 -10 48 -90 0 -2 48 -12 0 -2 48 -63 0 -2 48 -6 0 -4 48 -30 0 -4 48 -4 0 -4 48 -3 0 -5 48 -377 0 -6 48 -75 0 -12 48 -82 0 -8 48 -7 0 -7 48 -63 0 -2 48 -4 0 -4 48 -52 0 -2 48 -382 0 -2 48 -73 0 48 -10 0 48 -81 0 -2 48 -4 0 48 -3 0 -7 48 -68 0 -2 48 -4 0 -2 48 -56 0 -2 48 -383 0 -2 48 -71 0 48 -8 0 -3 48 -81 0 -2 48 -4 0 48 -2 0 -2 48 -21 0 -2 44 -4 0 -22 48 -10 7398 -22 48 -58 0 48 -385 0 -11 48 -60 0 -2 48 -2 0 -4 48 0 -2 48 -5 0 -2 48 -76 0 -9 48 -22 0 -2 44 -7 0 -3 48 -10 0 -6 48 -10 0 -2 48 -11 0 -4 48 -55 0 48 -7 0 48 -396 0 -2 48 -27 0 -3 3159 -29 0 -4 48 -2 0 -4 48 -114 0 -2 44 -9 0 48 -9 0 -4 48 -14 0 -13 48 -66 0 48 -398 0 48 -20 0 47 -4 0 -3 3159 47 -31 0 -2 48 -2 0 -2 48 -45 0 -3 44 -79 0 48 -7 0 -5 48 -94 0 48 -399 0 48 -19 0 27 29 -2 0 -3 3159 27 29 -151 0 -6 48 -7 0 48 -6 0 -2 48 0 48 -96 0 48 -400 0 48 -18 0 27 -7 28 29 -41 0 -2 48 -38 0 -4 3159 3160 -78 0 48 -6 0 48 0 -2 48 -95 0 -2 48 -401 0 48 -18 0 27 -5 28 29 -165 0 48 -6 0 48 0 48 -96 0 48 -403 0 48 -128 0 44 -6 0 44 -50 0 -4 48 -6 0 48 0 48 -96 0 48 -404 0 -12 48 27 -16 28 29 -21 48 -75 0 44 -3 0 44 -2 0 44 -3 0 44 -48 0 48 -9 0 48 0 -2 48 -44 0 -4 48 -18 0 -9 48 -12 7026 -9 48 -415 0 48 -18 0 48 -19 0 -2 48 -30 0 -6 48 -8 0 -6 3159 -13 48 -13 0 44 -6 0 44 -38 0 -9 48 -3 0 48 -12 0 -2 48 -41 0 7398 0 48 -2 0 48 -18 0 -2 48 -6 0 48 -12 0 48 -422 0 -2 48 -18 0 -4 48 -17 0 -2 48 -12 0 -10 48 -2 3159 -5 0 48 -4 0 48 -14 0 -5 48 -7 0 -2 48 -58 0 48 -7 0 -5 48 -12 0 -3 48 -37 0 7398 -4 0 48 -2 0 48 -18 0 -2 48 -6 0 48 -12 0 -2 48 -420 0 -2 48 -22 0 -3 48 -16 0 -2 48 -10 0 -2 48 -8 0 48 -7 0 48 -4 0 48 -17 0 -3 48 -7 0 -2 48 -11 0 44 -6 0 44 -25 0 -6 48 -7 0 48 -25 0 -17 48 -17 0 -4 48 -5 0 -2 48 -2 0 -2 48 -2 0 -6 48 -4 0 -6 48 -7 0 48 -12 0 48 -419 0 -3 48 -25 0 48 -17 0 -12 48 -9 0 48 -7 0 48 -4 0 48 -18 0 -2 48 -8 0 -2 48 -13 0 1628 1629 -13 0 -10 48 -5 0 48 -4 0 48 -7 0 48 -41 0 48 -17 0 48 -2 0 48 -5 0 -2 48 -3 0 -4 48 -4 0 -6 48 -12 0 48 -12 0 48 -419 0 48 -27 0 -2 48 -34 0 -4 48 -7 0 48 -3 0 -3 48 -4 0 -5 48 -8 0 48 -10 0 -2 48 -12 0 1630 1631 -12 0 -2 48 -8 0 48 -5 0 48 -4 0 48 -7 0 48 -41 0 48 -17 0 48 -2 0 48 -4 0 -3 48 -29 0 48 -12 0 48 -417 0 -3 48 -28 0 48 -33 0 -2 48 -9 0 -2 48 -3 0 -9 48 -2 0 -6 48 -2 0 -2 48 -11 0 -28 48 -9 0 48 -5 0 48 -4 0 -2 48 -5 0 -2 48 -41 0 -2 48 -15 0 -2 48 -2 0 -6 48 -31 0 48 -12 0 48 -417 0 48 -30 0 48 -33 0 48 -7 0 -5 48 -4 0 48 -2 0 -2 48 -11 0 -3 48 -49 0 48 -4 0 -2 48 -5 0 -7 48 -43 0 -2 48 -4 0 -11 48 -40 0 48 -12 0 48 -417 0 48 -30 0 48 -33 0 48 -7 0 48 -3 0 -6 48 -67 0 -2 48 -3 0 48 -57 0 -6 48 -50 0 48 -12 0 48 -417 0 48 -29 0 -2 48 -33 0 -2 48 -5 0 -2 48 -5 0 -2 48 -70 0 -5 48 -113 0 48 -12 0 48 -417 0 48 -29 0 48 -35 0 -7 48 -7 0 -3 48 -186 0 48 -12 0 48 -417 0 48 -28 0 -2 48 -51 0 -3 48 -184 0 48 -12 0 48 -417 0 48 -26 0 -3 48 -53 0 -2 48 -184 0 48 -12 0 48 -417 0 48 -25 0 -2 48 -241 0 48 -12 0 48 -417 0 48 -268 0 48 -12 0 48 -417 0 48 -268 0 48 -12 0 48 -8 0 -3 48 -406 0 48 -264 0 -5 48 -12 0 -2 48 -5 0 -3 48 -408 0 48 -262 0 -3 48 -17 0 -7 48 -410 0 48 -262 0 48 -436 0 48 -261 0 -2 48 -436 0 48 -261 0 48 -437 0 48 -261 0 48 -437 0 48 -261 0 48 -437 0 48 -261 0 -2 48 -436 0 48 -262 0 -2 48 -435 0 48 -263 0 -2 48 -434 0 48 -264 0 -2 48 -433 0 48 -266 0 -8 48 -2 0 -13 48 -410 0 48 -269 0 -5 48 -2 0 48 -11 0 -5 48 -406 0 48 -273 0 48 -2 0 48 -15 0 -4 48 -403 0 48 -273 0 48 -2 0 48 -19 0 -14 48 -389 0 48 -299 0 48 -399 0 48 -699 0 48 -699 0 48 -699 0 48 -14666 0)
    )
    (tilemap
      (solid #f)
      (tint 0.3 0.3 0.3)
      (z-pos -50)
      (name "dark")
      (width 700)
      (height 70)
      (tiles -22446 0 3171 3172 0 3171 3172 -695 0 3177 3178 0 3177 3178 -25849 0)
    )
    (tilemap
      (solid #t)
      (z-pos -2)
      (name "backsolid")
      (width 700)
      (height 90)
      (tiles -21216 0 102 -3563 0 1972 1976 1984 -6 0 1972 1984 -2 0 1972 1984 -521 0 5582 -12 0 5582 -141 0 5582 -4 0 5577 -2 1980 1976 1982 1977 1981 1980 1976 1984 -2 0 1972 1982 1977 1976 1980 1981 1985 -439 0 2141 2142 2019 2140 2141 2142 2019 2140 2141 2142 2019 2140 2141 2142 2019 2140 2141 2142 2019 2140 2141 2142 2019 2140 2141 2142 2019 2140 2141 2142 2019 2140 -44 0 5582 -5 0 5580 -12 0 1975 -2 5583 1976 1984 -67 0 5582 -68 0 1972 1987 -5 0 1975 1982 -3 1977 1982 1978 1977 1981 1976 1980 1977 1981 1977 -2 1982 1981 1986 -439 0 -32 2020 -37 0 5582 -5 0 1972 1987 -5 0 1974 1984 -2 0 1972 -2 1980 1976 1980 1976 1984 -5 0 1974 1982 1980 5579 -59 0 5582 -5 0 5584 -59 0 5582 -4 0 5582 -3 0 5584 -7 0 1975 1979 -2 1983 -2 1979 -7 1983 1979 1983 1979 1987 -439 0 -32 2020 -32 0 1972 1980 1976 -2 1980 1977 1984 -3 0 1972 1986 -6 0 1973 1982 1980 5578 -2 1979 1983 -2 1977 1982 1977 1980 5578 5583 -2 1980 1981 1977 1985 -60 0 1975 1984 -3 0 1972 1987 -43 0 1972 1980 1984 -4 0 1972 1980 1976 1984 -4 0 1972 1978 1984 -2 0 5577 1977 1976 -2 1980 1987 -463 0 -32 2020 -32 0 1973 1978 1977 1981 1982 1981 1977 -3 1980 1977 1986 -6 0 1975 1983 1987 -4 0 1975 -2 1983 1979 1987 -2 0 1973 1977 1978 1979 1987 -49 0 5582 -2 0 1972 5579 -7 0 1975 5583 -2 5578 1987 -44 0 1975 1977 1985 0 1972 -2 1976 1982 -2 1978 1982 -4 1976 1982 1977 1987 -3 0 1974 1979 1983 1987 -464 0 -32 2020 -32 0 1975 -2 1977 1978 -2 1982 1978 1982 -3 1977 1986 -20 0 1975 1983 1987 -51 0 1975 1984 0 5584 -58 0 1974 1978 1980 1982 1977 1982 -2 1983 1979 -3 1983 -3 1979 1987 -4 0 5585 -467 0 -32 2020 -33 0 1974 1978 1977 -2 1981 1978 1977 1978 -3 1981 5583 5579 -73 0 1975 5583 1987 -57 0 5577 1983 -3 1979 1983 1987 -482 0 -32 2020 -32 0 1972 1982 1979 1981 1977 -2 1978 1977 1981 1977 1979 1987 -688 0 1975 1987 0 1975 1983 1982 -2 1977 1983 1987 -695 0 1975 1983 1987 -31394 0)
    )
    (tilemap
      (solid #f)
      (z-pos 99)
      (width 700)
      (height 90)
      (tiles -43006 0 -6 48 -694 0 -6 48 -694 0 -6 48 -694 0 -6 48 -694 0 -6 48 -694 0 -6 48 -694 0 -6 48 -694 0 -6 48 -15088 0)
    )
    (torch
      (name "torch-0")
      (burning #f)
      (sprite "/images/objects/torch/torch3.sprite")
      (z-pos -1)
      (color 0.1 1 0.1)
      (x 9632)
      (y 1856)
    )
    (torch
      (name "torch-1")
      (burning #f)
      (sprite "/images/objects/torch/torch3.sprite")
      (z-pos -1)
      (color 0.1 1 0.1)
      (x 10144)
      (y 1856)
    )
    (torch
      (name "torch-2")
      (burning #f)
      (sprite "/images/objects/torch/torch3.sprite")
      (z-pos -1)
      (color 0.1 1 0.1)
      (x 10112)
      (y 768)
    )
  )
)
