(supertux-level
  (version 3)
  (name (_ "Library of Ghouls"))
  (author "Daniel Ward")
  (contact "weluvgoatz@gmail.com")
  (license "GPL 2+ / CC-by-sa 3.0")
  (allow-item-pocket "inherit")
  (icon "")
  (icon-locked "")
  (statistics
    (enable-coins #t)
    (enable-secrets #t)
  )
  (sector
    (name "main")
    (ambient-light
      (color 0.5 0.6 0.7)
    )
    (background
      (color 1 1 1)
      (alignment "bottom")
      (speed 0.125)
      (image "images/background/halloween/mountain_panorama.png")
      (z-pos -150)
    )
    (background
      (color 1 1 1)
      (speed 0)
      (image "images/background/halloween/sky.png")
    )
    (background
      (color 1 1 1)
      (alignment "bottom")
      (speed 1.5)
      (image "images/background/halloween/fog.png")
      (z-pos 100)
    )
    (background
      (color 1 1 1)
      (alignment "bottom")
      (speed 0.25)
      (image "images/background/halloween/fog.png")
      (z-pos -105)
    )
    (background
      (color 1 1 1)
      (speed 0)
      (fill #t)
      (image "images/background/misc/vignette.png")
      (z-pos 200)
    )
    (camera
      (name "Camera")
      (mode "normal")
    )
    (candle
      (z-pos -99)
      (x 1664)
      (y 928)
    )
    (candle
      (z-pos -99)
      (x 4192)
      (y 928)
    )
    (decal
      (z-pos -50)
      (sprite "/images/decal/halloween/exit.png")
      (x 5952)
      (y 800)
    )
    (decal
      (z-pos 55)
      (sprite "/images/decal/halloween/exitfg.png")
      (x 5952)
      (y 800)
    )
    (door
      (z-pos -99)
      (locked #f)
      (x 1568)
      (y 864)
    )
    (door
      (z-pos -99)
      (locked #f)
      (x 4264)
      (y 864)
    )
    (ghoul
      (z-pos 50)
      (x 1120)
      (y 704)
    )
    (invisible_wall
      (name "waller")
      (width 32)
      (height 8)
      (x 1248)
      (y 896)
    )
    (invisible_wall
      (name "waller_end")
      (width 32)
      (height 8)
      (x 4384)
      (y 896)
    )
    (lantern
      (z-pos 50)
      (on-grab-script "waller.set_pos(0,0);")
      (name "lanty")
      (x 1248)
      (y 856)
    )
    (lantern
      (z-pos 50)
      (on-grab-script "waller_end.set_pos(0,0);")
      (name "lanty")
      (x 4384)
      (y 856)
    )
    (magicblock
      (z-pos 50)
      (color 1 1 1)
      (x 1376)
      (y 896)
    )
    (magicblock
      (z-pos 50)
      (color 1 1 1)
      (x 1376)
      (y 928)
    )
    (magicblock
      (z-pos 50)
      (color 1 1 1)
      (x 1376)
      (y 864)
    )
    (magicblock
      (z-pos 50)
      (color 1 1 1)
      (x 1376)
      (y 832)
    )
    (magicblock
      (z-pos 50)
      (color 1 1 1)
      (x 4480)
      (y 832)
    )
    (magicblock
      (z-pos 50)
      (color 1 1 1)
      (x 4480)
      (y 864)
    )
    (magicblock
      (z-pos 50)
      (color 1 1 1)
      (x 4480)
      (y 896)
    )
    (magicblock
      (z-pos 50)
      (color 1 1 1)
      (x 4480)
      (y 928)
    )
    (music
      (file "/music/misc/halloween_1.music")
    )
    (sequencetrigger
      (sequence "stoptux")
      (width 32)
      (height 480)
      (x 6240)
      (y 576)
    )
    (sequencetrigger
      (sequence "endsequence")
      (width 32)
      (height 480)
      (x 5504)
      (y 576)
    )
    (spawnpoint
      (name "main")
      (x 416)
      (y 800)
    )
    (spawnpoint
      (name "end")
      (x 4272)
      (y 904)
    )
    (spawnpoint
      (name "start")
      (x 1576)
      (y 896)
    )
    (tilemap
      (solid #t)
      (z-pos 0)
      (width 200)
      (height 60)
      (tiles -37 0 48 -108 0 48 -90 0 48 -108 0 48 -90 0 48 -108 0 48 -90 0 48 -108 0 48 -90 0 48 -108 0 48 -90 0 48 -108 0 48 -90 0 48 -108 0 48 -90 0 48 -108 0 48 -90 0 48 -108 0 48 -90 0 48 -108 0 48 -90 0 48 -108 0 48 -90 0 48 -108 0 48 -90 0 48 -108 0 48 -90 0 48 -108 0 48 -90 0 48 -108 0 48 -90 0 48 -108 0 48 -90 0 48 -108 0 48 -90 0 48 -108 0 48 -90 0 48 -108 0 48 -90 0 -6 48 -98 0 -6 48 -92 0 48 -2 0 48 -98 0 48 -97 0 48 -2 0 48 0 -11 48 -74 0 -11 48 0 48 -97 0 4666 -2 0 48 0 48 -9 0 48 -74 0 48 -7 0 4666 0 48 0 48 -97 0 4665 -2 0 48 0 48 -9 0 48 -74 0 48 -7 0 4665 0 48 0 48 -97 0 4665 -2 0 48 0 48 -9 0 48 -74 0 48 -7 0 4665 0 48 0 48 -97 0 4665 -2 0 -3 48 -9 0 48 -74 0 48 -7 0 4665 0 -3 48 -97 0 4670 -14 0 48 -74 0 48 -7 0 4670 -73 0 -5 48 -38 0 48 -74 0 48 -79 0 -3 48 -3 0 -3 48 -36 0 48 -74 0 48 -77 0 -3 48 -7 0 -3 48 -34 0 48 -74 0 48 -70 0 -8 48 -11 0 -3 48 -19 0 -14 48 -74 0 -23 48 -69 0 -3 48 -16 0 -2 48 -3 0 48 -105 0 -2 48 -70 0 -23 48 -106 0 -2 48 -199 0 -6 48 -5 0 -36 48 -158 0 48 -5 0 48 -193 0 48 -5 0 48 -193 0 -7 48 -4635 0)
    )
    (tilemap
      (solid #t)
      (z-pos -1)
      (name "spiny")
      (width 200)
      (height 60)
      (tiles -5171 0 130 -199 0 129 -199 0 129 -199 0 129 -199 0 129 -199 0 129 -199 0 129 -199 0 4967 -386 0 1972 1980 1984 -2 0 1972 1984 -193 0 1974 -2 1978 -2 1980 1978 1986 -193 0 1975 1979 1983 -2 1979 1983 1987 -4635 0)
    )
    (tilemap
      (solid #f)
      (z-pos 100)
      (name "fg")
      (width 200)
      (height 60)
      (tiles -5173 0 130 -199 0 129 -199 0 129 -199 0 129 -199 0 129 -199 0 129 -199 0 129 -199 0 4967 -5426 0)
    )
    (torch
      (z-pos 0)
      (x 736)
      (y 896)
    )
    (torch
      (sprite "/images/objects/torch/torch2.sprite")
      (z-pos 0)
      (x 224)
      (y 832)
    )
    (torch
      (sprite "/images/objects/torch/torch2.sprite")
      (z-pos 0)
      (x 6176)
      (y 960)
    )
    (torch
      (sprite "/images/objects/torch/torch2.sprite")
      (z-pos 0)
      (x 5760)
      (y 960)
    )
  )
)
