(supertux-level
  (version 3)
  (name (_ "Overexposed"))
  (author "Daniel Ward")
  (contact "weluvgoatz@gmail.com")
  (license "GPL 2+ / CC-by-sa 3.0")
  (allow-item-pocket "inherit")
  (icon "")
  (icon-locked "")
  (statistics
    (enable-coins #t)
    (enable-secrets #t)
  )
  (sector
    (name "main")
    (ambient-light
      (color 0.25 0.3 0.35)
    )
    (background
      (color 1 1 1)
      (alignment "bottom")
      (speed 0.05)
      (image "images/background/halloween/mountain_panorama.png")
      (z-pos -150)
    )
    (background
      (color 1 1 1)
      (speed 0)
      (image "images/background/halloween/sky.png")
    )
    (background
      (color 1 1 1)
      (alignment "bottom")
      (speed 1.5)
      (speed-y 0)
      (image "images/background/halloween/fog.png")
      (z-pos 100)
    )
    (background
      (color 1 1 1)
      (alignment "bottom")
      (speed 0.25)
      (image "images/background/halloween/fog.png")
      (z-pos -105)
    )
    (background
      (color 1 1 1)
      (speed 0)
      (fill #t)
      (image "images/background/misc/vignette.png")
      (z-pos 200)
    )
    (bonusblock
      (type "orange")
      (z-pos 51)
      (x 5024)
      (y 320)
    )
    (bonusblock
      (type "purple")
      (z-pos 51)
      (x 5952)
      (y 288)
    )
    (bonusblock
      (type "orange")
      (z-pos 51)
      (x 10976)
      (y 576)
    )
    (bouncingsnowball
      (type "fatbat")
      (z-pos 50)
      (x 6528)
      (y 800)
      (glinting #f)
    )
    (bouncingsnowball
      (type "fatbat")
      (z-pos 50)
      (x 6272)
      (y 800)
      (glinting #f)
    )
    (bouncingsnowball
      (type "fatbat")
      (z-pos 50)
      (x 8144)
      (y 832)
      (glinting #f)
    )
    (bouncingsnowball
      (type "fatbat")
      (z-pos 50)
      (x 10656)
      (y 784)
      (glinting #f)
    )
    (bouncingsnowball
      (type "fatbat")
      (z-pos 50)
      (x 10528)
      (y 784)
      (glinting #f)
    )
    (bouncingsnowball
      (type "fatbat")
      (z-pos 50)
      (x 10400)
      (y 848)
      (glinting #f)
    )
    (camera
      (name "Camera")
      (mode "normal")
    )
    (coin
      (z-pos -49)
      (x 6176)
      (y 608)
    )
    (coin
      (z-pos -49)
      (x 6176)
      (y 640)
    )
    (coin
      (z-pos -49)
      (x 6208)
      (y 640)
    )
    (coin
      (z-pos -49)
      (x 6208)
      (y 672)
    )
    (coin
      (z-pos -49)
      (x 6240)
      (y 672)
    )
    (coin
      (z-pos -49)
      (x 6176)
      (y 672)
    )
    (coin
      (z-pos -49)
      (x 5952)
      (y 416)
    )
    (coin
      (z-pos -49)
      (x 5952)
      (y 448)
    )
    (coin
      (z-pos -49)
      (x 5984)
      (y 448)
    )
    (coin
      (z-pos -49)
      (x 5920)
      (y 448)
    )
    (coin
      (z-pos -49)
      (x 9312)
      (y 896)
    )
    (coin
      (z-pos -49)
      (x 9280)
      (y 896)
    )
    (coin
      (z-pos -49)
      (x 9280)
      (y 928)
    )
    (coin
      (z-pos -49)
      (x 9248)
      (y 928)
    )
    (coin
      (z-pos -49)
      (x 9216)
      (y 928)
    )
    (coin
      (z-pos -49)
      (x 9184)
      (y 928)
    )
    (editor-comment
      (name "cutscene - tux sees skullyhops rise from the ground.")
      (width 96)
      (height 96)
      (x 13232)
      (y 704)
      (comment "cutscene - tux sees skullyhop rise from the ground below")
    )
    (firefly
      (z-pos 0)
      (x 12752)
      (y 720)
    )
    (music
      (file "/music/misc/halloween_1.music")
    )
    (secretarea
      (width 32)
      (height 96)
      (x 5312)
      (y 704)
    )
    (smartball
      (type "pumpkin")
      (z-pos 50)
      (x 3424)
      (y 896)
      (glinting #f)
    )
    (smartball
      (type "pumpkin")
      (z-pos 50)
      (x 3680)
      (y 896)
      (glinting #f)
    )
    (smartball
      (type "pumpkin")
      (z-pos 50)
      (x 4128)
      (y 768)
      (glinting #f)
    )
    (smartball
      (type "pumpkin")
      (z-pos 50)
      (x 7136)
      (y 768)
      (glinting #f)
    )
    (smartball
      (type "pumpkin")
      (z-pos 50)
      (x 7456)
      (y 800)
      (glinting #f)
    )
    (smartball
      (type "pumpkin")
      (z-pos 50)
      (x 11904)
      (y 800)
      (glinting #f)
    )
    (snowball
      (type "bumpkin")
      (z-pos 50)
      (x 3552)
      (y 896)
      (glinting #f)
    )
    (snowball
      (type "bumpkin")
      (z-pos 50)
      (x 4768)
      (y 544)
      (glinting #f)
    )
    (snowball
      (type "bumpkin")
      (z-pos 50)
      (x 5056)
      (y 544)
      (glinting #f)
    )
    (snowball
      (type "bumpkin")
      (z-pos 50)
      (x 5344)
      (y 544)
      (glinting #f)
    )
    (snowball
      (type "bumpkin")
      (z-pos 50)
      (x 12032)
      (y 800)
      (glinting #f)
    )
    (snowball
      (type "bumpkin")
      (z-pos 50)
      (x 12160)
      (y 800)
      (glinting #f)
    )
    (snowball
      (type "bumpkin")
      (z-pos 50)
      (x 12288)
      (y 800)
      (glinting #f)
    )
    (spawnpoint
      (name "main")
      (x 416)
      (y 800)
    )
    (spawnpoint
      (x 6720)
      (y 736)
    )
    (tilemap
      (solid #t)
      (z-pos 0)
      (width 700)
      (height 40)
      (tiles -7152 0 102 3159 -2 83 3159 -2129 0 7395 -18 0 102 -643 0 3160 -3 3159 -4 0 -3 3159 3160 -8 0 44 -2 0 44 -12 0 -3 7395 -696 0 -7 48 -676 0 44 -175 0 44 -25 0 44 -466 0 44 -37 0 44 -27 0 -5 3159 -627 0 44 -5 0 -28 48 -173 0 44 -3 0 44 -21 0 44 0 102 0 44 -465 0 44 -2 0 48 -11 0 48 -13 0 -2 48 -25 0 7395 -641 0 44 -4 0 48 -18 0 -9 48 -25 0 -2 7395 -148 0 44 -25 0 44 -459 0 44 -10 0 48 -16 0 -3 48 -6 0 -2 48 -6 0 44 -18 0 -3 7395 -635 0 44 -2 0 -4 48 -2 0 -3 48 -14 0 -2 48 -33 0 -7 48 -142 0 -3 3159 3160 3159 -21 0 3159 3160 -3 3159 -407 0 -2 44 -47 0 44 -13 0 48 -14 0 48 -4 0 103 -9 0 44 -3 0 44 -65 0 -2 44 -83 0 44 -372 0 -8 48 -71 0 -2 44 -2 0 -2 44 -45 0 44 -11 0 -4 48 -11 0 48 -50 0 -5 48 -29 0 -2 44 -81 0 44 -69 0 -8 48 -304 0 -2 48 -26 0 -7 48 -26 0 -10 48 -5 0 -2 44 -2 0 -2 44 -55 0 48 -12 0 48 -8 0 -3 48 -5 0 44 -33 0 48 -3 0 48 -7 0 -5 48 -17 0 -2 44 -151 0 48 -6 0 48 -4 0 -16 48 -285 0 -2 48 -22 0 -4 48 -5 0 48 -5 0 -4 48 -17 0 48 -8 0 -5 48 -5 0 -2 44 -38 0 -6 48 -11 0 -2 48 -11 0 48 -7 0 -2 48 0 48 -39 0 48 -3 0 48 -7 0 48 -3 0 48 -5 0 -5 48 -56 0 3159 -32 0 44 -4 0 -19 48 -16 28 29 -25 48 -5 0 48 -5 0 -2 48 -3 0 5582 -2 48 -13 0 48 -286 0 -24 48 -8 0 48 -4 0 5582 48 -2 0 48 -5 0 -4 48 -7 0 5582 48 -12 0 -5 48 -58 0 -2 48 -11 0 -9 48 -2 0 48 -38 0 -2 48 -3 0 48 5582 -6 0 48 -3 0 48 -5 0 48 -3 0 48 -5 0 -6 48 -2 0 -9 48 -33 0 -3 3159 -26 0 44 -9 0 48 -16 0 -2 48 -17 0 -2 48 -22 0 48 5582 -4 0 -2 48 -3 0 -2 48 -4 0 1975 1984 -2 48 -11 0 -2 48 -318 0 48 5582 -3 0 5580 48 -2 0 48 -4 0 5582 -4 48 -7 0 5580 48 -16 0 -5 48 -45 0 -3 7395 -6 0 -2 48 -22 0 -40 48 -4 0 48 5580 -6 0 -5 48 -5 0 48 -3 0 48 -13 0 -5 48 -3 0 48 -28 0 3159 -4 0 -2 7395 47 -24 0 44 -7 0 -5 48 -15 0 -3 48 -17 0 -2 48 -21 0 -2 48 5584 -5 0 -5 48 -6 0 1975 1984 -2 48 -10 0 48 -319 0 48 5580 -2 0 1972 1986 48 -2 0 48 5582 -2 0 1972 1986 -4 48 0 1972 1984 -2 0 1972 5583 1987 48 -20 0 -27 48 -18 0 -5 7395 -5 0 48 -67 0 48 1973 1984 -6 0 -3 48 -6 0 -5 48 -12 0 5582 -6 48 -2 0 -5 48 -23 0 27 29 3160 -4 7395 27 29 -32 0 48 -19 0 -2 48 -18 0 -2 48 -20 0 -2 48 1972 1987 -17 0 1973 5579 48 -9 0 -2 48 -319 0 48 1974 1980 1976 1983 1987 48 -2 0 48 1975 5578 1980 1981 1985 -4 48 5577 -2 1979 1984 0 5580 -3 48 -46 0 48 5582 -5 0 -18 48 5582 -3 0 48 -67 0 48 1974 1987 -16 0 -3 48 -13 0 5580 -3 48 -9 0 48 -24 0 27 -5 28 29 -24 0 44 -4 0 -5 48 -19 0 -2 48 -19 0 -2 48 -18 0 -2 48 1972 1985 0 1972 -4 5583 5578 5583 5578 5583 5578 1984 0 1972 1984 -3 0 5584 -2 48 -8 0 -2 48 -320 0 48 1975 1979 1987 -3 48 -2 0 -3 48 1975 1979 1987 -7 48 1975 5578 1987 48 -48 0 48 5584 -4 0 5582 48 -16 0 48 1975 5583 1984 0 48 -67 0 48 5580 -33 0 1975 5578 1984 -2 48 -8 0 -5 48 -20 0 3171 3172 27 28 29 3171 3172 -29 0 48 -23 0 -2 48 -19 0 -2 48 -17 0 -2 48 5577 -2 1983 5578 1987 -9 48 1975 5578 -2 1979 1980 1976 5578 1987 48 -8 0 -2 48 -321 0 -5 48 -6 0 -6 48 -4 0 -5 48 -48 0 48 5584 0 1972 1984 0 5580 48 -16 0 -3 48 5580 0 48 -66 0 -2 48 5580 -9 0 1972 1984 -18 0 1972 1980 1984 -3 0 1974 1984 48 -12 0 48 -20 0 3177 3178 -3 0 3177 3178 -25 0 -5 48 -23 0 48 -21 0 -2 48 -16 0 -8 48 -7 0 -5 48 1975 1987 -3 48 -8 0 48 -336 0 -3 48 -57 0 48 1975 5578 1983 1981 1980 1986 48 -18 0 48 1975 5579 48 -66 0 -2 48 1974 1984 0 1972 -2 5578 -2 5583 5578 5583 1979 1983 5578 5583 5578 1984 -12 0 1972 5583 -2 1979 1983 -2 5578 1980 1982 1987 -2 48 -11 0 -15 48 27 -17 28 29 -20 48 -27 0 48 -21 0 -2 48 -35 0 -4 48 -10 0 48 -396 0 -4 48 1975 1979 1987 48 -18 0 -4 48 -66 0 -3 48 1983 5583 1987 -11 48 1975 -2 5578 1984 -2 0 1972 1976 1984 -2 0 1972 5583 1987 -6 48 1975 1987 -2 48 -26 0 48 -19 0 48 -45 0 -2 48 -21 0 -2 48 -49 0 48 -399 0 -5 48 -89 0 -6 48 -8 0 -5 48 1975 -2 5583 -2 1983 1979 5578 5583 1987 -3 48 -5 0 -3 48 -26 0 -2 48 -19 0 -2 48 -44 0 48 -23 0 -2 48 -48 0 48 -493 0 48 -14 0 -2 48 0 -11 48 -35 0 -2 48 -21 0 -3 48 -42 0 48 -23 0 -2 48 -48 0 48 -493 0 48 -62 0 -2 48 -24 0 -3 48 -40 0 48 -23 0 -2 48 -48 0 48 -493 0 48 -62 0 48 -27 0 -2 48 -39 0 48 -24 0 48 -48 0 48 -493 0 48 -62 0 48 -28 0 -2 48 -38 0 48 -24 0 -2 48 -47 0 48 -281 0)
    )
    (torch
      (z-pos 0)
      (x 1312)
      (y 704)
    )
    (torch
      (sprite "/images/objects/torch/torch2.sprite")
      (z-pos 0)
      (x 2192)
      (y 704)
    )
    (torch
      (z-pos 0)
      (x 2960)
      (y 832)
    )
    (torch
      (sprite "/images/objects/torch/torch2.sprite")
      (z-pos 0)
      (x 4208)
      (y 736)
    )
    (torch
      (sprite "/images/objects/torch/torch2.sprite")
      (z-pos 0)
      (x 4464)
      (y 480)
    )
    (torch
      (z-pos 0)
      (x 5296)
      (y 480)
    )
    (torch
      (sprite "/images/objects/torch/torch3.sprite")
      (z-pos 0)
      (x 5968)
      (y 800)
    )
    (torch
      (sprite "/images/objects/torch/torch3.sprite")
      (z-pos 0)
      (x 6720)
      (y 672)
    )
    (torch
      (sprite "/images/objects/torch/torch3.sprite")
      (z-pos 0)
      (x 7104)
      (y 704)
    )
    (torch
      (sprite "/images/objects/torch/torch3.sprite")
      (z-pos 0)
      (x 7424)
      (y 736)
    )
    (torch
      (sprite "/images/objects/torch/torch3.sprite")
      (z-pos 0)
      (x 7760)
      (y 768)
    )
    (torch
      (z-pos 0)
      (x 8864)
      (y 960)
    )
    (torch
      (sprite "/images/objects/torch/torch2.sprite")
      (z-pos 0)
      (x 9568)
      (y 960)
    )
    (torch
      (z-pos 0)
      (x 11088)
      (y 736)
    )
    (torch
      (sprite "/images/objects/torch/torch2.sprite")
      (z-pos 0)
      (x 11696)
      (y 736)
    )
    (torch
      (sprite "/images/objects/torch/torch3.sprite")
      (z-pos 0)
      (x 12832)
      (y 672)
    )
    (torch
      (sprite "/images/objects/torch/torch3.sprite")
      (z-pos 0)
      (x 12672)
      (y 672)
    )
  )
)
