(supertux-level
  (version 3)
  (name (_ "Halloween 2014"))
  (author "Ingo Ruhnke")
  (contact "grumbel@gmail.com")
  (license "CC-BY-SA 4.0 International")
  (allow-item-pocket "on")
  (icon "")
  (icon-locked "")
  (sector
    (name "main")
    (ambient-light
      (color 0.75 0.75 0.75)
    )
    (background
      (color 1 1 1)
      (speed 0.5)
      (image "images/background/misc/transparent_up.png")
    )
    (background
      (color 1 1 1)
      (speed 0)
      (fill #t)
      (image "/images/background/misc/vignette.png")
      (z-pos 300)
    )
    (decal
      (z-pos 50)
      (sprite "images/worldmap/halloween/scarecrow.png")
      (x 1248)
      (y 576)
    )
    (decal
      (z-pos 50)
      (sprite "images/worldmap/halloween/scarecrow.png")
      (x 1536)
      (y 608)
    )
    (decal
      (z-pos 50)
      (sprite "images/worldmap/halloween/scarecrow.png")
      (x 1056)
      (y 512)
    )
    (decal
      (z-pos 50)
      (sprite "images/worldmap/halloween/scarecrow.png")
      (x 1472)
      (y 832)
    )
    (decal
      (z-pos 50)
      (sprite "images/worldmap/halloween/scarecrow.png")
      (x 832)
      (y 384)
    )
    (decal
      (z-pos 1)
      (sprite "/images/worldmap/halloween/pumpkin_hut.png")
      (x 1632)
      (y 608)
    )
    (decal
      (z-pos 1)
      (sprite "/images/worldmap/halloween/pumpkin_hut.png")
      (x 896)
      (y 576)
    )
    (decal
      (z-pos 1)
      (sprite "/images/worldmap/shared/library.png")
      (x 1216)
      (y 768)
    )
    (level
      (z-pos 50)
      (level "overexposed.stl")
      (x 31)
      (y 22)
    )
    (level
      (z-pos 50)
      (level "pest_control.stl")
      (x 44)
      (y 24)
    )
    (level
      (z-pos 50)
      (level "green_little_ghosts.stl")
      (x 35)
      (y 19)
    )
    (level
      (z-pos 50)
      (level "library_of_ghouls.stl")
      (x 39)
      (y 26)
    )
    (level
      (z-pos 50)
      (level "death_by_disco.stl")
      (x 48)
      (y 23)
    )
    (level
      (z-pos 50)
      (level "intro.stl")
      (auto-play #t)
      (sprite "images/objects/invisible/invisible.sprite")
      (x 29)
      (y 20)
    )
    (level
      (z-pos 50)
      (level "outro.stl")
      (sprite "images/objects/invisible/invisible.sprite")
      (x 52)
      (y 21)
    )
    (music
      (file "/music/forest/wisphunt.music")
    )
    (tilemap
      (solid #f)
      (z-pos -150)
      (name "Splash")
      (width 80)
      (height 45)
      (tiles 509 -78 510 511 512 -78 513 514 512 -78 513 514 512 -78 513 514 512 -78 513 514 512 -78 513 514 512 -78 513 514 512 -78 513 514 512 -78 513 514 512 -78 513 514 512 -20 513 518 -7 516 519 -8 513 518 -3 516 519 -37 513 512 -19 513 518 -8 0 515 519 -6 513 518 517 -3 0 515 -5 516 519 -3 513 518 -4 516 519 -22 513 512 -19 513 514 -2 0 493 494 495 496 -3 0 515 519 -5 513 514 0 493 496 -7 0 515 519 -2 513 514 0 493 494 496 515 519 -21 513 512 -19 513 514 0 493 508 -2 0 507 495 496 -2 0 515 -5 516 517 0 501 504 -8 0 512 513 518 517 493 508 0 498 0 515 519 -20 513 512 -19 513 514 0 501 506 -4 0 498 -17 0 493 496 0 512 513 514 0 497 -2 0 507 496 0 512 -20 513 521 -19 513 520 511 0 501 502 503 502 503 504 -11 0 509 510 511 -3 0 501 504 0 515 519 520 511 501 502 503 502 504 0 512 -41 513 520 511 -11 0 493 494 495 496 -2 0 515 519 520 511 -6 0 515 519 520 511 -5 0 512 -42 513 514 -9 0 493 494 508 -2 0 507 495 496 0 515 519 520 510 511 -5 0 512 513 520 -5 510 521 -41 513 518 517 -4 0 493 494 495 494 495 508 -6 0 507 496 0 515 -2 516 517 -5 0 515 -2 516 519 -46 513 514 -5 0 497 -12 0 498 -6 0 493 494 495 496 493 495 496 515 519 -45 513 520 511 -4 0 501 506 -4 0 505 502 506 -4 0 507 495 496 -2 0 493 494 508 -2 0 507 508 0 498 0 515 519 -45 513 520 510 511 -3 0 497 -4 0 498 0 501 506 -2 0 505 502 506 507 494 495 508 -7 0 500 -2 0 515 519 -46 513 514 -3 0 499 -4 0 500 0 493 508 -2 0 498 0 497 -11 0 498 -3 0 512 -46 513 514 -3 0 501 502 503 506 0 507 494 508 -3 0 507 494 508 -11 0 500 -3 0 512 -44 513 518 516 517 -6 0 497 -21 0 504 -3 0 512 -44 513 514 -8 0 499 -12 0 505 506 -6 0 500 -2 0 509 510 521 -43 513 518 517 -8 0 501 502 503 506 -9 0 507 508 -3 0 505 502 503 504 -2 0 512 -45 513 514 -12 0 501 502 506 -12 0 500 -5 0 515 519 -44 513 514 -4 0 493 494 496 -7 0 501 502 503 502 503 506 -2 0 505 502 503 502 503 504 -6 0 515 519 -43 513 514 -3 0 493 508 0 507 495 496 -10 0 501 502 503 504 -12 0 512 -43 513 514 -3 0 501 506 -3 0 498 -23 0 493 496 0 512 -43 513 520 511 -3 0 501 502 503 502 504 0 509 -6 510 511 -3 0 493 496 -3 0 509 -3 510 511 0 501 504 0 512 -44 513 520 510 511 -6 0 509 521 -6 513 520 510 511 0 501 504 -2 0 509 521 -3 513 520 511 -3 0 512 -46 513 520 -6 510 521 -9 513 520 -5 510 521 -5 513 520 -3 510 521 -822 513 -20 516 519 -59 513)
    )
    (tilemap
      (solid #t)
      (z-pos 0)
      (name "Interactive")
      (width 80)
      (height 45)
      (tiles -1064 0 475 -2 476 478 -26 0 475 478 -48 0 485 -2 486 488 -26 0 485 488 -376 0 423 -4 435 424 -71 0 432 -2 0 436 -4 0 436 -71 0 425 424 0 436 -4 0 436 -14 0 432 -57 0 425 435 426 -4 0 436 -12 0 423 435 426 -64 0 436 -9 0 423 -2 435 426 -66 0 436 -3 0 423 -5 435 426 -69 0 436 -3 0 436 -75 0 425 -3 435 426 -224 0 475 478 -78 0 485 488 -26 0 475 478 -78 0 485 488 -1064 0)
    )
    (tilemap
      (solid #f)
      (z-pos -200)
      (name "Water")
      (width 80)
      (height 45)
      (tiles -3600 1)
    )
    (tilemap
      (solid #f)
      (z-pos -50)
      (width 80)
      (height 45)
      (tiles -983 0 475 -2 476 478 -12 0 475 478 -13 0 475 476 478 -45 0 475 489 -2 480 490 476 478 -10 0 485 488 -12 0 475 489 480 482 -45 0 485 491 -4 480 482 -17 0 475 478 -5 0 479 -2 480 490 478 -45 0 485 -4 486 488 -17 0 485 488 -5 0 485 -3 486 488 -56 0 475 -2 476 478 -74 0 475 476 489 -2 480 490 476 478 -67 0 475 -4 476 489 -6 480 490 478 -66 0 479 -12 480 490 478 -5 0 475 -2 476 478 475 476 478 -53 0 485 491 -4 480 492 486 491 -5 480 490 476 478 0 475 476 489 -2 480 490 489 480 482 -54 0 479 -4 480 482 0 485 491 -2 480 492 486 491 480 490 476 489 -7 480 482 -54 0 479 -4 480 482 0 475 489 -2 480 482 0 479 -11 480 482 -54 0 485 486 491 -2 480 490 476 489 -3 480 490 476 489 -11 480 482 -56 0 485 491 -20 480 492 488 -57 0 479 -20 480 482 -58 0 485 -2 486 491 -14 480 492 -2 486 488 -61 0 485 486 491 -12 480 482 -56 0 475 476 478 -7 0 485 -4 486 491 -2 480 492 -4 486 488 -55 0 475 489 480 490 476 478 -10 0 485 -2 486 488 -60 0 485 491 -3 480 482 -75 0 485 -3 486 488 -12 0 475 478 -78 0 485 488 -995 0)
    )
    (tilemap
      (solid #f)
      (z-pos -25)
      (width 80)
      (height 45)
      (tiles -1235 0 888 889 -78 0 890 891 -71 0 884 885 -78 0 886 887 -21 0 888 889 -57 0 888 889 -19 0 890 891 -57 0 890 891 -12 0 884 885 0 475 -2 476 478 -73 0 886 887 475 489 -2 480 490 478 -64 0 475 476 478 -7 0 479 -4 480 482 -64 0 479 480 482 -2 0 475 476 478 0 475 489 -4 480 482 -64 0 479 480 490 -2 476 489 480 482 0 479 -3 480 492 486 488 -63 0 475 489 -6 480 482 0 485 491 492 486 488 -65 0 485 491 -5 480 492 488 884 885 485 488 -68 0 485 -5 486 488 0 886 887 -1394 0)
    )
    (tilemap
      (solid #f)
      (z-pos 100)
      (width 80)
      (height 45)
      (tiles -1555 0 884 885 -78 0 886 887 -84 0 884 885 -68 0 888 889 -8 0 886 887 -68 0 890 891 -80 0 888 889 -7 0 884 885 -6 0 884 885 -61 0 890 891 -7 0 886 887 -6 0 886 887 -1548 0)
    )
    (worldmap-spawnpoint
      (z-pos 50)
      (name "main")
      (x 29)
      (y 20)
    )
  )
  (tileset "/images/ice_world.strf")
)
