(supertux-level
  (version 2)
  (name (_ "Halloween 2014"))
  (author "Ingo Ruhnke <grumbel@gmail.com>")
  (target-time 0)
  (sector
    (name "main")
    (music "music/voc-dark.music")
    (ambient-light 0.75 0.75 0.75)
    (camera
      (mode "normal")
    )
    (decal
      (x 272)
      (y 276)
      (layer 1)
      (sprite "images/worldmap/halloween/home.png")
    )
    (decal
      (x 576)
      (y 224)
      (sprite "images/worldmap/halloween/scarecrow.png")
    )
    (decal
      (x 864)
      (y 512)
      (sprite "images/worldmap/halloween/scarecrow.png")
    )
    (decal
      (x 1008)
      (y 308)
      (layer 1)
      (sprite "images/worldmap/halloween/home.png")
    )
    (decal
      (x 192)
      (y 64)
      (sprite "images/worldmap/halloween/scarecrow.png")
    )
    (decal
      (x 864)
      (y 320)
      (sprite "images/worldmap/halloween/tree1.png")
    )
    (decal
      (x 608)
      (y 32)
      (sprite "images/worldmap/halloween/tree2.png")
    )
    (decal
      (x 448)
      (y 192)
      (sprite "images/worldmap/halloween/tree1.png")
    )
    (decal
      (x 640)
      (y 384)
      (sprite "images/worldmap/halloween/tree2.png")
    )
    (decal
      (x 416)
      (y 448)
      (sprite "images/worldmap/halloween/tree2.png")
    )
    (decal
      (x 928)
      (y 416)
      (sprite "images/worldmap/halloween/tree2.png")
    )
    (decal
      (x 704)
      (y 544)
      (sprite "images/worldmap/halloween/tree1.png")
    )
    (decal
      (x 1088)
      (y 608)
      (sprite "images/worldmap/halloween/tree1.png")
    )
    (decal
      (x 288)
      (y 608)
      (sprite "images/worldmap/halloween/tree2.png")
    )
    (decal
      (x 896)
      (y 256)
      (sprite "images/worldmap/halloween/tree2.png")
    )
    (decal
      (x 736)
      (y 352)
      (sprite "images/worldmap/halloween/tree1.png")
    )
    (decal
      (x 800)
      (y 320)
      (sprite "images/worldmap/halloween/tree2.png")
    )
    (decal
      (x 864)
      (y 320)
      (sprite "images/worldmap/halloween/tree1.png")
    )
    (decal
      (sprite "images/background/halloween/vignette.png")
    )
    (tilemap
      (solid #f)
      (z-pos -100)
      (name "Splash")
      (width 40)
      (height 25)
      (tiles
      1985 1982 1990 1990 1990 1990 1990 1990 1990 1983 1985 1985 1985 1985 1985 1985 1985 1985 1982 1990 1990 1990 1983 1985 1985 1985 1985 1985 1985 1985 1985 1985 1985 1985 1985 1985 1985 1985 1985 1985
      1982 1991 0 0 0 0 0 0 0 1989 1983 1985 1985 1985 1985 1985 1985 1982 1991 0 0 0 1989 1990 1990 1990 1990 1990 1983 1985 1985 1985 1982 1990 1990 1990 1990 1983 1985 1985
      1986 0 0 1955 1956 1957 1958 0 0 0 1989 1983 1985 1985 1985 1985 1985 1986 0 1955 1958 0 0 0 0 0 0 0 1989 1983 1985 1985 1986 0 1955 1957 1958 1989 1983 1985
      1986 0 1955 1966 0 0 1965 1956 1958 0 0 1989 1990 1990 1990 1990 1990 1991 0 1973 1976 0 0 0 0 0 0 0 0 1984 1985 1982 1991 1955 1966 0 1964 0 1989 1983
      1986 0 1973 0 0 0 0 0 1964 0 0 0 0 0 0 0 0 0 0 0 0 0 0 0 0 0 1955 1958 0 1984 1985 1986 1971 1967 1968 0 1965 1958 0 1984
      1986 1971 0 1973 1974 1974 1975 1975 1976 0 0 0 0 0 0 0 0 0 0 0 1979 1980 1981 0 0 0 1973 1976 0 1989 1983 1987 1981 1973 1974 1974 1975 1976 0 1984
      1987 1981 0 0 0 0 0 0 0 0 0 0 0 0 1955 1956 1956 1958 0 0 1989 1983 1987 1981 0 0 0 0 0 0 1989 1983 1987 1981 0 0 0 0 0 1984
      1985 1987 1981 0 0 0 0 0 0 0 0 0 1955 1956 1966 0 0 1965 1956 1958 0 1989 1983 1987 1980 1981 0 0 0 0 0 1984 1985 1987 1980 1980 1980 1980 1980 1988
      1985 1982 1991 0 0 0 0 1955 1956 1956 1957 1956 1966 0 0 0 0 0 0 1965 1958 0 1989 1990 1990 1991 0 0 0 0 0 1989 1990 1990 1983 1985 1985 1985 1985 1985
      1985 1986 1971 1972 0 0 0 1967 0 0 0 1966 1934 1934 1934 1934 1934 1934 0 0 1964 0 0 0 0 0 0 1955 1957 1957 1958 1955 1957 1958 1989 1983 1985 1985 1985 1985
      1985 1987 1981 1978 0 0 0 1973 1960 1934 0 0 1934 1959 1974 0 0 1934 0 0 1965 1957 1958 0 0 1955 1957 1966 0 0 1965 1966 1958 1964 0 1989 1983 1985 1985 1985
      1985 1985 1987 1980 1981 0 0 0 1967 1934 1934 1934 1934 1964 0 1973 0 1934 0 0 0 0 1965 1956 1957 1966 0 0 0 0 0 0 1934 1964 0 0 1989 1983 1985 1985
      1985 1985 1985 1985 1986 0 0 0 1967 1968 0 0 1934 1964 0 1955 1966 1934 1934 1934 1934 1934 1934 0 0 0 0 0 0 0 1934 1934 1934 1964 0 0 0 1984 1985 1985
      1985 1985 1985 1985 1986 0 0 0 1973 1974 1975 1960 1934 1965 1956 1966 0 0 0 0 0 0 1934 0 0 0 0 1934 1934 1934 1934 0 0 1964 0 0 0 1984 1985 1985
      1985 1985 1982 1990 1991 0 0 0 0 0 0 1961 1934 1934 1934 1934 1934 1934 1934 0 0 0 1934 0 1934 1934 1934 1934 0 0 0 0 1959 1976 0 0 0 1984 1985 1985
      1985 1985 1986 0 0 0 0 0 0 0 0 1967 1968 1969 0 0 0 0 1934 1934 1934 1934 1934 1934 1934 0 0 0 0 0 0 0 1964 0 0 1979 1980 1988 1985 1985
      1985 1982 1991 1993 0 0 0 0 0 0 0 1973 1974 1975 1960 0 0 0 0 0 0 0 0 0 0 0 0 0 0 1959 1974 1975 1976 0 0 1984 1985 1985 1985 1985
      1985 1986 1971 0 0 0 0 0 0 0 0 0 0 0 1973 1975 1960 0 0 0 0 0 0 0 0 0 0 0 0 1964 0 0 0 0 0 1989 1983 1985 1985 1985
      1985 1986 0 0 0 0 1955 1956 1958 0 0 0 0 0 0 0 1973 1974 1975 1974 1975 1960 0 0 0 1974 1975 1974 1975 1976 0 0 0 0 0 0 1989 1983 1985 1985
      1985 1986 0 0 0 1955 1966 0 1965 1956 1958 0 0 0 0 0 0 0 0 0 0 1973 1974 1975 1976 0 0 0 0 0 0 0 0 0 0 0 0 1984 1985 1985
      1985 1986 0 0 0 1973 0 0 0 0 1970 0 0 0 0 0 0 0 0 0 0 0 0 0 0 0 0 0 0 0 0 0 0 0 1955 1958 0 1984 1985 1985
      1985 1987 1981 0 0 0 1973 1974 1975 1974 1976 0 1979 1980 1980 1980 1980 1980 1980 1981 0 0 0 1955 1958 0 0 0 1979 1980 1980 1980 1981 0 1973 1976 0 1984 1985 1985
      1985 1985 1987 1980 1981 0 0 0 0 0 0 1979 1988 1985 1985 1985 1985 1985 1985 1987 1980 1981 0 1973 1976 0 0 1979 1988 1985 1985 1985 1987 1981 0 0 0 1984 1985 1985
      1985 1985 1985 1985 1987 1980 1980 1980 1980 1980 1980 1988 1985 1985 1985 1985 1985 1985 1985 1985 1985 1987 1980 1980 1980 1980 1980 1988 1985 1985 1985 1985 1985 1987 1980 1980 1980 1988 1985 1985
      1985 1985 1985 1985 1985 1985 1985 1985 1985 1985 1985 1985 1985 1985 1985 1985 1985 1985 1985 1985 1985 1985 1985 1985 1985 1985 1985 1985 1985 1985 1985 1985 1985 1985 1985 1985 1985 1985 1985 1985
      )
    )
    (tilemap
      (solid #t)
      (z-pos 0)
      (name "Interactive")
      (width 40)
      (height 25)
      (tiles
      0 0 0 0 0 0 0 0 0 0 0 0 0 0 0 0 0 0 0 0 0 0 0 0 0 0 0 0 0 0 0 0 0 0 0 0 0 0 0 0
      0 0 0 0 0 0 0 0 0 0 0 0 0 0 0 0 0 0 0 0 0 0 0 0 0 0 0 0 0 0 0 0 0 0 0 0 0 0 0 0
      0 0 0 1954 1927 1928 1929 0 0 0 0 0 0 0 0 0 0 0 0 1954 1929 0 0 0 0 0 0 0 0 0 0 0 0 0 1954 1928 1929 0 0 0
      0 0 1954 1938 1934 1935 1937 1928 1929 0 0 0 0 0 0 0 0 0 0 1947 1950 0 0 0 0 0 0 0 0 0 0 0 0 1954 1938 1935 1936 0 0 0
      0 0 1947 1931 1941 1942 1941 1942 1936 0 0 0 0 0 0 0 0 0 0 0 0 0 0 0 0 0 1954 1929 0 0 0 0 0 1940 1941 1942 1937 1929 0 0
      0 0 0 1947 1948 1949 1948 1949 1950 0 0 0 0 0 0 0 0 0 0 0 0 0 0 0 0 0 1947 1950 0 0 0 0 0 1947 1948 1949 1949 1950 0 0
      0 0 0 0 0 0 0 0 0 0 0 0 0 0 1954 1927 1928 1929 0 0 0 0 0 0 0 0 0 0 0 0 0 0 0 0 0 0 0 0 0 0
      0 0 0 0 0 0 0 0 0 0 0 0 1954 1927 1938 1934 1935 1937 1928 1929 0 0 0 0 0 0 0 0 0 0 0 0 0 0 0 0 0 0 0 0
      0 0 0 0 0 0 0 1954 1927 1927 1928 1928 1938 1935 1935 1935 1935 1935 1935 1937 1929 0 0 0 0 0 0 0 0 0 0 0 0 0 0 0 0 0 0 0
      0 0 0 0 0 0 0 1940 1935 1935 1935 1935 1994 2008 2008 2008 2008 1995 1934 1935 1936 0 0 0 0 0 0 1954 1927 1928 1929 1954 1927 1929 0 0 0 0 0 0
      0 0 0 0 0 0 0 1947 1931 2002 1941 1941 2004 1930 1948 1931 1942 2004 1934 1935 1937 1928 1929 0 0 1954 1927 1938 1934 1935 1937 1938 1935 1936 0 0 0 0 0 0
      0 0 0 0 0 0 0 0 1933 1998 2008 2008 2001 1936 0 1947 1931 2004 1934 1934 1934 1935 1937 1927 1928 1938 1935 1935 1935 1935 1935 1935 2002 1936 0 1971 1972 0 0 0
      0 0 0 0 0 0 0 0 1940 1935 1935 1935 2004 1936 0 1954 1938 1998 2008 2008 2008 2008 1995 1935 1935 1934 1935 1934 1935 1934 1994 2008 1999 1936 0 0 0 0 0 0
      0 0 0 0 0 0 0 0 1947 1948 1949 1931 2004 1937 1928 1938 1942 1935 1934 1935 1935 1934 2004 1934 1935 1934 1935 1994 2008 2008 1999 1934 1935 1943 0 0 0 0 0 0
      0 0 0 0 0 0 0 0 0 0 0 1933 1998 2008 2008 2008 2008 2008 1995 1942 1942 1935 2004 1935 1994 2008 2008 1999 1935 1935 1935 1934 1930 1950 0 0 0 0 0 0
      0 0 0 0 0 0 0 0 0 0 0 1940 1941 1942 1941 1935 1935 1934 1998 2008 2008 2008 2000 2008 1999 1934 1934 1934 1935 1935 1935 1942 1943 0 0 0 0 0 0 0
      0 0 0 0 0 0 0 0 0 0 0 1947 1948 1949 1931 1942 1942 1941 1934 1934 1934 1935 1934 1935 1934 1935 1934 1935 1934 1930 1949 1949 1950 0 0 0 0 0 0 0
      0 0 0 0 0 0 0 0 0 0 0 0 0 0 1947 1948 1931 1942 1934 1935 1934 1935 1934 1935 1934 1935 1934 1935 1942 1943 0 0 0 0 0 0 0 0 0 0
      0 0 0 0 0 0 1954 1928 1929 0 0 0 0 0 0 0 1947 1948 1948 1948 1949 1931 1935 1935 1930 1948 1949 1948 1949 1950 0 0 0 0 0 0 0 0 0 0
      0 0 0 0 0 1954 1938 1935 1937 1928 1929 0 0 0 0 0 0 0 0 0 0 1947 1948 1949 1950 0 0 0 0 0 0 0 0 0 0 0 0 0 0 0
      0 0 0 0 0 1947 1931 1942 1941 1942 1936 0 0 0 0 0 0 0 0 0 0 0 0 0 0 0 0 0 0 0 0 0 0 0 1954 1929 0 0 0 0
      0 0 0 0 0 0 1947 1949 1948 1949 1950 0 0 0 0 0 0 0 0 0 0 0 0 1954 1929 0 0 0 0 0 0 0 0 0 1947 1950 0 0 0 0
      0 0 0 0 0 0 0 0 0 0 0 0 0 0 0 0 0 0 0 0 0 0 0 1947 1950 0 0 0 0 0 0 0 0 0 0 0 0 0 0 0
      0 0 0 0 0 0 0 0 0 0 0 0 0 0 0 0 0 0 0 0 0 0 0 0 0 0 0 0 0 0 0 0 0 0 0 0 0 0 0 0
      0 0 0 0 0 0 0 0 0 0 0 0 0 0 0 0 0 0 0 0 0 0 0 0 0 0 0 0 0 0 0 0 0 0 0 0 0 0 0 0
      )
    )
    (tilemap
      (solid #f)
      (z-pos 1)
      (name "Foreground")
      (width 40)
      (height 25)
      (tiles
      0 0 0 0 0 0 0 0 0 0 0 0 0 0 0 0 0 0 0 0 0 0 0 0 0 0 0 0 0 0 0 0 0 0 0 0 0 0 0 0
      0 0 0 0 0 0 0 0 0 0 0 0 0 0 0 0 0 0 0 0 0 0 0 0 0 0 0 0 0 0 0 0 0 0 0 0 0 0 0 0
      0 0 0 0 0 0 0 0 0 0 0 0 0 0 0 0 0 0 0 0 0 0 0 0 0 0 0 0 0 0 0 0 0 0 0 0 0 0 0 0
      0 0 0 0 1954 1927 1927 1929 0 0 0 0 0 0 0 0 0 0 0 0 0 0 0 0 0 0 0 0 0 0 0 0 0 0 1954 1929 0 0 0 0
      0 0 0 0 1947 1948 1949 1950 0 0 0 0 0 0 0 0 0 0 0 0 0 0 0 0 0 0 0 0 0 0 0 0 0 0 1947 1950 0 0 0 0
      0 0 0 0 0 0 0 0 0 0 0 0 0 0 0 0 0 0 0 0 0 0 0 0 0 0 0 0 0 0 0 0 0 0 0 0 0 0 0 0
      0 0 0 0 0 0 0 0 0 0 0 0 0 0 0 0 0 0 0 0 0 0 0 0 0 0 0 0 0 0 0 0 0 0 0 0 0 0 0 0
      0 0 0 0 0 0 0 0 0 0 0 0 0 0 0 0 0 0 0 0 0 0 0 0 0 0 0 0 0 0 0 0 0 0 0 0 0 0 0 0
      0 0 0 0 0 0 0 0 0 0 0 0 0 0 0 0 0 0 0 0 0 0 0 0 0 0 0 0 0 0 0 0 0 0 0 0 0 0 0 0
      0 0 0 0 0 0 0 0 0 0 0 0 0 0 0 0 0 0 0 0 0 0 0 0 0 0 0 0 0 0 0 0 0 0 0 0 0 0 0 0
      0 0 0 0 0 0 0 0 0 2002 0 0 0 0 0 0 0 0 0 0 0 0 0 0 0 0 0 0 0 0 0 0 0 0 0 0 0 0 0 0
      0 0 0 0 0 0 0 0 0 0 0 0 0 0 0 0 0 0 0 0 0 0 0 0 0 0 0 0 0 0 0 0 0 0 0 0 0 0 0 0
      0 0 0 0 0 0 0 0 0 0 0 0 0 0 0 0 0 0 0 0 0 0 0 0 0 0 0 0 0 0 0 0 0 0 0 0 0 0 0 0
      0 0 0 0 0 0 0 0 0 0 0 0 0 0 0 0 0 0 0 0 0 0 0 0 0 0 0 0 0 0 0 0 0 0 0 0 0 0 0 0
      0 0 0 0 0 0 0 0 0 0 0 0 0 0 0 0 0 0 0 0 0 0 0 0 0 0 0 0 0 0 0 0 0 0 0 0 0 0 0 0
      0 0 0 0 0 0 0 0 0 0 0 0 0 0 0 0 0 0 0 0 0 0 0 0 0 0 0 0 0 0 0 0 0 0 0 0 0 0 0 0
      0 0 0 0 0 0 0 0 0 0 0 0 0 0 0 0 0 0 0 0 0 0 0 0 0 0 0 0 0 0 0 0 0 0 0 0 0 0 0 0
      0 0 0 0 0 0 0 0 0 0 0 0 0 0 0 0 0 0 0 0 0 0 0 0 0 0 0 0 0 0 0 0 0 0 0 0 0 0 0 0
      0 0 0 0 0 0 0 0 0 0 0 0 0 0 0 0 0 0 0 0 0 0 0 0 0 0 0 0 0 0 0 0 0 0 0 0 0 0 0 0
      0 0 0 0 0 0 1954 1929 0 0 0 0 0 0 0 0 0 0 0 0 0 0 0 0 0 0 0 0 0 0 0 0 0 0 0 0 0 0 0 0
      0 0 0 0 0 0 1947 1950 0 0 0 0 0 0 0 0 0 0 0 0 0 0 0 0 0 0 0 0 0 0 0 0 0 0 0 0 0 0 0 0
      0 0 0 0 0 0 0 0 0 0 0 0 0 0 0 0 0 0 0 0 0 0 0 0 0 0 0 0 0 0 0 0 0 0 0 0 0 0 0 0
      0 0 0 0 0 0 0 0 0 0 0 0 0 0 0 0 0 0 0 0 0 0 0 0 0 0 0 0 0 0 0 0 0 0 0 0 0 0 0 0
      0 0 0 0 0 0 0 0 0 0 0 0 0 0 0 0 0 0 0 0 0 0 0 0 0 0 0 0 0 0 0 0 0 0 0 0 0 0 0 0
      0 0 0 0 0 0 0 0 0 0 0 0 0 0 0 0 0 0 0 0 0 0 0 0 0 0 0 0 0 0 0 0 0 0 0 0 0 0 0 0
      )
    )
    (tilemap
      (solid #f)
      (z-pos -150)
      (name "Water")
      (width 40)
      (height 25)
      (tiles
      1 1 1 1 1 1 1 1 1 1 1 1 1 1 1 1 1 1 1 1 1 1 1 1 1 1 1 1 1 1 1 1 1 1 1 1 1 1 1 1
      1 1 1 1 1 1 1 1 1 1 1 1 1 1 1 1 1 1 1 1 1 1 1 1 1 1 1 1 1 1 1 1 1 1 1 1 1 1 1 1
      1 1 1 1 1 1 1 1 1 1 1 1 1 1 1 1 1 1 1 1 1 1 1 1 1 1 1 1 1 1 1 1 1 1 1 1 1 1 1 1
      1 1 1 1 1 1 1 1 1 1 1 1 1 1 1 1 1 1 1 1 1 1 1 1 1 1 1 1 1 1 1 1 1 1 1 1 1 1 1 1
      1 1 1 1 1 1 1 1 1 1 1 1 1 1 1 1 1 1 1 1 1 1 1 1 1 1 1 1 1 1 1 1 1 1 1 1 1 1 1 1
      1 1 1 1 1 1 1 1 1 1 1 1 1 1 1 1 1 1 1 1 1 1 1 1 1 1 1 1 1 1 1 1 1 1 1 1 1 1 1 1
      1 1 1 1 1 1 1 1 1 1 1 1 1 1 1 1 1 1 1 1 1 1 1 1 1 1 1 1 1 1 1 1 1 1 1 1 1 1 1 1
      1 1 1 1 1 1 1 1 1 1 1 1 1 1 1 1 1 1 1 1 1 1 1 1 1 1 1 1 1 1 1 1 1 1 1 1 1 1 1 1
      1 1 1 1 1 1 1 1 1 1 1 1 1 1 1 1 1 1 1 1 1 1 1 1 1 1 1 1 1 1 1 1 1 1 1 1 1 1 1 1
      1 1 1 1 1 1 1 1 1 1 1 1 1 1 1 1 1 1 1 1 1 1 1 1 1 1 1 1 1 1 1 1 1 1 1 1 1 1 1 1
      1 1 1 1 1 1 1 1 1 1 1 1 1 1 1 1 1 1 1 1 1 1 1 1 1 1 1 1 1 1 1 1 1 1 1 1 1 1 1 1
      1 1 1 1 1 1 1 1 1 1 1 1 1 1 1 1 1 1 1 1 1 1 1 1 1 1 1 1 1 1 1 1 1 1 1 1 1 1 1 1
      1 1 1 1 1 1 1 1 1 1 1 1 1 1 1 1 1 1 1 1 1 1 1 1 1 1 1 1 1 1 1 1 1 1 1 1 1 1 1 1
      1 1 1 1 1 1 1 1 1 1 1 1 1 1 1 1 1 1 1 1 1 1 1 1 1 1 1 1 1 1 1 1 1 1 1 1 1 1 1 1
      1 1 1 1 1 1 1 1 1 1 1 1 1 1 1 1 1 1 1 1 1 1 1 1 1 1 1 1 1 1 1 1 1 1 1 1 1 1 1 1
      1 1 1 1 1 1 1 1 1 1 1 1 1 1 1 1 1 1 1 1 1 1 1 1 1 1 1 1 1 1 1 1 1 1 1 1 1 1 1 1
      1 1 1 1 1 1 1 1 1 1 1 1 1 1 1 1 1 1 1 1 1 1 1 1 1 1 1 1 1 1 1 1 1 1 1 1 1 1 1 1
      1 1 1 1 1 1 1 1 1 1 1 1 1 1 1 1 1 1 1 1 1 1 1 1 1 1 1 1 1 1 1 1 1 1 1 1 1 1 1 1
      1 1 1 1 1 1 1 1 1 1 1 1 1 1 1 1 1 1 1 1 1 1 1 1 1 1 1 1 1 1 1 1 1 1 1 1 1 1 1 1
      1 1 1 1 1 1 1 1 1 1 1 1 1 1 1 1 1 1 1 1 1 1 1 1 1 1 1 1 1 1 1 1 1 1 1 1 1 1 1 1
      1 1 1 1 1 1 1 1 1 1 1 1 1 1 1 1 1 1 1 1 1 1 1 1 1 1 1 1 1 1 1 1 1 1 1 1 1 1 1 1
      1 1 1 1 1 1 1 1 1 1 1 1 1 1 1 1 1 1 1 1 1 1 1 1 1 1 1 1 1 1 1 1 1 1 1 1 1 1 1 1
      1 1 1 1 1 1 1 1 1 1 1 1 1 1 1 1 1 1 1 1 1 1 1 1 1 1 1 1 1 1 1 1 1 1 1 1 1 1 1 1
      1 1 1 1 1 1 1 1 1 1 1 1 1 1 1 1 1 1 1 1 1 1 1 1 1 1 1 1 1 1 1 1 1 1 1 1 1 1 1 1
      1 1 1 1 1 1 1 1 1 1 1 1 1 1 1 1 1 1 1 1 1 1 1 1 1 1 1 1 1 1 1 1 1 1 1 1 1 1 1 1
      )
    )
    (level
      (name "halloween1.stl")
      (x 12)
      (y 13)
    )
    (level
      (name "pools.stl")
      (x 22)
      (y 12)
    )
    (level
      (name "halloween3.stl")
      (x 20)
      (y 15)
    )
    (level
      (name "halloween2.stl")
      (x 14)
      (y 9)
    )
    (level
      (name "mound.stl")
      (x 28)
      (y 13)
    )
    (level
      (name "intro.stl")
      (extro-script " wait_for_screenswitch();
			  display_text_file( \"levels/halloween/intro.txt\"	);")
      (sprite "images/objects/invisible/invisible.sprite")
      (x 9)
      (y 10)
    )
    (level
      (name "outro.stl")
      (extro-script " wait_for_screenswitch();
			  display_text_file( \"levels/halloween/outro.txt\"	);")
      (sprite "images/objects/invisible/invisible.sprite")
      (x 32)
      (y 11)
    )
    (worldmap-spawnpoint
      (name "main")
      (x 9)
      (y 10)
    )
  )
  (tileset "images/worldmap.strf")
)
