(supertux-level
  (version 2)
  (name (_ "Unnamed"))
  (author "ingo")
  (target-time 0)
  (sector
    (name "main")
    (ambient-light 1 1 1)
    (camera
      (mode "normal")
    )
    (decal
      (x 256)
      (y 288)
      (sprite "images/worldmap/halloween/home.png")
    )
    (decal
      (x 576)
      (y 224)
      (sprite "images/worldmap/halloween/scarecrow.png")
    )
    (decal
      (x 864)
      (y 512)
      (sprite "images/worldmap/halloween/scarecrow.png")
    )
    (decal
      (x 992)
      (y 320)
      (sprite "images/worldmap/halloween/home.png")
    )
    (decal
      (x 192)
      (y 64)
      (sprite "images/worldmap/halloween/scarecrow.png")
    )
    (decal
      (x 864)
      (y 320)
      (sprite "images/worldmap/halloween/tree1.png")
    )
    (decal
      (x 608)
      (y 32)
      (sprite "images/worldmap/halloween/tree2.png")
    )
    (decal
      (x 448)
      (y 192)
      (sprite "images/worldmap/halloween/tree1.png")
    )
    (decal
      (x 640)
      (y 384)
      (sprite "images/worldmap/halloween/tree2.png")
    )
    (decal
      (x 416)
      (y 448)
      (sprite "images/worldmap/halloween/tree2.png")
    )
    (decal
      (x 928)
      (y 416)
      (sprite "images/worldmap/halloween/tree2.png")
    )
    (decal
      (x 704)
      (y 544)
      (sprite "images/worldmap/halloween/tree1.png")
    )
    (decal
      (x 1088)
      (y 608)
      (sprite "images/worldmap/halloween/tree1.png")
    )
    (decal
      (x 288)
      (y 608)
      (sprite "images/worldmap/halloween/tree2.png")
    )
    (decal
      (x 896)
      (y 256)
      (sprite "images/worldmap/halloween/tree2.png")
    )
    (decal
      (x 736)
      (y 352)
      (sprite "images/worldmap/halloween/tree1.png")
    )
    (decal
      (x 800)
      (y 320)
      (sprite "images/worldmap/halloween/tree2.png")
    )
    (decal
      (x 864)
      (y 320)
      (sprite "images/worldmap/halloween/tree1.png")
    )
    (tilemap
      (solid #f)
      (z-pos -100)
      (name "Background")
      (width 40)
      (height 25)
      (tiles
      1 1 1 1 1 1 1 1 1 1 1 1 1 1 1 1 1 1 1 1 1 1 1 1 1 1 1 1 1 1 1 1 1 1 1 1 1 1 1 1
      1 1 1 1 1 1 1 1 1 1 1 1 1 1 1 1 1 1 1 1 1 1 1 1 1 1 1 1 1 1 1 1 1 1 1 1 1 1 1 1
      1 1 1 1 1 1 1 1 1 1 1 1 1 1 1 1 1 1 1 1 1 1 1 1 1 1 1 1 1 1 1 1 1 1 1 1 1 1 1 1
      1 1 1 1 1 1 1 1 1 1 1 1 1 1 1 1 1 1 1 1 1 1 1 1 1 1 1 1 1 1 1 1 1 1 1 1 1 1 1 1
      1 1 1 1 1 1 1 1 1 1 1 1 1 1 1 1 1 1 1 1 1 1 1 1 1 1 1 1 1 1 1 1 1 1 1 1 1 1 1 1
      1 1 1 1 1 1 1 1 1 1 1 1 1 1 1 1 1 1 1 1 1 1 1 1 1 1 1 1 1 1 1 1 1 1 1 1 1 1 1 1
      1 1 1 1 1 1 1 1 1 1 1 1 1 1 1 1 1 1 1 1 1 1 1 1 1 1 1 1 1 1 1 1 1 1 1 1 1 1 1 1
      1 1 1 1 1 1 1 1 1 1 1 1 1 1 1 1 1 1 1 1 1 1 1 1 1 1 1 1 1 1 1 1 1 1 1 1 1 1 1 1
      1 1 1 1 1 1 1 1 1 1 1 1 1 1 1 1 1 1 1 1 1 1 1 1 1 1 1 1 1 1 1 1 1 1 1 1 1 1 1 1
      1 1 1 1 1 1 1 1 1 1 1 1 1 1 1 1 1 1 1 1 1 1 1 1 1 1 1 1 1 1 1 1 1 1 1 1 1 1 1 1
      1 1 1 1 1 1 1 1 1 1 1 1 1 1 1 1 1 1 1 1 1 1 1 1 1 1 1 1 1 1 1 1 1 1 1 1 1 1 1 1
      1 1 1 1 1 1 1 1 1 1 1 1 1 1 1 1 1 1 1 1 1 1 1 1 1 1 1 1 1 1 1 1 1 1 1 1 1 1 1 1
      1 1 1 1 1 1 1 1 1 1 1 1 1 1 1 1 1 1 1 1 1 1 1 1 1 1 1 1 1 1 1 1 1 1 1 1 1 1 1 1
      1 1 1 1 1 1 1 1 1 1 1 1 1 1 1 1 1 1 1 1 1 1 1 1 1 1 1 1 1 1 1 1 1 1 1 1 1 1 1 1
      1 1 1 1 1 1 1 1 1 1 1 1 1 1 1 1 1 1 1 1 1 1 1 1 1 1 1 1 1 1 1 1 1 1 1 1 1 1 1 1
      1 1 1 1 1 1 1 1 1 1 1 1 1 1 1 1 1 1 1 1 1 1 1 1 1 1 1 1 1 1 1 1 1 1 1 1 1 1 1 1
      1 1 1 1 1 1 1 1 1 1 1 1 1 1 1 1 1 1 1 1 1 1 1 1 1 1 1 1 1 1 1 1 1 1 1 1 1 1 1 1
      1 1 1 1 1 1 1 1 1 1 1 1 1 1 1 1 1 1 1 1 1 1 1 1 1 1 1 1 1 1 1 1 1 1 1 1 1 1 1 1
      1 1 1 1 1 1 1 1 1 1 1 1 1 1 1 1 1 1 1 1 1 1 1 1 1 1 1 1 1 1 1 1 1 1 1 1 1 1 1 1
      1 1 1 1 1 1 1 1 1 1 1 1 1 1 1 1 1 1 1 1 1 1 1 1 1 1 1 1 1 1 1 1 1 1 1 1 1 1 1 1
      1 1 1 1 1 1 1 1 1 1 1 1 1 1 1 1 1 1 1 1 1 1 1 1 1 1 1 1 1 1 1 1 1 1 1 1 1 1 1 1
      1 1 1 1 1 1 1 1 1 1 1 1 1 1 1 1 1 1 1 1 1 1 1 1 1 1 1 1 1 1 1 1 1 1 1 1 1 1 1 1
      1 1 1 1 1 1 1 1 1 1 1 1 1 1 1 1 1 1 1 1 1 1 1 1 1 1 1 1 1 1 1 1 1 1 1 1 1 1 1 1
      1 1 1 1 1 1 1 1 1 1 1 1 1 1 1 1 1 1 1 1 1 1 1 1 1 1 1 1 1 1 1 1 1 1 1 1 1 1 1 1
      1 1 1 1 1 1 1 1 1 1 1 1 1 1 1 1 1 1 1 1 1 1 1 1 1 1 1 1 1 1 1 1 1 1 1 1 1 1 1 1
      )
    )
    (tilemap
      (solid #t)
      (z-pos 0)
      (name "Interactive")
      (width 40)
      (height 25)
      (tiles
      0 0 0 0 0 0 0 0 0 0 0 0 0 0 0 0 0 0 0 0 0 0 0 0 0 0 0 0 0 0 0 0 0 0 0 0 0 0 0 0
      0 0 0 0 0 0 0 0 0 0 0 0 0 0 0 0 0 0 0 0 0 0 0 0 0 0 0 0 0 0 0 0 0 0 0 0 0 0 0 0
      0 0 0 1954 1927 1928 1929 0 0 0 0 0 0 0 0 0 0 0 0 1954 1929 0 0 0 0 0 0 0 0 0 0 0 0 0 1954 1928 1929 0 0 0
      0 0 1954 1938 1934 1935 1937 1928 1929 0 0 0 0 0 0 0 0 0 0 1947 1950 0 0 0 0 0 0 0 0 0 0 0 0 1954 1938 1935 1936 0 0 0
      0 0 1947 1931 1941 1942 1941 1942 1936 0 0 0 0 0 0 0 0 0 0 0 0 0 0 0 0 0 1954 1929 0 0 0 0 0 1940 1941 1942 1937 1929 0 0
      0 0 0 1947 1948 1949 1948 1949 1950 0 0 0 0 0 0 0 0 0 0 0 0 0 0 0 0 0 1947 1950 0 0 0 0 0 1947 1948 1949 1949 1950 0 0
      0 0 0 0 0 0 0 0 0 0 0 0 0 0 1954 1927 1928 1929 0 0 0 0 0 0 0 0 0 0 0 0 0 0 0 0 0 0 0 0 0 0
      0 0 0 0 0 0 0 0 0 0 0 0 1954 1927 1938 1934 1935 1937 1928 1929 0 0 0 0 0 0 0 0 0 0 0 0 0 0 0 0 0 0 0 0
      0 0 0 0 0 0 0 0 0 0 0 1954 1938 1935 1935 1935 1935 1935 1935 1937 1929 0 0 0 0 0 0 0 0 0 0 0 0 0 0 0 0 0 0 0
      0 0 0 0 0 0 0 1954 1927 1927 1928 1938 48 40 40 40 40 39 1934 1935 1936 0 0 0 0 0 0 1954 1927 1928 1929 0 0 0 0 0 0 0 0 0
      0 0 0 0 0 0 0 1947 1931 1941 1941 1941 47 1930 1948 1931 1942 47 1934 1935 1937 1928 1929 0 0 1954 1927 1938 1934 1935 1937 1928 1929 0 0 0 0 0 0 0
      0 0 0 0 0 0 0 0 1933 37 40 40 46 1936 0 1947 1931 47 1934 1934 1934 1935 1937 1927 1928 1938 1935 1935 1935 1935 1935 1935 1937 1929 0 0 0 0 0 0
      0 0 0 0 0 0 0 0 1940 1935 1935 1935 47 1936 0 1954 1938 37 40 40 40 40 39 1935 1935 1934 1935 1934 1935 1934 48 40 42 1936 0 0 0 0 0 0
      0 0 0 0 0 0 0 0 1947 1948 1949 1931 47 1937 1928 1938 1942 1935 1934 1935 1935 1934 47 1934 1935 1934 1935 48 40 40 42 1934 1935 1943 0 0 0 0 0 0
      0 0 0 0 0 0 0 0 0 0 0 1933 37 40 40 40 40 40 39 1942 1942 1935 47 1935 48 40 40 42 1935 1935 1935 1934 1930 1950 0 0 0 0 0 0
      0 0 0 0 0 0 0 0 0 0 0 1940 1941 1942 1941 1935 1935 1934 37 40 40 40 44 40 42 1934 1934 1934 1935 1935 1935 1942 1943 0 0 0 0 0 0 0
      0 0 0 0 0 0 0 0 0 0 0 1947 1948 1949 1931 1942 1942 1941 1934 1934 1934 1935 1934 1935 1934 1935 1934 1935 1934 1930 1949 1949 1950 0 0 0 0 0 0 0
      0 0 0 0 0 0 0 0 0 0 0 0 0 0 1947 1948 1931 1942 1934 1935 1934 1935 1934 1935 1934 1935 1934 1935 1942 1943 0 0 0 0 0 0 0 0 0 0
      0 0 0 0 0 0 1954 1928 1929 0 0 0 0 0 0 0 1947 1948 1948 1948 1949 1931 1935 1935 1930 1948 1949 1948 1949 1950 0 0 0 0 0 0 0 0 0 0
      0 0 0 0 0 1954 1938 1935 1937 1928 1929 0 0 0 0 0 0 0 0 0 0 1947 1948 1949 1950 0 0 0 0 0 0 0 0 0 0 0 0 0 0 0
      0 0 0 0 0 1947 1931 1942 1941 1942 1936 0 0 0 0 0 0 0 0 0 0 0 0 0 0 0 0 0 0 0 0 0 0 0 1954 1929 0 0 0 0
      0 0 0 0 0 0 1947 1949 1948 1949 1950 0 0 0 0 0 0 0 0 0 0 0 0 1954 1929 0 0 0 0 0 0 0 0 0 1947 1950 0 0 0 0
      0 0 0 0 0 0 0 0 0 0 0 0 0 0 0 0 0 0 0 0 0 0 0 1947 1950 0 0 0 0 0 0 0 0 0 0 0 0 0 0 0
      0 0 0 0 0 0 0 0 0 0 0 0 0 0 0 0 0 0 0 0 0 0 0 0 0 0 0 0 0 0 0 0 0 0 0 0 0 0 0 0
      0 0 0 0 0 0 0 0 0 0 0 0 0 0 0 0 0 0 0 0 0 0 0 0 0 0 0 0 0 0 0 0 0 0 0 0 0 0 0 0
      )
    )
    (tilemap
      (solid #f)
      (z-pos 1)
      (name "Foreground")
      (width 40)
      (height 25)
      (tiles
      0 0 0 0 0 0 0 0 0 0 0 0 0 0 0 0 0 0 0 0 0 0 0 0 0 0 0 0 0 0 0 0 0 0 0 0 0 0 0 0
      0 0 0 0 0 0 0 0 0 0 0 0 0 0 0 0 0 0 0 0 0 0 0 0 0 0 0 0 0 0 0 0 0 0 0 0 0 0 0 0
      0 0 0 0 0 0 0 0 0 0 0 0 0 0 0 0 0 0 0 0 0 0 0 0 0 0 0 0 0 0 0 0 0 0 0 0 0 0 0 0
      0 0 0 0 1954 1927 1927 1929 0 0 0 0 0 0 0 0 0 0 0 0 0 0 0 0 0 0 0 0 0 0 0 0 0 0 1954 1929 0 0 0 0
      0 0 0 0 1947 1948 1949 1950 0 0 0 0 0 0 0 0 0 0 0 0 0 0 0 0 0 0 0 0 0 0 0 0 0 0 1947 1950 0 0 0 0
      0 0 0 0 0 0 0 0 0 0 0 0 0 0 0 0 0 0 0 0 0 0 0 0 0 0 0 0 0 0 0 0 0 0 0 0 0 0 0 0
      0 0 0 0 0 0 0 0 0 0 0 0 0 0 0 0 0 0 0 0 0 0 0 0 0 0 0 0 0 0 0 0 0 0 0 0 0 0 0 0
      0 0 0 0 0 0 0 0 0 0 0 0 0 0 0 0 0 0 0 0 0 0 0 0 0 0 0 0 0 0 0 0 0 0 0 0 0 0 0 0
      0 0 0 0 0 0 0 0 0 0 0 0 0 0 0 0 0 0 0 0 0 0 0 0 0 0 0 0 0 0 0 0 0 0 0 0 0 0 0 0
      0 0 0 0 0 0 0 0 0 0 0 0 0 0 0 0 0 0 0 0 0 0 0 0 0 0 0 0 0 0 0 0 0 0 0 0 0 0 0 0
      0 0 0 0 0 0 0 0 0 0 0 0 0 0 0 0 0 0 0 0 0 0 0 0 0 0 0 0 0 0 0 0 0 0 0 0 0 0 0 0
      0 0 0 0 0 0 0 0 0 0 0 0 0 0 0 0 0 0 0 0 0 0 0 0 0 0 0 0 0 0 0 0 0 0 0 0 0 0 0 0
      0 0 0 0 0 0 0 0 0 0 0 0 0 0 0 0 0 0 0 0 0 0 0 0 0 0 0 0 0 0 0 0 0 0 0 0 0 0 0 0
      0 0 0 0 0 0 0 0 0 0 0 0 0 0 0 0 0 0 0 0 0 0 0 0 0 0 0 0 0 0 0 0 0 0 0 0 0 0 0 0
      0 0 0 0 0 0 0 0 0 0 0 0 0 0 0 0 0 0 0 0 0 0 0 0 0 0 0 0 0 0 0 0 0 0 0 0 0 0 0 0
      0 0 0 0 0 0 0 0 0 0 0 0 0 0 0 0 0 0 0 0 0 0 0 0 0 0 0 0 0 0 0 0 0 0 0 0 0 0 0 0
      0 0 0 0 0 0 0 0 0 0 0 0 0 0 0 0 0 0 0 0 0 0 0 0 0 0 0 0 0 0 0 0 0 0 0 0 0 0 0 0
      0 0 0 0 0 0 0 0 0 0 0 0 0 0 0 0 0 0 0 0 0 0 0 0 0 0 0 0 0 0 0 0 0 0 0 0 0 0 0 0
      0 0 0 0 0 0 0 0 0 0 0 0 0 0 0 0 0 0 0 0 0 0 0 0 0 0 0 0 0 0 0 0 0 0 0 0 0 0 0 0
      0 0 0 0 0 0 1954 1929 0 0 0 0 0 0 0 0 0 0 0 0 0 0 0 0 0 0 0 0 0 0 0 0 0 0 0 0 0 0 0 0
      0 0 0 0 0 0 1947 1950 0 0 0 0 0 0 0 0 0 0 0 0 0 0 0 0 0 0 0 0 0 0 0 0 0 0 0 0 0 0 0 0
      0 0 0 0 0 0 0 0 0 0 0 0 0 0 0 0 0 0 0 0 0 0 0 0 0 0 0 0 0 0 0 0 0 0 0 0 0 0 0 0
      0 0 0 0 0 0 0 0 0 0 0 0 0 0 0 0 0 0 0 0 0 0 0 0 0 0 0 0 0 0 0 0 0 0 0 0 0 0 0 0
      0 0 0 0 0 0 0 0 0 0 0 0 0 0 0 0 0 0 0 0 0 0 0 0 0 0 0 0 0 0 0 0 0 0 0 0 0 0 0 0
      0 0 0 0 0 0 0 0 0 0 0 0 0 0 0 0 0 0 0 0 0 0 0 0 0 0 0 0 0 0 0 0 0 0 0 0 0 0 0 0
      )
    )
    (level
      (name "halloween1.stl")
      (x 12)
      (y 13)
    )
    (level
      (name "halloween1.stl")
      (x 22)
      (y 12)
    )
    (level
      (name "halloween1.stl")
      (x 20)
      (y 15)
    )
    (level
      (name "halloween1.stl")
      (x 14)
      (y 9)
    )
    (level
      (name "halloween1.stl")
      (x 28)
      (y 13)
    )
    (worldmap-spawnpoint
      (name "main")
      (x 10)
      (y 11)
    )
  )
  (tileset "images/worldmap.strf")
)
