(supertux-level
  (version 3)
  (name (_ "Menu Level (Retro)"))
  (author "SuperTux Team")
  (contact "supertux.org/contact.html")
  (license "CC-BY-SA 4.0 International")
  (allow-item-pocket "inherit")
  (icon "")
  (icon-locked "")
  (statistics
    (enable-coins #t)
    (enable-badguys #f)
    (enable-secrets #t)
  )
  (sector
    (name "main")
    (init-script "if(is_christmas())
{
  // change ambient light
  settings.fade_to_ambient_light(0.7, 0.8, 1, 0);

  // change background
  background_layer1.set_color(0.5, 0.6, 0.8, 1);
  background_layer2.set_color(0.3, 0.4, 0.7, 1);
  background_layer3.set_color(0.2, 0.3, 0.66, 1);
  skybox_layer1.set_color(0.3, 0.4, 0.6, 1);
  skybox_layer2.set_color(0.3, 0.4, 0.6, 1);
  gradient.set_color1(0, 0, 0);
  gradient.set_color2(0, 0, 0.5);

  // change music (disabled for now to keep the retro feel)
  // settings.set_music(\"music/misc/christmas_theme.music\");
}")
    (ambient-light
      (color 1 1 1)
    )
    (background
      (name "skybox_layer2")
      (color 1 1 1)
      (scroll-speed-x -0.1)
      (speed 0)
      (image "/images/background/misc/skybox.png")
      (z-pos -240)
    )
    (background
      (name "background_layer1")
      (color 1 1 1)
      (alignment "bottom")
      (speed 0.5)
      (image-top "/images/background/misc/transparent_up.png")
      (image "/images/background/retro/arctis_shore.png")
      (z-pos -200)
    )
    (background
      (name "background_layer3")
      (color 1 1 1)
      (speed 0)
      (image-top "/images/background/misc/transparent_up.png")
      (image "/images/background/retro/arctis_skyline.png")
      (z-pos -220)
    )
    (background
      (name "background_layer2")
      (color 1 1 1)
      (speed 0.01)
      (speed-y 0)
      (image-top "/images/background/misc/transparent_up.png")
      (image "/images/background/retro/arctis_icechunk.png")
      (z-pos -210)
    )
    (background
      (name "skybox_layer1")
      (color 1 1 1)
      (scroll-speed-x -2)
      (speed 0)
      (image "/images/background/misc/clouds.png")
      (z-pos -230)
    )
    (bonusblock
      (type "retro")
      (z-pos 51)
      (x 928)
      (y 416)
    )
    (bonusblock
      (type "retro")
      (z-pos 51)
      (x 1056)
      (y 416)
    )
    (bonusblock
      (type "retro")
      (z-pos 51)
      (x 1056)
      (y 288)
    )
    (bonusblock
      (type "retro")
      (z-pos 51)
      (x 1184)
      (y 416)
    )
    (bonusblock
      (type "retro")
      (z-pos 51)
      (x 1632)
      (y 288)
    )
    (bonusblock
      (type "retro")
      (z-pos 51)
      (x 1536)
      (y 416)
    )
    (bonusblock
      (type "retro")
      (z-pos 51)
      (x 1568)
      (y 416)
    )
    (bonusblock
      (type "retro")
      (z-pos 51)
      (x 1664)
      (y 416)
    )
    (bonusblock
      (type "retro")
      (z-pos 51)
      (x 1696)
      (y 416)
    )
    (bonusblock
      (type "retro")
      (z-pos 51)
      (x 1792)
      (y 416)
    )
    (bonusblock
      (type "retro")
      (z-pos 51)
      (x 1824)
      (y 416)
    )
    (bonusblock
      (type "retro")
      (z-pos 51)
      (x 3008)
      (y 192)
    )
    (bonusblock
      (type "retro")
      (z-pos 51)
      (x 3040)
      (y 192)
    )
    (bonusblock
      (type "retro")
      (z-pos 51)
      (x 3168)
      (y 288)
    )
    (bonusblock
      (type "retro")
      (z-pos 51)
      (x 3360)
      (y 320)
    )
    (bonusblock
      (type "retro")
      (z-pos 51)
      (x 4736)
      (y 256)
    )
    (bonusblock
      (type "retro")
      (z-pos 51)
      (x 4800)
      (y 256)
    )
    (bonusblock
      (type "retro")
      (z-pos 51)
      (x 7168)
      (y 352)
    )
    (bonusblock
      (type "retro")
      (z-pos 51)
      (x 7200)
      (y 352)
    )
    (bonusblock
      (type "retro")
      (z-pos 51)
      (x 8608)
      (y 384)
    )
    (brick
      (type "retro")
      (z-pos 51)
      (x 1888)
      (y 160)
      (breakable #t)
    )
    (brick
      (type "retro")
      (z-pos 51)
      (x 1920)
      (y 160)
      (breakable #t)
    )
    (brick
      (type "retro")
      (z-pos 51)
      (x 1952)
      (y 160)
      (breakable #t)
    )
    (brick
      (type "retro")
      (z-pos 51)
      (x 1984)
      (y 160)
      (breakable #t)
    )
    (brick
      (type "retro")
      (z-pos 51)
      (x 2016)
      (y 160)
      (breakable #t)
    )
    (brick
      (type "retro")
      (z-pos 51)
      (x 2048)
      (y 160)
      (breakable #t)
    )
    (brick
      (type "retro")
      (z-pos 51)
      (x 1856)
      (y 416)
      (breakable #t)
    )
    (brick
      (type "retro")
      (z-pos 51)
      (x 1760)
      (y 416)
      (breakable #t)
    )
    (brick
      (type "retro")
      (z-pos 51)
      (x 1728)
      (y 416)
      (breakable #t)
    )
    (brick
      (type "retro")
      (z-pos 51)
      (x 1632)
      (y 416)
      (breakable #t)
    )
    (brick
      (type "retro")
      (z-pos 51)
      (x 1600)
      (y 416)
      (breakable #t)
    )
    (brick
      (type "retro")
      (z-pos 51)
      (x 1504)
      (y 416)
      (breakable #t)
    )
    (camera
      (name "Camera")
      (mode "normal")
    )
    (gradient
      (name "gradient")
      (top_color 0.8 0.9 1)
      (bottom_color 0.82 0.8 0.98)
    )
    (music
      (file "/music/retro/theme_old.music")
    )
    (spawnpoint
      (name "main")
      (x 0)
      (y 0)
    )
    (tilemap
      (solid #f)
      (z-pos -100)
      (width 300)
      (height 25)
      (tiles -7500 0)
    )
    (tilemap
      (solid #t)
      (z-pos 0)
      (width 300)
      (height 25)
      (tiles -2546 0 27 29 0 47 0 27 29 -76 0 27 -13 28 29 -3 0 27 -9 28 29 -92 0 47 0 27 -3 28 29 -30 0 4100 -4 4102 4101 -44 0 4100 -2 4102 4101 -15 0 27 -4 28 29 -225 0 4157 -2 4002 -2 4001 4158 -44 0 4157 4003 4002 4158 -31 0 27 -2 28 29 -8 0 27 -2 28 29 -28 0 27 -2 28 29 -167 0 4161 -4 4000 4162 -44 0 4161 -2 4000 4162 -58 0 27 -10 28 29 -172 0 4100 -3 4102 4159 -4 4000 4162 -41 0 4100 -2 4102 4159 -2 4000 4162 -106 0 4100 -2 4102 4101 -132 0 4157 -3 4001 4163 -4 4000 4160 -4 4102 4101 -36 0 4157 4002 4001 4163 -2 4000 4162 -22 0 4100 -30 4102 4101 -39 0 4100 -5 4102 4101 4100 -4 4102 4101 4157 -2 4001 4158 -132 0 4161 -8 4000 4164 -3 4001 4003 4158 -36 0 4161 -5 4000 4160 -9 4102 4101 -12 0 4157 -2 4002 4001 4002 4001 4002 -2 4001 4002 4003 4002 -3 4001 4002 -12 4001 4003 4001 4003 4158 -39 0 4157 -2 4001 4003 -2 4001 4158 4157 -4 4001 4158 4161 -2 4000 4162 4100 4101 -47 0 -26 4102 4101 -37 0 4100 -18 4102 4159 -13 4000 4160 -36 4102 4159 4000 4078 -3 4000 4164 4001 4002 -2 4001 4002 4003 -3 4001 4158 -12 0 4161 4000 4078 -28 4000 4160 -25 4102 4101 4100 4101 4100 4102 4101 4100 -7 4102 4159 -5 4000 4162 4161 -4 4000 4162 4161 -2 4000 4162 4157 4158 4100 -46 4102 4002 -3 4001 -2 4002 -20 4001 4169 -37 4102 4168 -6 4001 -2 4002 -3 4001 4002 -6 4001 4163 -13 4000 4164 -13 4001 4003 4002 -3 4001 -2 4002 -16 4001 4163 -15 4000 4160 -12 4102 4159 -30 4000 4164 -2 4001 4003 -2 4001 4002 -3 4001 4003 -5 4001 4002 -9 4001 4158 4157 4158 4157 4001 4158 4157 -3 4001 4003 4002 -2 4001 4163 -5 4000 4162 4161 -4 4000 4162 4161 -2 4000 4162 4161 4162 4157 -2 4001 4003 -5 4001 4003 4001 -2 4002 4001 -2 4002 -5 4001 4002 -4 4001 4002 -5 4001 4002 -14 4001 -26 4000 4164 4001 4002 -2 4001 4002 -8 4001 4002 -23 4001 4163 -5 4000 4078 -33 4000 4078 -45 4000 4164 -7 4001 4003 -4 4001 4163 -2 4000 4078 -4 4000 4078 -48 4000 4162 4161 4162 4161 4000 4162 4161 -13 4000 4162 4161 -4 4000 4162 4161 -2 4000 4162 4161 4162 4161 -20 4000 4078 -49 4000 4078 -19 4000 4078 -108 4000 4078 -66 4000 4162 4161 4162 4161 4000 4162 4161 -13 4000 4162 4161 -4 4000 4162 4161 -2 4000 4162 4161 4162 4161 -8 4000 4078 -257 4000 4162 4161 4162 4161 4000 4162 4161 -13 4000 4162 4161 -4 4000 4162 4161 -2 4000 4162 4161 4162 4161 -266 4000 4162 4161 4162 4161 4000 4162 4161 -13 4000 4162 4161 -4 4000 4162 4161 -2 4000 4162 4161 4162 4161 -266 4000 4162 4161 4162 4161 4000 4162 4161 -13 4000 4162 4161 -4 4000 4162 4161 -2 4000 4162 4161 4162 4161 -266 4000 4162 4161 4162 4161 4000 4162 4161 -13 4000 4162 4161 -4 4000 4162 4161 -2 4000 4162 4161 4162 4161 -266 4000 4162 4161 4162 4161 4000 4162 4161 -13 4000 4162 4161 -4 4000 4162 4161 -2 4000 4162 4161 4162 4161 -266 4000 4162 4161 4162 4161 4000 4162 4161 -13 4000 4162 4161 -4 4000 4162 4161 -2 4000 4162 4161 4162 4161 -46 4000)
    )
    (tilemap
      (solid #f)
      (z-pos 100)
      (width 300)
      (height 25)
      (tiles -7500 0)
    )
    (tilemap
      (solid #t)
      (z-pos -1)
      (width 300)
      (height 25)
      (tiles -2521 0 27 29 -297 0 27 28 29 -296 0 27 -2 28 29 -295 0 27 -3 28 29 -294 0 27 -6 28 29 -291 0 27 -5 28 29 -292 0 27 -6 28 29 -151 0 57 58 -138 0 27 -7 28 29 -151 0 59 60 -2724 0)
    )
  )
)
